app,usage,start_time,end_time,created_at,tz,device_model
com.apple.finder,1,1736213001,1736213002,1736213003,-21600,MacBook
com.microsoft.VSCode,0,1736213001,1736213001,1736213002,-21600,MacBook
com.google.Chrome,3,1736212998,1736213001,1736213001,-21600,MacBook
com.apple.finder,2,1736212996,1736212998,1736212999,-21600,MacBook
com.microsoft.VSCode,1,1736212995,1736212996,1736212997,-21600,MacBook
com.google.Chrome,9,1736212986,1736212995,1736212996,-21600,MacBook
com.microsoft.VSCode,1,1736212985,1736212986,1736212987,-21600,MacBook
com.apple.finder,3,1736212982,1736212985,1736212986,-21600,MacBook
com.google.Chrome,66,1736212916,1736212982,1736212983,-21600,MacBook
com.microsoft.VSCode,4,1736212912,1736212916,1736212917,-21600,MacBook
com.google.Chrome,17,1736212895,1736212912,1736212913,-21600,MacBook
com.apple.finder,5,1736212890,1736212895,1736212896,-21600,MacBook
com.google.Chrome,124,1736212766,1736212890,1736212891,-21600,MacBook
com.microsoft.VSCode,2,1736212764,1736212766,1736212766,-21600,MacBook
com.google.Chrome,7,1736212757,1736212764,1736212764,-21600,MacBook
com.microsoft.VSCode,4,1736212753,1736212757,1736212758,-21600,MacBook
com.google.Chrome,4,1736212749,1736212753,1736212754,-21600,MacBook
com.microsoft.VSCode,2,1736212747,1736212749,1736212749,-21600,MacBook
com.google.Chrome,2,1736212745,1736212747,1736212747,-21600,MacBook
com.microsoft.VSCode,2,1736212743,1736212745,1736212745,-21600,MacBook
com.google.Chrome,29,1736212714,1736212743,1736212743,-21600,MacBook
com.microsoft.VSCode,14,1736212700,1736212714,1736212714,-21600,MacBook
com.google.Chrome,3,1736212697,1736212700,1736212701,-21600,MacBook
com.microsoft.VSCode,7,1736212690,1736212697,1736212698,-21600,MacBook
com.google.Chrome,3,1736212687,1736212690,1736212691,-21600,MacBook
com.apple.finder,1,1736212686,1736212687,1736212688,-21600,MacBook
com.microsoft.VSCode,27,1736212659,1736212686,1736212687,-21600,MacBook
com.google.Chrome,14,1736212645,1736212659,1736212660,-21600,MacBook
com.microsoft.VSCode,12,1736212633,1736212645,1736212646,-21600,MacBook
com.google.Chrome,26,1736212607,1736212633,1736212633,-21600,MacBook
com.apple.finder,2,1736212605,1736212607,1736212607,-21600,MacBook
com.google.Chrome,2,1736212603,1736212605,1736212605,-21600,MacBook
com.microsoft.VSCode,3,1736212600,1736212603,1736212604,-21600,MacBook
com.apple.finder,6,1736212594,1736212600,1736212601,-21600,MacBook
com.microsoft.VSCode,48,1736212546,1736212594,1736212595,-21600,MacBook
com.apple.finder,3,1736212543,1736212546,1736212547,-21600,MacBook
com.microsoft.VSCode,1,1736212542,1736212543,1736212544,-21600,MacBook
com.google.Chrome,77,1736212465,1736212542,1736212542,-21600,MacBook
com.microsoft.Outlook,2,1736212463,1736212465,1736212465,-21600,MacBook
com.google.Chrome,2,1736212461,1736212463,1736212464,-21600,MacBook
com.microsoft.Outlook,6,1736212455,1736212461,1736212461,-21600,MacBook
com.microsoft.VSCode,0,1736212455,1736212455,1736212456,-21600,MacBook
com.google.Chrome,71,1736212384,1736212455,1736212456,-21600,MacBook
com.microsoft.VSCode,1,1736212383,1736212384,1736212385,-21600,MacBook
com.google.Chrome,2,1736212381,1736212383,1736212384,-21600,MacBook
com.microsoft.VSCode,0,1736212381,1736212381,1736212382,-21600,MacBook
com.apple.finder,8,1736212373,1736212381,1736212381,-21600,MacBook
com.google.Chrome,119,1736212254,1736212373,1736212373,-21600,MacBook
com.microsoft.Excel,7,1736212247,1736212254,1736212254,-21600,MacBook
com.apple.finder,2,1736212245,1736212247,1736212248,-21600,MacBook
com.microsoft.Excel,18,1736212227,1736212245,1736212245,-21600,MacBook
com.apple.finder,3,1736212224,1736212227,1736212228,-21600,MacBook
com.google.Chrome,3,1736212221,1736212224,1736212225,-21600,MacBook
com.microsoft.Excel,2,1736212219,1736212221,1736212222,-21600,MacBook
com.google.Chrome,2,1736212217,1736212219,1736212219,-21600,MacBook
com.apple.finder,25,1736212192,1736212217,1736212218,-21600,MacBook
com.google.Chrome,212,1736211980,1736212192,1736212192,-21600,MacBook
com.apple.finder,6,1736211845,1736211851,1736211852,-21600,MacBook
com.google.Chrome,441,1736211404,1736211845,1736211846,-21600,MacBook
com.apple.finder,1,1736211403,1736211404,1736211405,-21600,MacBook
com.microsoft.Outlook,13,1736211390,1736211403,1736211403,-21600,MacBook
com.apple.finder,0,1736211390,1736211390,1736211391,-21600,MacBook
com.google.Chrome,129,1736211261,1736211390,1736211391,-21600,MacBook
com.apple.finder,1,1736211260,1736211261,1736211262,-21600,MacBook
com.tencent.xinWeChat,38,1736211222,1736211260,1736211260,-21600,MacBook
com.apple.finder,0,1736211222,1736211222,1736211223,-21600,MacBook
com.google.Chrome,4,1736211218,1736211222,1736211223,-21600,MacBook
com.apple.finder,2,1736211216,1736211218,1736211219,-21600,MacBook
com.google.Chrome,2,1736211214,1736211216,1736211217,-21600,MacBook
com.apple.finder,2,1736211212,1736211214,1736211215,-21600,MacBook
com.google.Chrome,57,1736211155,1736211212,1736211212,-21600,MacBook
com.apple.Notes,1,1736211154,1736211155,1736211156,-21600,MacBook
com.google.Chrome,1,1736211153,1736211154,1736211155,-21600,MacBook
com.apple.clock,1,1736211152,1736211153,1736211154,-21600,MacBook
com.google.Chrome,242,1736210910,1736211152,1736211153,-21600,MacBook
com.google.Chrome,652,1736209963,1736210615,1736210616,-21600,MacBook
com.google.Chrome,302,1736209193,1736209495,1736209496,-21600,MacBook
com.google.Chrome,365,1736208308,1736208673,1736208673,-21600,MacBook
com.apple.clock,17,1736208291,1736208308,1736208309,-21600,MacBook
com.google.Chrome,2,1736208289,1736208291,1736208292,-21600,MacBook
com.apple.clock,1,1736208288,1736208289,1736208289,-21600,MacBook
com.apple.finder,4,1736208284,1736208288,1736208289,-21600,MacBook
com.google.Chrome,760,1736207524,1736208284,1736208284,-21600,MacBook
com.tencent.xinWeChat,36,1736207488,1736207524,1736207524,-21600,MacBook
com.apple.Preview,0,1736207488,1736207488,1736207489,-21600,MacBook
com.google.Chrome,17,1736207471,1736207488,1736207489,-21600,MacBook
com.ubercab.UberEats,1,1736207374,1736207375,1736207376,-21600,iPhone
com.ubercab.UberEats,2,1736207336,1736207338,1736207338,-21600,iPhone
com.ubercab.UberEats,7,1736207135,1736207142,1736207142,-21600,iPhone
com.ubercab.UberEats,23,1736207104,1736207127,1736207128,-21600,iPhone
com.ubercab.UberEats,28,1736207064,1736207092,1736207093,-21600,iPhone
com.ubercab.UberEats,8,1736206972,1736206980,1736206981,-21600,iPhone
tv.danmaku.bilianime,3,1736206967,1736206970,1736206970,-21600,iPhone
tv.danmaku.bilianime,14,1736206753,1736206767,1736206768,-21600,iPhone
com.apple.MobileSMS,4,1736206746,1736206750,1736206750,-21600,iPhone
com.ubercab.UberEats,35,1736206708,1736206743,1736206744,-21600,iPhone
com.ubercab.UberEats,33,1736206663,1736206696,1736206697,-21600,iPhone
com.apple.mobilenotes,5,1736206656,1736206661,1736206662,-21600,iPhone
com.apple.camera,2,1736206656,1736206658,1736206660,-21600,iPhone
com.apple.mobilenotes,2,1736206236,1736206238,1736206238,-21600,iPhone
com.apple.mobilenotes,5,1736206194,1736206199,1736206199,-21600,iPhone
com.apple.mobilenotes,37,1736206041,1736206078,1736206079,-21600,iPhone
com.tencent.xin,6,1736206008,1736206014,1736206015,-21600,iPhone
com.tencent.xin,46,1736205927,1736205973,1736205974,-21600,iPhone
com.microsoft.Office.Outlook,7,1736205918,1736205925,1736205926,-21600,iPhone
com.apple.MobileSMS,4,1736205914,1736205918,1736205919,-21600,iPhone
com.xingin.discover,3,1736205910,1736205913,1736205914,-21600,iPhone
com.zimride.instant,6,1736205904,1736205910,1736205910,-21600,iPhone
com.zimride.instant,18,1736205793,1736205811,1736205812,-21600,iPhone
com.google.Chrome,113,1736205670,1736205783,1736205784,-21600,MacBook
com.zimride.instant,4,1736205713,1736205717,1736205717,-21600,iPhone
com.zimride.instant,66,1736205605,1736205671,1736205672,-21600,iPhone
com.xingin.discover,81,1736205524,1736205605,1736205605,-21600,iPhone
com.zimride.instant,2,1736205522,1736205524,1736205525,-21600,iPhone
com.xingin.discover,127,1736205395,1736205522,1736205522,-21600,iPhone
com.zimride.instant,3,1736205392,1736205395,1736205395,-21600,iPhone
com.xingin.discover,143,1736205249,1736205392,1736205393,-21600,iPhone
com.zimride.instant,5,1736205244,1736205249,1736205249,-21600,iPhone
com.xingin.discover,138,1736205106,1736205244,1736205245,-21600,iPhone
com.zimride.instant,4,1736205102,1736205106,1736205106,-21600,iPhone
com.xingin.discover,164,1736204938,1736205102,1736205103,-21600,iPhone
com.apple.MobileSMS,4,1736204934,1736204938,1736204938,-21600,iPhone
com.xingin.discover,1,1736204931,1736204932,1736204933,-21600,iPhone
com.zimride.instant,102,1736204827,1736204929,1736204929,-21600,iPhone
com.zimride.instant,22,1736204653,1736204675,1736204676,-21600,iPhone
com.ridewithvia.UCA.UniversityOfChicagoRider,17,1736204635,1736204652,1736204652,-21600,iPhone
com.ridewithvia.UCA.UniversityOfChicagoRider,34,1736204597,1736204631,1736204632,-21600,iPhone
com.ridewithvia.UCA.UniversityOfChicagoRider,86,1736204479,1736204565,1736204566,-21600,iPhone
com.ridewithvia.UCA.UniversityOfChicagoRider,10,1736204448,1736204458,1736204459,-21600,iPhone
com.apple.Notes,1,1736204095,1736204096,1736204097,-21600,MacBook
com.apple.Preview,10,1736204085,1736204095,1736204096,-21600,MacBook
com.apple.finder,3,1736204082,1736204085,1736204086,-21600,MacBook
com.google.Chrome,737,1736203345,1736204082,1736204083,-21600,MacBook
com.ridewithvia.UCA.UniversityOfChicagoRider,39,1736203573,1736203612,1736203612,-21600,iPhone
com.ridewithvia.UCA.UniversityOfChicagoRider,2,1736203389,1736203391,1736203391,-21600,iPhone
com.apple.Notes,2,1736203343,1736203345,1736203345,-21600,MacBook
com.google.Chrome,5,1736203338,1736203343,1736203343,-21600,MacBook
com.apple.Notes,14,1736203324,1736203338,1736203339,-21600,MacBook
com.apple.finder,2,1736203322,1736203324,1736203325,-21600,MacBook
com.apple.Notes,1,1736203321,1736203322,1736203322,-21600,MacBook
com.apple.finder,1,1736203320,1736203321,1736203322,-21600,MacBook
com.google.Chrome,415,1736202905,1736203320,1736203321,-21600,MacBook
com.ridewithvia.UCA.UniversityOfChicagoRider,32,1736202965,1736202997,1736202998,-21600,iPhone
com.apple.Preview,4,1736202901,1736202905,1736202905,-21600,MacBook
com.apple.finder,3,1736202898,1736202901,1736202901,-21600,MacBook
com.google.Chrome,6,1736202892,1736202898,1736202898,-21600,MacBook
com.apple.finder,0,1736202892,1736202892,1736202893,-21600,MacBook
com.apple.Preview,13,1736202879,1736202892,1736202892,-21600,MacBook
com.apple.finder,12,1736202867,1736202879,1736202880,-21600,MacBook
com.google.Chrome,4,1736202863,1736202867,1736202868,-21600,MacBook
com.apple.finder,4,1736202859,1736202863,1736202864,-21600,MacBook
com.google.Chrome,6,1736202853,1736202859,1736202859,-21600,MacBook
com.apple.finder,1,1736202852,1736202853,1736202854,-21600,MacBook
com.apple.Preview,6,1736202846,1736202852,1736202853,-21600,MacBook
com.apple.finder,12,1736202834,1736202846,1736202846,-21600,MacBook
com.google.Chrome,9,1736202825,1736202834,1736202835,-21600,MacBook
com.apple.finder,48,1736202777,1736202825,1736202826,-21600,MacBook
com.google.Chrome,3,1736202774,1736202777,1736202777,-21600,MacBook
com.apple.finder,10,1736202764,1736202774,1736202775,-21600,MacBook
com.google.Chrome,127,1736202637,1736202764,1736202764,-21600,MacBook
com.apple.finder,21,1736202616,1736202637,1736202638,-21600,MacBook
com.google.Chrome,66,1736202550,1736202616,1736202616,-21600,MacBook
com.apple.finder,1,1736202549,1736202550,1736202550,-21600,MacBook
com.microsoft.Outlook,2,1736202547,1736202549,1736202549,-21600,MacBook
com.google.Chrome,58,1736202489,1736202547,1736202547,-21600,MacBook
com.microsoft.Outlook,51,1736202438,1736202489,1736202489,-21600,MacBook
com.google.Chrome,1,1736202437,1736202438,1736202439,-21600,MacBook
com.microsoft.Outlook,62,1736202375,1736202437,1736202438,-21600,MacBook
com.google.Chrome,1,1736202374,1736202375,1736202376,-21600,MacBook
com.microsoft.Outlook,1,1736202373,1736202374,1736202375,-21600,MacBook
com.google.Chrome,1,1736202372,1736202373,1736202373,-21600,MacBook
com.microsoft.Outlook,10,1736202362,1736202372,1736202372,-21600,MacBook
com.apple.finder,1,1736202361,1736202362,1736202362,-21600,MacBook
com.microsoft.Outlook,3,1736202358,1736202361,1736202362,-21600,MacBook
com.google.Chrome,1,1736202357,1736202358,1736202359,-21600,MacBook
com.microsoft.Outlook,23,1736202334,1736202357,1736202358,-21600,MacBook
com.google.Chrome,3,1736202331,1736202334,1736202334,-21600,MacBook
com.microsoft.Outlook,10,1736202321,1736202331,1736202331,-21600,MacBook
com.google.Chrome,1,1736202320,1736202321,1736202321,-21600,MacBook
com.microsoft.Outlook,8,1736202312,1736202320,1736202321,-21600,MacBook
com.google.Chrome,14,1736202298,1736202312,1736202313,-21600,MacBook
com.microsoft.Outlook,38,1736202260,1736202298,1736202298,-21600,MacBook
com.google.Chrome,6,1736202254,1736202260,1736202260,-21600,MacBook
com.microsoft.Outlook,44,1736202210,1736202254,1736202254,-21600,MacBook
com.apple.finder,1,1736202209,1736202210,1736202211,-21600,MacBook
com.google.Chrome,24,1736202185,1736202209,1736202209,-21600,MacBook
com.apple.finder,1,1736202184,1736202185,1736202186,-21600,MacBook
com.tencent.xinWeChat,42,1736202142,1736202184,1736202184,-21600,MacBook
com.tencent.xin,2,1736202178,1736202180,1736202181,-21600,iPhone
com.apple.Preferences,20,1736202156,1736202176,1736202177,-21600,iPhone
com.bestbuy.buyphone,5,1736202150,1736202155,1736202155,-21600,iPhone
com.ubercab.UberEats,5,1736202145,1736202150,1736202151,-21600,iPhone
com.ubercab.UberEats,18,1736202001,1736202019,1736202020,-21600,iPhone
com.apple.weather,17,1736201984,1736202001,1736202002,-21600,iPhone
com.ubercab.UberEats,0,1736201982,1736201982,1736201983,-21600,iPhone
com.tencent.xin,7,1736201971,1736201978,1736201978,-21600,iPhone
com.apple.finder,1,1736201966,1736201967,1736201968,-21600,MacBook
com.google.Chrome,2,1736201964,1736201966,1736201966,-21600,MacBook
com.microsoft.Outlook,2,1736201962,1736201964,1736201965,-21600,MacBook
com.apple.finder,2,1736201960,1736201962,1736201962,-21600,MacBook
com.microsoft.Outlook,14,1736201946,1736201960,1736201961,-21600,MacBook
com.apple.finder,1,1736201945,1736201946,1736201947,-21600,MacBook
com.microsoft.Outlook,0,1736201945,1736201945,1736201946,-21600,MacBook
com.apple.finder,1,1736201944,1736201945,1736201945,-21600,MacBook
com.microsoft.Outlook,18,1736201926,1736201944,1736201945,-21600,MacBook
com.google.Chrome,14,1736201912,1736201926,1736201926,-21600,MacBook
com.microsoft.Outlook,36,1736201876,1736201912,1736201913,-21600,MacBook
com.google.Chrome,4,1736201872,1736201876,1736201877,-21600,MacBook
com.tencent.xinWeChat,33,1736201839,1736201872,1736201872,-21600,MacBook
com.tencent.xin,12,1736201829,1736201841,1736201842,-21600,iPhone
com.google.Chrome,16,1736201823,1736201839,1736201840,-21600,MacBook
com.ubercab.UberEats,5,1736201824,1736201829,1736201830,-21600,iPhone
com.tencent.xinWeChat,2,1736201821,1736201823,1736201824,-21600,MacBook
com.google.Chrome,18,1736201803,1736201821,1736201822,-21600,MacBook
com.tencent.xinWeChat,1,1736201802,1736201803,1736201803,-21600,MacBook
com.google.Chrome,0,1736201802,1736201802,1736201803,-21600,MacBook
com.microsoft.Outlook,4,1736201798,1736201802,1736201803,-21600,MacBook
com.google.Chrome,50,1736201748,1736201798,1736201799,-21600,MacBook
com.ubercab.UberEats,35,1736201747,1736201782,1736201782,-21600,iPhone
tv.danmaku.bilianime,5,1736201740,1736201745,1736201745,-21600,iPhone
com.microsoft.Office.Outlook,43,1736201693,1736201736,1736201737,-21600,iPhone
com.instructure.icanvas,1,1736201691,1736201692,1736201692,-21600,iPhone
com.tencent.xin,3,1736201687,1736201690,1736201691,-21600,iPhone
com.microsoft.Outlook,19,1736201644,1736201663,1736201663,-21600,MacBook
com.google.Chrome,5,1736201639,1736201644,1736201645,-21600,MacBook
com.microsoft.Outlook,7,1736201632,1736201639,1736201639,-21600,MacBook
com.google.Chrome,201,1736201431,1736201632,1736201633,-21600,MacBook
com.microsoft.Outlook,64,1736201367,1736201431,1736201431,-21600,MacBook
com.google.Chrome,5,1736201362,1736201367,1736201367,-21600,MacBook
com.microsoft.Outlook,1,1736201361,1736201362,1736201363,-21600,MacBook
com.google.Chrome,13,1736201348,1736201361,1736201362,-21600,MacBook
com.microsoft.Outlook,6,1736201342,1736201348,1736201348,-21600,MacBook
com.google.Chrome,1,1736201341,1736201342,1736201343,-21600,MacBook
com.microsoft.Outlook,15,1736201326,1736201341,1736201342,-21600,MacBook
com.google.Chrome,11,1736201315,1736201326,1736201327,-21600,MacBook
com.microsoft.Outlook,2,1736201313,1736201315,1736201315,-21600,MacBook
com.google.Chrome,28,1736201285,1736201313,1736201313,-21600,MacBook
com.microsoft.Outlook,3,1736201282,1736201285,1736201285,-21600,MacBook
com.google.Chrome,21,1736201261,1736201282,1736201283,-21600,MacBook
com.microsoft.Outlook,9,1736201252,1736201261,1736201262,-21600,MacBook
com.apple.finder,0,1736201252,1736201252,1736201256,-21600,MacBook
com.google.Chrome,8,1736201244,1736201252,1736201256,-21600,MacBook
com.tencent.xin,99,1736201146,1736201245,1736201245,-21600,iPhone
com.tencent.xin,12,1736201134,1736201146,1736201146,-21600,iPhone
com.instructure.icanvas,7,1736201075,1736201082,1736201083,-21600,iPhone
com.microsoft.Office.Outlook,17,1736201058,1736201075,1736201076,-21600,iPhone
com.instructure.icanvas,1,1736201057,1736201058,1736201059,-21600,iPhone
com.microsoft.Office.Outlook,111,1736200941,1736201052,1736201053,-21600,iPhone
com.microsoft.Office.Outlook,10,1736197830,1736197840,1736197841,-21600,iPhone
com.google.Chrome,38,1736197275,1736197313,1736197314,-21600,MacBook
com.apple.PassbookUIService,31,1736197062,1736197093,1736197094,-21600,iPhone
com.microsoft.Office.Outlook,32,1736197061,1736197093,1736197094,-21600,iPhone
com.microsoft.Office.Outlook,2,1736197022,1736197024,1736197024,-21600,iPhone
com.microsoft.Office.Outlook,10,1736196947,1736196957,1736196958,-21600,iPhone
com.apple.PassbookUIService,30,1736196880,1736196910,1736196911,-21600,iPhone
com.google.Chrome,32,1736196868,1736196900,1736196900,-21600,MacBook
com.microsoft.Office.Outlook,3,1736196873,1736196876,1736196877,-21600,iPhone
com.valvesoftware.steam,1,1736196867,1736196868,1736196869,-21600,MacBook
com.apple.finder,4,1736196863,1736196867,1736196868,-21600,MacBook
com.google.Chrome,12,1736196851,1736196863,1736196864,-21600,MacBook
com.apple.finder,21,1736196830,1736196851,1736196852,-21600,MacBook
com.microsoft.Office.Outlook,67,1736196668,1736196735,1736196735,-21600,iPhone
com.google.calendar,3,1736196662,1736196665,1736196665,-21600,iPhone
com.google.calendar,6,1736196655,1736196661,1736196662,-21600,iPhone
com.netease.cloudmusic,14,1736196640,1736196654,1736196654,-21600,iPhone
com.netease.cloudmusic,1,1736196637,1736196638,1736196639,-21600,iPhone
com.netease.cloudmusic,26,1736196609,1736196635,1736196636,-21600,iPhone
com.google.chrome.ios,13,1736196592,1736196605,1736196606,-21600,iPhone
com.google.chrome.ios,12,1736196578,1736196590,1736196591,-21600,iPhone
com.microsoft.Office.Outlook,97,1736196481,1736196578,1736196578,-21600,iPhone
com.netease.cloudmusic,20,1736196461,1736196481,1736196482,-21600,iPhone
com.apple.Preferences,8,1736196449,1736196457,1736196457,-21600,iPhone
com.apple.mobiletimer,1,1736196447,1736196448,1736196449,-21600,iPhone
com.apple.mobiletimer,5,1736196324,1736196329,1736196329,-21600,iPhone
com.microsoft.Office.Outlook,2,1736196322,1736196324,1736196325,-21600,iPhone
com.google.calendar,5,1736196317,1736196322,1736196323,-21600,iPhone
com.google.calendar,1,1736196277,1736196278,1736196279,-21600,iPhone
com.google.calendar,9,1736196267,1736196276,1736196277,-21600,iPhone
tv.danmaku.bilianime,2,1736196263,1736196265,1736196266,-21600,iPhone
tv.danmaku.bilianime,0,1736195789,1736195789,1736195790,-21600,iPhone
tv.danmaku.bilianime,4,1736195732,1736195736,1736195736,-21600,iPhone
tv.danmaku.bilianime,6,1736195694,1736195700,1736195700,-21600,iPhone
tv.danmaku.bilianime,558,1736195132,1736195690,1736195691,-21600,iPhone
com.apple.mobilenotes,1,1736195129,1736195130,1736195131,-21600,iPhone
com.ubercab.UberEats,194,1736194932,1736195126,1736195126,-21600,iPhone
com.apple.PassbookUIService,8,1736195098,1736195106,1736195107,-21600,iPhone
com.apple.mobilenotes,4,1736194928,1736194932,1736194933,-21600,iPhone
com.ubercab.UberEats,10,1736194918,1736194928,1736194928,-21600,iPhone
com.ubercab.UberEats,2,1736194916,1736194918,1736194918,-21600,iPhone
com.google.calendar,7,1736194906,1736194913,1736194914,-21600,iPhone
com.apple.mobilenotes,2,1736194904,1736194906,1736194907,-21600,iPhone
com.apple.camera,11,1736194889,1736194900,1736194901,-21600,iPhone
com.apple.camera,2,1736194883,1736194885,1736194886,-21600,iPhone
com.netease.cloudmusic,11,1736194772,1736194783,1736194784,-21600,iPhone
com.apple.finder,46,1736194598,1736194644,1736194644,-21600,MacBook
com.netease.cloudmusic,7,1736194630,1736194637,1736194638,-21600,iPhone
com.apple.Preferences,8,1736194622,1736194630,1736194631,-21600,iPhone
com.netease.cloudmusic,4,1736194617,1736194621,1736194621,-21600,iPhone
com.apple.Preferences,2,1736194614,1736194616,1736194616,-21600,iPhone
com.microsoft.Office.Outlook,13,1736194601,1736194614,1736194614,-21600,iPhone
com.google.Chrome,40,1736194558,1736194598,1736194599,-21600,MacBook
com.apple.finder,9,1736194549,1736194558,1736194558,-21600,MacBook
com.microsoft.Outlook,3,1736194546,1736194549,1736194549,-21600,MacBook
com.google.Chrome,66,1736194480,1736194546,1736194547,-21600,MacBook
com.microsoft.Outlook,11,1736194469,1736194480,1736194481,-21600,MacBook
com.google.Chrome,1,1736194468,1736194469,1736194470,-21600,MacBook
com.microsoft.Outlook,24,1736194444,1736194468,1736194468,-21600,MacBook
com.google.Chrome,2,1736194442,1736194444,1736194444,-21600,MacBook
com.microsoft.Outlook,13,1736194429,1736194442,1736194442,-21600,MacBook
com.google.Chrome,3,1736194426,1736194429,1736194429,-21600,MacBook
com.microsoft.Outlook,3,1736194423,1736194426,1736194426,-21600,MacBook
com.google.Chrome,35,1736194388,1736194423,1736194423,-21600,MacBook
com.microsoft.Outlook,70,1736194318,1736194388,1736194389,-21600,MacBook
com.google.Chrome,13,1736194305,1736194318,1736194319,-21600,MacBook
com.microsoft.Outlook,99,1736194206,1736194305,1736194306,-21600,MacBook
com.google.Chrome,262,1736193944,1736194206,1736194207,-21600,MacBook
com.microsoft.Outlook,1,1736193943,1736193944,1736193945,-21600,MacBook
com.google.Chrome,1,1736193942,1736193943,1736193944,-21600,MacBook
com.microsoft.Outlook,10,1736193932,1736193942,1736193943,-21600,MacBook
com.google.Chrome,1,1736193931,1736193932,1736193933,-21600,MacBook
com.microsoft.Outlook,33,1736193898,1736193931,1736193932,-21600,MacBook
com.google.Chrome,909,1736192989,1736193898,1736193899,-21600,MacBook
com.microsoft.Outlook,10,1736192979,1736192989,1736192989,-21600,MacBook
com.google.Chrome,1409,1736191570,1736192979,1736192980,-21600,MacBook
com.microsoft.Outlook,11,1736191559,1736191570,1736191571,-21600,MacBook
com.apple.finder,0,1736191559,1736191559,1736191560,-21600,MacBook
com.google.Chrome,94,1736191465,1736191559,1736191560,-21600,MacBook
com.apple.finder,1,1736191464,1736191465,1736191465,-21600,MacBook
com.tencent.xinWeChat,4,1736191460,1736191464,1736191465,-21600,MacBook
com.microsoft.Outlook,9,1736191451,1736191460,1736191460,-21600,MacBook
com.apple.finder,0,1736191451,1736191451,1736191452,-21600,MacBook
com.google.Chrome,2361,1736189090,1736191451,1736191452,-21600,MacBook
com.apple.mobileslideshow,2,1736189122,1736189124,1736189125,-21600,iPhone
com.apple.finder,1,1736189089,1736189090,1736189090,-21600,MacBook
com.google.Chrome,69,1736189020,1736189089,1736189090,-21600,MacBook
com.apple.mobileslideshow,46,1736189040,1736189086,1736189087,-21600,iPhone
com.netease.cloudmusic,2,1736189038,1736189040,1736189041,-21600,iPhone
com.netease.cloudmusic,27,1736188907,1736188934,1736188934,-21600,iPhone
com.apple.Preferences,8,1736188899,1736188907,1736188907,-21600,iPhone
com.netease.cloudmusic,22,1736188877,1736188899,1736188900,-21600,iPhone
com.apple.Preferences,5,1736188869,1736188874,1736188875,-21600,iPhone
com.microsoft.Office.Outlook,4,1736188865,1736188869,1736188870,-21600,iPhone
com.microsoft.Office.Outlook,2,1736188861,1736188863,1736188863,-21600,iPhone
com.apple.Preferences,1,1736188860,1736188861,1736188862,-21600,iPhone
com.tencent.xin,6,1736188854,1736188860,1736188861,-21600,iPhone
com.tencent.xin,1,1736188689,1736188690,1736188690,-21600,iPhone
com.google.Chrome,23,1736188614,1736188637,1736188637,-21600,MacBook
com.google.Chrome,614,1736187958,1736188572,1736188573,-21600,MacBook
com.tencent.xin,1,1736187743,1736187744,1736187745,-21600,iPhone
com.google.Chrome,860,1736186700,1736187560,1736187561,-21600,MacBook
com.tencent.xin,1,1736187451,1736187452,1736187452,-21600,iPhone
com.tencent.xin,1,1736187187,1736187188,1736187188,-21600,iPhone
com.tencent.xin,28,1736186986,1736187014,1736187015,-21600,iPhone
com.tencent.xin,10,1736186792,1736186802,1736186802,-21600,iPhone
com.tencent.xin,10,1736186779,1736186789,1736186790,-21600,iPhone
com.tencent.xin,35,1736186708,1736186743,1736186744,-21600,iPhone
com.tencent.xin,5,1736186703,1736186708,1736186709,-21600,iPhone
com.google.Chrome,335,1736185951,1736186286,1736186286,-21600,MacBook
com.google.Chrome,318,1736185559,1736185877,1736185878,-21600,MacBook
com.google.Chrome,456,1736184890,1736185346,1736185346,-21600,MacBook
com.tencent.xinWeChat,28,1736184837,1736184865,1736184866,-21600,MacBook
com.apple.finder,0,1736184837,1736184837,1736184837,-21600,MacBook
com.google.Chrome,205,1736184632,1736184837,1736184837,-21600,MacBook
com.google.Chrome,73,1736184478,1736184551,1736184552,-21600,MacBook
com.apple.finder,68,1736184410,1736184478,1736184479,-21600,MacBook
com.apple.finder,15,1736181060,1736181075,1736181076,-21600,MacBook
com.tencent.xinWeChat,7,1736181053,1736181060,1736181060,-21600,MacBook
com.apple.finder,1,1736181052,1736181053,1736181054,-21600,MacBook
com.google.Chrome,3,1736181049,1736181052,1736181053,-21600,MacBook
com.ridewithvia.UCA.UniversityOfChicagoRider,28,1736144447,1736144475,1736144475,-21600,iPhone
com.ridewithvia.UCA.UniversityOfChicagoRider,13,1736144376,1736144389,1736144390,-21600,iPhone
com.ridewithvia.UCA.UniversityOfChicagoRider,9,1736144245,1736144254,1736144255,-21600,iPhone
com.ridewithvia.UCA.UniversityOfChicagoRider,84,1736144098,1736144182,1736144183,-21600,iPhone
com.ridewithvia.UCA.UniversityOfChicagoRider,42,1736144048,1736144090,1736144091,-21600,iPhone
com.microsoft.Office.Outlook,6,1736144041,1736144047,1736144047,-21600,iPhone
com.microsoft.Office.Outlook,20,1736143999,1736144019,1736144020,-21600,iPhone
com.tencent.xin,6,1736143991,1736143997,1736143997,-21600,iPhone
com.tencent.xin,1,1736143243,1736143244,1736143245,-21600,iPhone
com.tencent.xin,8,1736142957,1736142965,1736142966,-21600,iPhone
com.apple.camera,1,1736142964,1736142965,1736142965,-21600,iPhone
com.tencent.xin,3,1736142687,1736142690,1736142691,-21600,iPhone
com.google.calendar,21,1736142666,1736142687,1736142688,-21600,iPhone
com.tencent.xin,2,1736142664,1736142666,1736142666,-21600,iPhone
com.tencent.xin,4,1736142657,1736142661,1736142661,-21600,iPhone
com.tencent.xin,10,1736142410,1736142420,1736142420,-21600,iPhone
com.tencent.xin,32,1736142365,1736142397,1736142397,-21600,iPhone
com.tencent.xin,17,1736142041,1736142058,1736142058,-21600,iPhone
com.tencent.xin,84,1736141951,1736142035,1736142035,-21600,iPhone
com.ridewithvia.UCA.UniversityOfChicagoRider,3,1736141948,1736141951,1736141951,-21600,iPhone
com.ridewithvia.UCA.UniversityOfChicagoRider,10,1736141937,1736141947,1736141947,-21600,iPhone
com.ridewithvia.UCA.UniversityOfChicagoRider,14,1736141917,1736141931,1736141931,-21600,iPhone
com.ridewithvia.UCA.UniversityOfChicagoRider,10,1736141828,1736141838,1736141838,-21600,iPhone
com.ridewithvia.UCA.UniversityOfChicagoRider,10,1736141638,1736141648,1736141648,-21600,iPhone
com.ridewithvia.UCA.UniversityOfChicagoRider,67,1736141483,1736141550,1736141551,-21600,iPhone
com.apple.Health,3,1736141480,1736141483,1736141483,-21600,iPhone
com.tinyspeck.chatlyio,5,1736138697,1736138702,1736138703,-21600,iPhone
com.tencent.xin,6,1736138690,1736138696,1736138696,-21600,iPhone
com.tencent.xin,12,1736137925,1736137937,1736137937,-21600,iPhone
com.tencent.xin,58,1736137532,1736137590,1736137591,-21600,iPhone
com.tencent.xin,21,1736137509,1736137530,1736137530,-21600,iPhone
com.apple.mobiletimer,2,1736137507,1736137509,1736137510,-21600,iPhone
com.apple.mobiletimer,2,1736137326,1736137328,1736137328,-21600,iPhone
com.apple.mobiletimer,3,1736137053,1736137056,1736137056,-21600,iPhone
com.apple.mobiletimer,9,1736136390,1736136399,1736136399,-21600,iPhone
com.apple.mobiletimer,5,1736135534,1736135539,1736135540,-21600,iPhone
com.tencent.xin,7,1736135527,1736135534,1736135534,-21600,iPhone
com.tencent.xin,27,1736134191,1736134218,1736134219,-21600,iPhone
com.apple.camera,4,1736134183,1736134187,1736134188,-21600,iPhone
com.microsoft.Office.Outlook,26,1736133817,1736133843,1736133843,-21600,iPhone
com.openai.chat,2,1736133815,1736133817,1736133818,-21600,iPhone
com.microsoft.Office.Outlook,1,1736133814,1736133815,1736133816,-21600,iPhone
com.openai.chat,10,1736133804,1736133814,1736133814,-21600,iPhone
com.microsoft.Office.Outlook,79,1736133725,1736133804,1736133805,-21600,iPhone
com.microsoft.Office.Outlook,39,1736133669,1736133708,1736133710,-21600,iPhone
com.openai.chat,22,1736133647,1736133669,1736133670,-21600,iPhone
com.google.calendar,16,1736133631,1736133647,1736133648,-21600,iPhone
com.openai.chat,2,1736133629,1736133631,1736133632,-21600,iPhone
com.microsoft.Office.Outlook,62,1736133567,1736133629,1736133629,-21600,iPhone
com.microsoft.Office.Outlook,29,1736133498,1736133527,1736133528,-21600,iPhone
com.google.calendar,7,1736133491,1736133498,1736133499,-21600,iPhone
com.microsoft.Office.Outlook,31,1736133456,1736133487,1736133488,-21600,iPhone
com.tencent.xin,22,1736133434,1736133456,1736133456,-21600,iPhone
com.google.calendar,2,1736133432,1736133434,1736133434,-21600,iPhone
com.tencent.xin,5,1736133427,1736133432,1736133433,-21600,iPhone
com.google.calendar,3,1736133424,1736133427,1736133428,-21600,iPhone
com.tencent.xin,19,1736133405,1736133424,1736133425,-21600,iPhone
com.google.calendar,10,1736133395,1736133405,1736133406,-21600,iPhone
com.google.calendar,2,1736133324,1736133326,1736133327,-21600,iPhone
com.tencent.xin,7,1736133317,1736133324,1736133325,-21600,iPhone
com.google.calendar,6,1736133311,1736133317,1736133318,-21600,iPhone
com.tencent.xin,1,1736133310,1736133311,1736133312,-21600,iPhone
com.google.calendar,20,1736133290,1736133310,1736133310,-21600,iPhone
com.tencent.xin,11,1736133279,1736133290,1736133291,-21600,iPhone
com.google.calendar,1,1736133278,1736133279,1736133280,-21600,iPhone
com.tencent.xin,2,1736133276,1736133278,1736133278,-21600,iPhone
com.google.calendar,11,1736133265,1736133276,1736133276,-21600,iPhone
com.tencent.xin,64,1736133201,1736133265,1736133266,-21600,iPhone
com.tencent.xin,75,1736133121,1736133196,1736133197,-21600,iPhone
com.tencent.xin,50,1736132956,1736133006,1736133007,-21600,iPhone
com.differentsocial.Weee,3,1736128767,1736128770,1736128771,-21600,iPhone
com.differentsocial.Weee,27,1736127075,1736127102,1736127104,-21600,iPhone
com.differentsocial.Weee,60,1736127008,1736127068,1736127068,-21600,iPhone
com.differentsocial.Weee,230,1736126773,1736127003,1736127004,-21600,iPhone
com.differentsocial.Weee,7,1736126763,1736126770,1736126771,-21600,iPhone
com.differentsocial.Weee,8,1736126742,1736126750,1736126751,-21600,iPhone
com.differentsocial.Weee,32,1736126697,1736126729,1736126729,-21600,iPhone
com.differentsocial.Weee,33,1736126650,1736126683,1736126683,-21600,iPhone
com.differentsocial.Weee,45,1736126538,1736126583,1736126584,-21600,iPhone
com.apple.mobiletimer,5,1736126531,1736126536,1736126537,-21600,iPhone
com.apple.mobiletimer,4,1736126359,1736126363,1736126363,-21600,iPhone
com.tencent.xin,2,1736126356,1736126358,1736126359,-21600,iPhone
com.tencent.xin,1,1736125136,1736125137,1736125137,-21600,iPhone
com.tencent.xin,3,1736125114,1736125117,1736125117,-21600,iPhone
com.apple.MobileSMS,19,1736125095,1736125114,1736125114,-21600,iPhone
com.apple.MobileSMS,45,1736125046,1736125091,1736125092,-21600,iPhone
com.bilibili.bilicomic,3,1736125039,1736125042,1736125042,-21600,iPhone
com.bilibili.bilicomic,60,1736124965,1736125025,1736125026,-21600,iPhone
com.tencent.xin,36,1736124929,1736124965,1736124966,-21600,iPhone
com.apple.MobileSMS,36,1736124893,1736124929,1736124930,-21600,iPhone
com.chase,3,1736124890,1736124893,1736124894,-21600,iPhone
com.apple.MobileSMS,7,1736124883,1736124890,1736124891,-21600,iPhone
com.apple.MobileAddressBook,2,1736124881,1736124883,1736124884,-21600,iPhone
com.chase,14,1736124866,1736124880,1736124881,-21600,iPhone
com.apple.CoreAuthUI,2,1736124867,1736124869,1736124870,-21600,iPhone
com.tencent.xin,10,1736124856,1736124866,1736124867,-21600,iPhone
com.chase,2,1736124854,1736124856,1736124856,-21600,iPhone
com.tencent.xin,9,1736124842,1736124851,1736124851,-21600,iPhone
com.tencent.xin,2,1736124839,1736124841,1736124842,-21600,iPhone
com.tinyspeck.chatlyio,21,1736124818,1736124839,1736124839,-21600,iPhone
com.tencent.xin,4,1736124816,1736124820,1736124820,-21600,iPhone
com.tinyspeck.chatlyio,14,1736124802,1736124816,1736124817,-21600,iPhone
com.bilibili.bilicomic,5,1736124797,1736124802,1736124802,-21600,iPhone
com.openai.chat,2,1736124795,1736124797,1736124798,-21600,iPhone
com.bilibili.bilicomic,1,1736124788,1736124789,1736124790,-21600,iPhone
tv.danmaku.bilianime,2,1736124784,1736124786,1736124786,-21600,iPhone
com.apple.CoreAuthUI,2,1736124772,1736124774,1736124775,-21600,iPhone
com.bilibili.bilicomic,4,1736124761,1736124765,1736124765,-21600,iPhone
com.tinyspeck.chatlyio,3,1736124755,1736124758,1736124759,-21600,iPhone
com.google.chrome.ios,1,1736124754,1736124755,1736124756,-21600,iPhone
com.tencent.xin,4,1736124750,1736124754,1736124754,-21600,iPhone
com.google.chrome.ios,23,1736124727,1736124750,1736124751,-21600,iPhone
com.tinyspeck.chatlyio,1,1736124726,1736124727,1736124728,-21600,iPhone
com.tencent.xin,8,1736124718,1736124726,1736124726,-21600,iPhone
com.apple.mobilephone,4,1736124714,1736124718,1736124718,-21600,iPhone
com.tinyspeck.chatlyio,18,1736124696,1736124714,1736124715,-21600,iPhone
com.apple.MobileSMS,15,1736124681,1736124696,1736124696,-21600,iPhone
com.apple.mobilephone,24,1736124655,1736124679,1736124680,-21600,iPhone
com.tencent.xin,8,1736124646,1736124654,1736124655,-21600,iPhone
com.tencent.xin,38,1736124599,1736124637,1736124638,-21600,iPhone
com.tencent.xin,16,1736124577,1736124593,1736124594,-21600,iPhone
com.tinyspeck.chatlyio,14,1736124562,1736124576,1736124577,-21600,iPhone
com.google.chrome.ios,17,1736124545,1736124562,1736124563,-21600,iPhone
com.tinyspeck.chatlyio,1,1736124544,1736124545,1736124545,-21600,iPhone
com.google.chrome.ios,27,1736124515,1736124542,1736124542,-21600,iPhone
com.duosecurity.DuoMobile,4,1736124511,1736124515,1736124515,-21600,iPhone
com.google.chrome.ios,2,1736124509,1736124511,1736124511,-21600,iPhone
com.duosecurity.DuoMobile,14,1736124495,1736124509,1736124509,-21600,iPhone
com.google.chrome.ios,41,1736124454,1736124495,1736124495,-21600,iPhone
com.apple.CoreAuthUI,1,1736124486,1736124487,1736124488,-21600,iPhone
com.apple.CoreAuthUI,2,1736124478,1736124480,1736124481,-21600,iPhone
com.apple.Preferences,8,1736124445,1736124453,1736124454,-21600,iPhone
com.microsoft.Office.Outlook,6,1736124431,1736124437,1736124438,-21600,iPhone
com.tencent.xin,20,1736124410,1736124430,1736124430,-21600,iPhone
com.tencent.xin,27,1736124350,1736124377,1736124378,-21600,iPhone
com.tencent.xin,30,1736124274,1736124304,1736124304,-21600,iPhone
com.zimride.instant,7,1736124267,1736124274,1736124275,-21600,iPhone
com.tencent.xin,7,1736124260,1736124267,1736124267,-21600,iPhone
com.zimride.instant,10,1736124250,1736124260,1736124261,-21600,iPhone
com.tencent.xin,15,1736124235,1736124250,1736124251,-21600,iPhone
com.zimride.instant,3,1736124232,1736124235,1736124235,-21600,iPhone
com.zimride.instant,23,1736124059,1736124082,1736124083,-21600,iPhone
com.zimride.instant,7,1736124009,1736124016,1736124017,-21600,iPhone
com.ubercab.UberClient,10,1736123998,1736124008,1736124009,-21600,iPhone
com.zimride.instant,3,1736123995,1736123998,1736123998,-21600,iPhone
com.ubercab.UberClient,22,1736123973,1736123995,1736123995,-21600,iPhone
com.apple.PassbookUIService,6,1736123988,1736123994,1736123994,-21600,iPhone
com.zimride.instant,17,1736123956,1736123973,1736123974,-21600,iPhone
com.apple.PassbookUIService,10,1736123963,1736123973,1736123973,-21600,iPhone
com.apple.PassbookUIService,2,1736123958,1736123960,1736123961,-21600,iPhone
com.ubercab.UberClient,3,1736123953,1736123956,1736123957,-21600,iPhone
com.zimride.instant,8,1736123945,1736123953,1736123954,-21600,iPhone
com.ubercab.UberClient,8,1736123937,1736123945,1736123945,-21600,iPhone
com.zimride.instant,26,1736123911,1736123937,1736123938,-21600,iPhone
com.ubercab.UberClient,2,1736123909,1736123911,1736123912,-21600,iPhone
com.zimride.instant,1,1736123905,1736123906,1736123907,-21600,iPhone
com.ridewithvia.UCA.UniversityOfChicagoRider,40,1736123865,1736123905,1736123905,-21600,iPhone
com.zimride.instant,3,1736123862,1736123865,1736123865,-21600,iPhone
com.ridewithvia.UCA.UniversityOfChicagoRider,18,1736123841,1736123859,1736123859,-21600,iPhone
com.ridewithvia.UCA.UniversityOfChicagoRider,24,1736123798,1736123822,1736123823,-21600,iPhone
com.ridewithvia.UCA.UniversityOfChicagoRider,4,1736123678,1736123682,1736123682,-21600,iPhone
com.ridewithvia.UCA.UniversityOfChicagoRider,5,1736123658,1736123663,1736123664,-21600,iPhone
com.ridewithvia.UCA.UniversityOfChicagoRider,63,1736123528,1736123591,1736123592,-21600,iPhone
com.apple.mobiletimer,3,1736123525,1736123528,1736123528,-21600,iPhone
com.ridewithvia.UCA.UniversityOfChicagoRider,8,1736123517,1736123525,1736123525,-21600,iPhone
com.tencent.xin,2,1736123515,1736123517,1736123518,-21600,iPhone
com.tencent.xin,1,1736123220,1736123221,1736123222,-21600,iPhone
com.apple.mobiletimer,1,1736123219,1736123220,1736123220,-21600,iPhone
com.ridewithvia.UCA.UniversityOfChicagoRider,4,1736123215,1736123219,1736123219,-21600,iPhone
com.apple.mobiletimer,3,1736123212,1736123215,1736123216,-21600,iPhone
com.ridewithvia.UCA.UniversityOfChicagoRider,3,1736123209,1736123212,1736123212,-21600,iPhone
com.tencent.xin,11,1736123198,1736123209,1736123209,-21600,iPhone
com.tencent.xin,4,1736123000,1736123004,1736123005,-21600,iPhone
com.tencent.xin,22,1736122978,1736123000,1736123000,-21600,iPhone
com.ridewithvia.UCA.UniversityOfChicagoRider,6,1736122972,1736122978,1736122979,-21600,iPhone
com.tencent.xin,14,1736122958,1736122972,1736122973,-21600,iPhone
com.ridewithvia.UCA.UniversityOfChicagoRider,6,1736122952,1736122958,1736122959,-21600,iPhone
com.ridewithvia.UCA.UniversityOfChicagoRider,118,1736122785,1736122903,1736122904,-21600,iPhone
com.tencent.xin,4,1736122781,1736122785,1736122786,-21600,iPhone
com.netease.cloudmusic,2,1736122778,1736122780,1736122780,-21600,iPhone
com.ridewithvia.UCA.UniversityOfChicagoRider,9,1736122769,1736122778,1736122779,-21600,iPhone
com.netease.cloudmusic,3,1736122764,1736122767,1736122767,-21600,iPhone
com.tencent.xin,15,1736122749,1736122764,1736122765,-21600,iPhone
com.apple.Preferences,97,1736122652,1736122749,1736122750,-21600,iPhone
com.netease.cloudmusic,9,1736122643,1736122652,1736122652,-21600,iPhone
com.tencent.xin,2,1736122635,1736122637,1736122637,-21600,iPhone
com.tencent.xin,7,1736122449,1736122456,1736122457,-21600,iPhone
com.tencent.xin,16,1736122274,1736122290,1736122291,-21600,iPhone
com.ridewithvia.UCA.UniversityOfChicagoRider,1,1736122273,1736122274,1736122275,-21600,iPhone
com.tencent.xin,4,1736122269,1736122273,1736122273,-21600,iPhone
com.xingin.discover,13,1736122256,1736122269,1736122270,-21600,iPhone
com.amazon.Amazon,26,1736122230,1736122256,1736122259,-21600,iPhone
com.xingin.discover,19,1736122211,1736122230,1736122231,-21600,iPhone
com.amazon.Amazon,61,1736122150,1736122211,1736122212,-21600,iPhone
com.tencent.xin,8,1736122142,1736122150,1736122150,-21600,iPhone
com.amazon.Amazon,1,1736122141,1736122142,1736122143,-21600,iPhone
com.tencent.xin,19,1736122122,1736122141,1736122141,-21600,iPhone
com.amazon.Amazon,20,1736122102,1736122122,1736122124,-21600,iPhone
com.tencent.xin,1,1736122101,1736122102,1736122102,-21600,iPhone
com.tencent.xin,18,1736122082,1736122100,1736122101,-21600,iPhone
com.amazon.Amazon,4,1736122078,1736122082,1736122084,-21600,iPhone
com.xingin.discover,6,1736122072,1736122078,1736122078,-21600,iPhone
com.tencent.xin,20,1736122052,1736122072,1736122072,-21600,iPhone
com.xingin.discover,44,1736122008,1736122052,1736122053,-21600,iPhone
com.amazon.Amazon,21,1736121987,1736122008,1736122009,-21600,iPhone
com.tencent.xin,18,1736121969,1736121987,1736121988,-21600,iPhone
com.chase,12,1736121957,1736121969,1736121969,-21600,iPhone
com.apple.CoreAuthUI,3,1736121959,1736121962,1736121963,-21600,iPhone
com.tencent.xin,20,1736121936,1736121956,1736121956,-21600,iPhone
com.discoverfinancial.mobile,13,1736121922,1736121935,1736121936,-21600,iPhone
com.apple.CoreAuthUI,1,1736121927,1736121928,1736121929,-21600,iPhone
com.amazon.Amazon,52,1736121867,1736121919,1736121920,-21600,iPhone
com.xingin.discover,8,1736121859,1736121867,1736121868,-21600,iPhone
com.tencent.xin,9,1736121850,1736121859,1736121859,-21600,iPhone
com.xingin.discover,10,1736121839,1736121849,1736121850,-21600,iPhone
com.amazon.Amazon,17,1736121822,1736121839,1736121840,-21600,iPhone
com.xingin.discover,46,1736121774,1736121820,1736121820,-21600,iPhone
tv.danmaku.bilianime,2,1736121765,1736121767,1736121768,-21600,iPhone
tv.danmaku.bilianime,21,1736121265,1736121286,1736121287,-21600,iPhone
com.bilibili.bilicomic,1,1736121264,1736121265,1736121266,-21600,iPhone
tv.danmaku.bilianime,2,1736121262,1736121264,1736121264,-21600,iPhone
com.tencent.xin,18,1736121242,1736121260,1736121260,-21600,iPhone
com.bilibili.bilicomic,27,1736121214,1736121241,1736121242,-21600,iPhone
tv.danmaku.bilianime,1,1736121213,1736121214,1736121215,-21600,iPhone
com.bilibili.bilicomic,1,1736121212,1736121213,1736121214,-21600,iPhone
com.apple.mobilesafari,1922,1736119288,1736121210,1736121210,-21600,iPhone
com.tencent.xin,7,1736119281,1736119288,1736119289,-21600,iPhone
com.apple.mobilesafari,5,1736119276,1736119281,1736119282,-21600,iPhone
com.tencent.xin,15,1736119261,1736119276,1736119277,-21600,iPhone
com.apple.mobilesafari,17,1736119244,1736119261,1736119261,-21600,iPhone
com.tencent.xin,24,1736119220,1736119244,1736119244,-21600,iPhone
com.apple.mobilesafari,15,1736119205,1736119220,1736119221,-21600,iPhone
com.google.chrome.ios,2,1736119203,1736119205,1736119205,-21600,iPhone
com.tencent.xin,33,1736119170,1736119203,1736119204,-21600,iPhone
com.google.chrome.ios,17,1736119153,1736119170,1736119171,-21600,iPhone
com.tencent.xin,3,1736119149,1736119152,1736119152,-21600,iPhone
com.apple.mobilesafari,4,1736119145,1736119149,1736119150,-21600,iPhone
com.tencent.xin,31,1736119114,1736119145,1736119146,-21600,iPhone
com.apple.mobilesafari,53,1736119061,1736119114,1736119115,-21600,iPhone
com.google.chrome.ios,7,1736119054,1736119061,1736119061,-21600,iPhone
com.tencent.xin,47,1736119007,1736119054,1736119055,-21600,iPhone
com.google.chrome.ios,1,1736119005,1736119006,1736119006,-21600,iPhone
com.apple.mobilesafari,4,1736119001,1736119005,1736119005,-21600,iPhone
com.apple.mobilesafari,2546,1736116412,1736118958,1736118959,-21600,iPhone
com.google.chrome.ios,134,1736116276,1736116410,1736116411,-21600,iPhone
com.apple.mobiletimer,3,1736116273,1736116276,1736116277,-21600,iPhone
com.google.chrome.ios,13,1736116258,1736116271,1736116272,-21600,iPhone
com.bilibili.bilicomic,814,1736115442,1736116256,1736116257,-21600,iPhone
com.apple.mobiletimer,5,1736115437,1736115442,1736115443,-21600,iPhone
com.apple.mobiletimer,4,1736115364,1736115368,1736115369,-21600,iPhone
com.bilibili.bilicomic,1,1736115362,1736115363,1736115364,-21600,iPhone
com.xingin.discover,6,1736115355,1736115361,1736115362,-21600,iPhone
com.apple.camera,1,1736115355,1736115356,1736115356,-21600,iPhone
com.xingin.discover,31,1736115243,1736115274,1736115275,-21600,iPhone
com.xingin.discover,293,1736114703,1736114996,1736114997,-21600,iPhone
com.bilibili.bilicomic,6,1736114254,1736114260,1736114261,-21600,iPhone
tv.danmaku.bilianime,0,1736114254,1736114254,1736114255,-21600,iPhone
com.bilibili.bilicomic,2,1736114251,1736114253,1736114254,-21600,iPhone
com.tencent.xin,7,1736114241,1736114248,1736114248,-21600,iPhone
com.tencent.xin,2,1736113587,1736113589,1736113590,-21600,iPhone
com.tencent.xin,20,1736113565,1736113585,1736113586,-21600,iPhone
com.tencent.xin,18,1736113454,1736113472,1736113473,-21600,iPhone
com.tencent.xin,10,1736113403,1736113413,1736113414,-21600,iPhone
com.tencent.xin,31,1736113329,1736113360,1736113361,-21600,iPhone
com.tencent.xin,67,1736112924,1736112991,1736112992,-21600,iPhone
com.apple.mobiletimer,18,1736112790,1736112808,1736112809,-21600,iPhone
com.tencent.xin,2,1736112788,1736112790,1736112790,-21600,iPhone
com.tencent.xin,41,1736112747,1736112788,1736112788,-21600,iPhone
com.tencent.xin,45,1736112681,1736112726,1736112727,-21600,iPhone
com.tencent.xin,10,1736112588,1736112598,1736112599,-21600,iPhone
com.tencent.xin,10,1736112524,1736112534,1736112535,-21600,iPhone
com.tencent.xin,10,1736112513,1736112523,1736112523,-21600,iPhone
com.tencent.xin,94,1736112399,1736112493,1736112493,-21600,iPhone
com.apple.camera,2,1736112401,1736112403,1736112404,-21600,iPhone
com.tencent.xin,10,1736112359,1736112369,1736112370,-21600,iPhone
com.tencent.xin,10,1736112340,1736112350,1736112351,-21600,iPhone
com.tencent.xin,25,1736112311,1736112336,1736112337,-21600,iPhone
com.tencent.xin,10,1736112296,1736112306,1736112307,-21600,iPhone
com.tencent.xin,45,1736112213,1736112258,1736112259,-21600,iPhone
com.tencent.xin,6,1736112169,1736112175,1736112176,-21600,iPhone
com.tencent.xin,38,1736112122,1736112160,1736112161,-21600,iPhone
com.tencent.xin,39,1736112055,1736112094,1736112095,-21600,iPhone
com.tencent.xin,19,1736111860,1736111879,1736111880,-21600,iPhone
com.tinyspeck.chatlyio,7,1736111853,1736111860,1736111860,-21600,iPhone
com.microsoft.Office.Outlook,6,1736111846,1736111852,1736111853,-21600,iPhone
com.tinyspeck.chatlyio,1,1736111845,1736111846,1736111847,-21600,iPhone
com.tencent.xin,22,1736111822,1736111844,1736111845,-21600,iPhone
com.tencent.xin,7,1736111783,1736111790,1736111791,-21600,iPhone
com.tencent.xin,6,1736111711,1736111717,1736111718,-21600,iPhone
com.tencent.xin,49,1736111661,1736111710,1736111710,-21600,iPhone
com.tencent.xin,33,1736111452,1736111485,1736111486,-21600,iPhone
com.apple.mobiletimer,9,1736111441,1736111450,1736111450,-21600,iPhone
com.apple.mobiletimer,25,1736110574,1736110599,1736110599,-21600,iPhone
com.apple.mobiletimer,5,1736110034,1736110039,1736110039,-21600,iPhone
com.apple.mobiletimer,14,1736110020,1736110034,1736110034,-21600,iPhone
com.apple.mobiletimer,23,1736106882,1736106905,1736106906,-21600,iPhone
com.apple.mobiletimer,2,1736106880,1736106882,1736106882,-21600,iPhone
com.openai.chat,11,1736106868,1736106879,1736106880,-21600,iPhone
com.openai.chat,25,1736106420,1736106445,1736106445,-21600,iPhone
com.openai.chat,25,1736106000,1736106025,1736106025,-21600,iPhone
com.openai.chat,25,1736103600,1736103625,1736103625,-21600,iPhone
com.openai.chat,25,1736102701,1736102726,1736102726,-21600,iPhone
com.openai.chat,121,1736096901,1736097022,1736097023,-21600,iPhone
com.microsoft.Office.Outlook,7,1736096894,1736096901,1736096902,-21600,iPhone
com.openai.chat,684,1736096210,1736096894,1736096895,-21600,iPhone
com.tencent.xin,97,1736096113,1736096210,1736096210,-21600,iPhone
com.microsoft.Office.Outlook,24,1736096089,1736096113,1736096113,-21600,iPhone
com.microsoft.Office.Outlook,7,1736083122,1736083129,1736083129,-21600,iPhone
com.apple.camera,1,1736083122,1736083123,1736083123,-21600,iPhone
com.apple.camera,0,1736083120,1736083120,1736083121,-21600,iPhone
com.microsoft.Office.Outlook,1,1736083119,1736083120,1736083121,-21600,iPhone
com.microsoft.Office.Outlook,10,1736083038,1736083048,1736083049,-21600,iPhone
com.openai.chat,2,1736083036,1736083038,1736083038,-21600,iPhone
com.microsoft.Office.Outlook,9,1736083027,1736083036,1736083036,-21600,iPhone
com.openai.chat,1,1736083024,1736083025,1736083026,-21600,iPhone
com.tencent.xin,10,1736083014,1736083024,1736083025,-21600,iPhone
com.openai.chat,4,1736083010,1736083014,1736083015,-21600,iPhone
com.openai.chat,474,1736082535,1736083009,1736083010,-21600,iPhone
com.tencent.xin,32,1736082441,1736082473,1736082473,-21600,iPhone
com.tencent.xin,40,1736082269,1736082309,1736082310,-21600,iPhone
com.microsoft.Office.Outlook,2,1736082267,1736082269,1736082269,-21600,iPhone
com.tencent.xin,1,1736082266,1736082267,1736082268,-21600,iPhone
com.google.chrome.ios,1368,1736079941,1736081309,1736081310,-21600,iPhone
com.bilibili.bilicomic,1,1736079940,1736079941,1736079942,-21600,iPhone
com.google.chrome.ios,5,1736079932,1736079937,1736079938,-21600,iPhone
com.apple.mobiletimer,16,1736079911,1736079927,1736079927,-21600,iPhone
com.xingin.discover,155,1736079746,1736079901,1736079902,-21600,iPhone
com.xingin.discover,1350,1736078326,1736079676,1736079676,-21600,iPhone
com.chase,5,1736078321,1736078326,1736078327,-21600,iPhone
com.apple.CoreAuthUI,2,1736078322,1736078324,1736078324,-21600,iPhone
com.xingin.discover,15,1736078306,1736078321,1736078321,-21600,iPhone
com.chase,0,1736078306,1736078306,1736078307,-21600,iPhone
com.xingin.discover,95,1736078206,1736078301,1736078302,-21600,iPhone
com.tencent.xin,140,1736078066,1736078206,1736078207,-21600,iPhone
com.tencent.xin,273,1736077791,1736078064,1736078065,-21600,iPhone
com.xingin.discover,35,1736077756,1736077791,1736077792,-21600,iPhone
com.amazon.Amazon,66,1736077690,1736077756,1736077756,-21600,iPhone
com.tencent.xin,423,1736077267,1736077690,1736077691,-21600,iPhone
com.amazon.Amazon,30,1736077237,1736077267,1736077268,-21600,iPhone
com.tencent.xin,1,1736077236,1736077237,1736077238,-21600,iPhone
com.xingin.discover,17,1736077219,1736077236,1736077237,-21600,iPhone
com.tencent.xin,48,1736077171,1736077219,1736077220,-21600,iPhone
com.amazon.Amazon,1,1736077170,1736077171,1736077171,-21600,iPhone
com.xingin.discover,64,1736077106,1736077170,1736077170,-21600,iPhone
com.amazon.Amazon,12,1736077094,1736077106,1736077106,-21600,iPhone
com.tencent.xin,245,1736076849,1736077094,1736077095,-21600,iPhone
com.xingin.discover,1,1736076848,1736076849,1736076851,-21600,iPhone
com.amazon.Amazon,11,1736076837,1736076848,1736076850,-21600,iPhone
com.xingin.discover,6,1736076831,1736076837,1736076837,-21600,iPhone
com.tencent.xin,92,1736076739,1736076831,1736076832,-21600,iPhone
com.xingin.discover,16,1736076723,1736076739,1736076740,-21600,iPhone
com.tencent.xin,47,1736076676,1736076723,1736076723,-21600,iPhone
com.xingin.discover,21,1736076654,1736076675,1736076676,-21600,iPhone
com.tencent.xin,1,1736076653,1736076654,1736076654,-21600,iPhone
com.xingin.discover,219,1736076433,1736076652,1736076653,-21600,iPhone
com.amazon.Amazon,8,1736076425,1736076433,1736076434,-21600,iPhone
com.apple.calculator,10,1736076415,1736076425,1736076425,-21600,iPhone
com.amazon.Amazon,98,1736076315,1736076413,1736076414,-21600,iPhone
com.openai.chat,4,1736076311,1736076315,1736076316,-21600,iPhone
com.amazon.Amazon,7,1736076304,1736076311,1736076313,-21600,iPhone
com.openai.chat,45,1736076259,1736076304,1736076304,-21600,iPhone
com.amazon.Amazon,36,1736076223,1736076259,1736076260,-21600,iPhone
com.openai.chat,82,1736076141,1736076223,1736076224,-21600,iPhone
com.xingin.discover,1,1736076140,1736076141,1736076141,-21600,iPhone
com.google.chrome.ios,3,1736076137,1736076140,1736076140,-21600,iPhone
com.xingin.discover,90,1736076047,1736076137,1736076137,-21600,iPhone
com.openai.chat,48,1736075999,1736076047,1736076048,-21600,iPhone
com.google.chrome.ios,2,1736075997,1736075999,1736075999,-21600,iPhone
com.xingin.discover,86,1736075911,1736075997,1736075998,-21600,iPhone
com.openai.chat,40,1736075871,1736075911,1736075912,-21600,iPhone
com.xingin.discover,141,1736075729,1736075870,1736075871,-21600,iPhone
com.apple.mobilenotes,3,1736075726,1736075729,1736075730,-21600,iPhone
com.xingin.discover,8,1736075716,1736075724,1736075724,-21600,iPhone
com.google.chrome.ios,14,1736075702,1736075716,1736075717,-21600,iPhone
com.xingin.discover,207,1736075495,1736075702,1736075703,-21600,iPhone
com.google.chrome.ios,18,1736075477,1736075495,1736075495,-21600,iPhone
com.xingin.discover,41,1736075436,1736075477,1736075477,-21600,iPhone
com.amazon.Amazon,220,1736075216,1736075436,1736075438,-21600,iPhone
com.xingin.discover,1,1736075215,1736075216,1736075217,-21600,iPhone
com.amazon.Amazon,1,1736075206,1736075207,1736075208,-21600,iPhone
com.zimride.instant,11,1736075191,1736075202,1736075202,-21600,iPhone
com.zimride.instant,6,1736075179,1736075185,1736075186,-21600,iPhone
com.apple.camera,4,1736074770,1736074774,1736074776,-21600,iPhone
com.zimride.instant,7,1736074767,1736074774,1736074776,-21600,iPhone
com.zimride.instant,14,1736074227,1736074241,1736074242,-21600,iPhone
com.zimride.instant,8,1736074215,1736074223,1736074223,-21600,iPhone
com.zimride.instant,5,1736073956,1736073961,1736073962,-21600,iPhone
com.ubercab.UberClient,2,1736073954,1736073956,1736073957,-21600,iPhone
com.ubercab.UberClient,2,1736073869,1736073871,1736073872,-21600,iPhone
com.zimride.instant,28,1736073841,1736073869,1736073869,-21600,iPhone
com.apple.PassbookUIService,10,1736073855,1736073865,1736073865,-21600,iPhone
com.ubercab.UberClient,22,1736073819,1736073841,1736073842,-21600,iPhone
com.ubercab.UberClient,1,1736073815,1736073816,1736073817,-21600,iPhone
com.ridewithvia.UCA.UniversityOfChicagoRider,22,1736073792,1736073814,1736073815,-21600,iPhone
com.ridewithvia.UCA.UniversityOfChicagoRider,12,1736073777,1736073789,1736073789,-21600,iPhone
com.google.Chrome,59,1736073073,1736073132,1736073132,-21600,MacBook
com.apple.finder,0,1736072722,1736072722,1736072723,-21600,MacBook
com.google.Chrome,5,1736072717,1736072722,1736072722,-21600,MacBook
com.google.Chrome,385,1736071941,1736072326,1736072326,-21600,MacBook
com.apple.finder,3,1736071938,1736071941,1736071941,-21600,MacBook
com.google.Chrome,121,1736071817,1736071938,1736071939,-21600,MacBook
com.tencent.xinWeChat,5,1736071484,1736071489,1736071489,-21600,MacBook
com.google.Chrome,304,1736071180,1736071484,1736071485,-21600,MacBook
com.ridewithvia.UCA.UniversityOfChicagoRider,6,1736071095,1736071101,1736071101,-21600,iPhone
com.ridewithvia.UCA.UniversityOfChicagoRider,162,1736070774,1736070936,1736070937,-21600,iPhone
com.google.chrome.ios,3,1736070764,1736070767,1736070767,-21600,iPhone
com.google.chrome.ios,6,1736070457,1736070463,1736070464,-21600,iPhone
com.google.chrome.ios,2,1736070454,1736070456,1736070457,-21600,iPhone
com.google.chrome.ios,5,1736070447,1736070452,1736070453,-21600,iPhone
com.google.chrome.ios,6,1736070440,1736070446,1736070447,-21600,iPhone
com.google.chrome.ios,8,1736070254,1736070262,1736070263,-21600,iPhone
com.google.chrome.ios,6,1736070225,1736070231,1736070231,-21600,iPhone
com.google.chrome.ios,6,1736070206,1736070212,1736070213,-21600,iPhone
com.google.chrome.ios,6,1736070199,1736070205,1736070206,-21600,iPhone
com.google.chrome.ios,6,1736070187,1736070193,1736070194,-21600,iPhone
com.google.chrome.ios,2,1736070179,1736070181,1736070181,-21600,iPhone
com.google.chrome.ios,13,1736070077,1736070090,1736070091,-21600,iPhone
com.google.chrome.ios,19,1736070054,1736070073,1736070073,-21600,iPhone
com.google.chrome.ios,10,1736070030,1736070040,1736070040,-21600,iPhone
com.google.chrome.ios,28,1736069987,1736070015,1736070015,-21600,iPhone
com.google.chrome.ios,24,1736069934,1736069958,1736069958,-21600,iPhone
com.google.chrome.ios,12,1736069909,1736069921,1736069922,-21600,iPhone
com.apple.weather,5,1736069903,1736069908,1736069909,-21600,iPhone
com.google.Maps,2,1736069899,1736069901,1736069902,-21600,iPhone
com.google.Maps,13,1736068342,1736068355,1736068356,-21600,iPhone
com.google.Maps,51,1736068169,1736068220,1736068220,-21600,iPhone
com.google.Maps,10,1736068159,1736068169,1736068169,-21600,iPhone
com.apple.weather,15,1736068144,1736068159,1736068159,-21600,iPhone
com.apple.mobilenotes,5,1736068136,1736068141,1736068142,-21600,iPhone
com.apple.mobilenotes,184,1736067936,1736068120,1736068120,-21600,iPhone
com.apple.mobilenotes,2,1736067788,1736067790,1736067790,-21600,iPhone
com.tencent.xin,16,1736067771,1736067787,1736067788,-21600,iPhone
com.apple.mobilenotes,1,1736067769,1736067770,1736067770,-21600,iPhone
com.google.chrome.ios,3,1736067766,1736067769,1736067769,-21600,iPhone
com.google.chrome.ios,1,1736067731,1736067732,1736067733,-21600,iPhone
com.google.chrome.ios,4,1736067726,1736067730,1736067730,-21600,iPhone
com.google.chrome.ios,105,1736067274,1736067379,1736067380,-21600,iPhone
com.google.chrome.ios,15,1736067257,1736067272,1736067273,-21600,iPhone
com.apple.mobilenotes,14,1736067234,1736067248,1736067249,-21600,iPhone
com.netease.cloudmusic,3,1736067230,1736067233,1736067234,-21600,iPhone
com.netease.cloudmusic,26,1736067108,1736067134,1736067135,-21600,iPhone
com.apple.mobilenotes,3,1736067101,1736067104,1736067104,-21600,iPhone
com.apple.mobilenotes,2,1736067031,1736067033,1736067033,-21600,iPhone
com.apple.mobilenotes,2,1736067026,1736067028,1736067029,-21600,iPhone
com.bilibili.bilicomic,3,1736067023,1736067026,1736067026,-21600,iPhone
com.bilibili.bilicomic,9,1736067005,1736067014,1736067015,-21600,iPhone
com.apple.mobilenotes,14,1736066990,1736067004,1736067004,-21600,iPhone
com.apple.mobilenotes,31,1736066901,1736066932,1736066933,-21600,iPhone
com.apple.mobilenotes,3,1736066839,1736066842,1736066843,-21600,iPhone
com.tencent.xin,8,1736066831,1736066839,1736066840,-21600,iPhone
com.bilibili.bilicomic,14,1736066722,1736066736,1736066737,-21600,iPhone
com.tencent.xin,2,1736066716,1736066718,1736066718,-21600,iPhone
com.tencent.xin,104,1736066610,1736066714,1736066715,-21600,iPhone
com.tencent.xin,6,1736066516,1736066522,1736066523,-21600,iPhone
com.tencent.xin,17,1736066305,1736066322,1736066322,-21600,iPhone
com.google.chrome.ios,3,1736066302,1736066305,1736066306,-21600,iPhone
com.google.chrome.ios,30,1736066136,1736066166,1736066167,-21600,iPhone
com.tencent.xin,16,1736066120,1736066136,1736066137,-21600,iPhone
com.google.chrome.ios,50,1736066070,1736066120,1736066121,-21600,iPhone
com.amazon.Amazon,2,1736066067,1736066069,1736066070,-21600,iPhone
com.google.chrome.ios,35,1736066032,1736066067,1736066068,-21600,iPhone
com.tencent.xin,2,1736066029,1736066031,1736066031,-21600,iPhone
com.bilibili.bilicomic,4,1736065250,1736065254,1736065255,-21600,iPhone
com.tencent.xin,4,1736065245,1736065249,1736065249,-21600,iPhone
com.tencent.xin,5,1736065156,1736065161,1736065162,-21600,iPhone
com.apple.camera,0,1736065161,1736065161,1736065162,-21600,iPhone
com.tencent.xin,2,1736065152,1736065154,1736065155,-21600,iPhone
com.tencent.xin,20,1736065086,1736065106,1736065107,-21600,iPhone
com.tencent.xin,19,1736065042,1736065061,1736065061,-21600,iPhone
com.tencent.xin,12,1736065025,1736065037,1736065038,-21600,iPhone
com.apple.camera,0,1736065028,1736065028,1736065028,-21600,iPhone
com.tencent.xin,22,1736064962,1736064984,1736064985,-21600,iPhone
com.tencent.xin,11,1736064943,1736064954,1736064954,-21600,iPhone
com.apple.camera,0,1736064947,1736064947,1736064948,-21600,iPhone
com.tencent.xin,2,1736064568,1736064570,1736064570,-21600,iPhone
com.tencent.xin,6,1736063672,1736063678,1736063679,-21600,iPhone
com.tencent.xin,6,1736062990,1736062996,1736062997,-21600,iPhone
com.tencent.xin,9,1736062865,1736062874,1736062875,-21600,iPhone
com.tencent.xin,56,1736062807,1736062863,1736062864,-21600,iPhone
com.tencent.xin,18,1736062747,1736062765,1736062766,-21600,iPhone
com.tencent.xin,14,1736062644,1736062658,1736062658,-21600,iPhone
com.tencent.xin,1,1736062613,1736062614,1736062615,-21600,iPhone
com.bilibili.bilicomic,7,1736062606,1736062613,1736062613,-21600,iPhone
com.tencent.xin,3,1736062603,1736062606,1736062607,-21600,iPhone
com.tencent.xin,13,1736062585,1736062598,1736062599,-21600,iPhone
com.bilibili.bilicomic,24,1736062561,1736062585,1736062586,-21600,iPhone
com.naver.linewebtoon,1,1736062559,1736062560,1736062561,-21600,iPhone
com.bilibili.bilicomic,1,1736062558,1736062559,1736062560,-21600,iPhone
tv.danmaku.bilianime,3,1736062555,1736062558,1736062558,-21600,iPhone
com.bilibili.bilicomic,1,1736062554,1736062555,1736062556,-21600,iPhone
com.tencent.xin,16,1736062533,1736062549,1736062549,-21600,iPhone
com.tencent.xin,65,1736062463,1736062528,1736062529,-21600,iPhone
com.apple.mobiletimer,2,1736062461,1736062463,1736062463,-21600,iPhone
com.tencent.xin,3,1736062457,1736062460,1736062460,-21600,iPhone
com.tencent.xin,44,1736062412,1736062456,1736062457,-21600,iPhone
com.tencent.xin,12,1736060865,1736060877,1736060878,-21600,iPhone
com.tencent.xin,74,1736060660,1736060734,1736060734,-21600,iPhone
com.tencent.xin,138,1736060483,1736060621,1736060621,-21600,iPhone
com.tencent.xin,315,1736060105,1736060420,1736060421,-21600,iPhone
com.tencent.xin,5,1736059905,1736059910,1736059911,-21600,iPhone
com.tencent.xin,29,1736059820,1736059849,1736059849,-21600,iPhone
com.tencent.xin,49,1736059757,1736059806,1736059807,-21600,iPhone
com.tencent.xin,25,1736059722,1736059747,1736059747,-21600,iPhone
com.tencent.xin,155,1736059488,1736059643,1736059644,-21600,iPhone
com.tencent.xin,87,1736059369,1736059456,1736059457,-21600,iPhone
com.tencent.xin,148,1736059152,1736059300,1736059301,-21600,iPhone
com.tencent.xin,222,1736058854,1736059076,1736059076,-21600,iPhone
com.tencent.xin,34,1736058787,1736058821,1736058821,-21600,iPhone
com.tencent.xin,27,1736058731,1736058758,1736058759,-21600,iPhone
com.tencent.xin,192,1736058525,1736058717,1736058718,-21600,iPhone
com.tencent.xin,94,1736058391,1736058485,1736058486,-21600,iPhone
com.apple.PassbookUIService,31,1736058302,1736058333,1736058333,-21600,iPhone
com.tencent.xin,8,1736058289,1736058297,1736058297,-21600,iPhone
com.google.Chrome,12,1736058191,1736058203,1736058203,-21600,MacBook
com.tinyspeck.slackmacgap,17,1736058174,1736058191,1736058191,-21600,MacBook
com.valvesoftware.steam,60,1736058114,1736058174,1736058175,-21600,MacBook
com.tinyspeck.slackmacgap,2,1736058112,1736058114,1736058115,-21600,MacBook
com.google.Chrome,64,1736058048,1736058112,1736058112,-21600,MacBook
com.tinyspeck.slackmacgap,1,1736058047,1736058048,1736058048,-21600,MacBook
com.google.Chrome,25,1736058022,1736058047,1736058048,-21600,MacBook
com.tinyspeck.slackmacgap,4,1736058018,1736058022,1736058022,-21600,MacBook
com.google.Chrome,3,1736058015,1736058018,1736058019,-21600,MacBook
com.tinyspeck.slackmacgap,29,1736057986,1736058015,1736058015,-21600,MacBook
com.apple.finder,0,1736057986,1736057986,1736057987,-21600,MacBook
com.google.Chrome,19,1736057967,1736057986,1736057986,-21600,MacBook
com.valvesoftware.steam,5,1736057962,1736057967,1736057967,-21600,MacBook
com.google.Chrome,52,1736057910,1736057962,1736057963,-21600,MacBook
com.valvesoftware.steam,7,1736057903,1736057910,1736057911,-21600,MacBook
com.tencent.xin,2,1736057887,1736057889,1736057890,-21600,iPhone
com.valvesoftware.steam,63,1736057773,1736057836,1736057837,-21600,MacBook
com.tencent.xinWeChat,13,1736057760,1736057773,1736057774,-21600,MacBook
com.valvesoftware.steam,175,1736057585,1736057760,1736057761,-21600,MacBook
com.tencent.xinWeChat,61,1736057524,1736057585,1736057585,-21600,MacBook
com.apple.finder,0,1736057524,1736057524,1736057525,-21600,MacBook
com.google.Chrome,6,1736057518,1736057524,1736057525,-21600,MacBook
com.valvesoftware.steam,6,1736057512,1736057518,1736057518,-21600,MacBook
com.tencent.xinWeChat,3,1736057509,1736057512,1736057512,-21600,MacBook
com.valvesoftware.steam,1,1736057508,1736057509,1736057510,-21600,MacBook
com.tencent.xinWeChat,3,1736057505,1736057508,1736057509,-21600,MacBook
com.valvesoftware.steam,2,1736057503,1736057505,1736057506,-21600,MacBook
com.tencent.xinWeChat,26,1736057477,1736057503,1736057504,-21600,MacBook
com.tencent.xin,48,1736057451,1736057499,1736057500,-21600,iPhone
com.valvesoftware.steam,17,1736057460,1736057477,1736057478,-21600,MacBook
com.tencent.xinWeChat,28,1736057432,1736057460,1736057461,-21600,MacBook
com.tencent.xin,20,1736057429,1736057449,1736057449,-21600,iPhone
com.valvesoftware.steam,2,1736057430,1736057432,1736057433,-21600,MacBook
com.tencent.xinWeChat,4,1736057422,1736057426,1736057427,-21600,MacBook
com.google.Chrome,28,1736057394,1736057422,1736057423,-21600,MacBook
com.tencent.xinWeChat,10,1736057384,1736057394,1736057395,-21600,MacBook
com.valvesoftware.steam,31,1736057353,1736057384,1736057385,-21600,MacBook
com.microsoft.Outlook,13,1736057340,1736057353,1736057354,-21600,MacBook
com.valvesoftware.steam,1,1736057339,1736057340,1736057340,-21600,MacBook
com.microsoft.Outlook,2,1736057337,1736057339,1736057339,-21600,MacBook
com.valvesoftware.steam,1,1736057336,1736057337,1736057337,-21600,MacBook
com.microsoft.Outlook,13,1736057323,1736057336,1736057337,-21600,MacBook
com.valvesoftware.steam,4,1736057319,1736057323,1736057329,-21600,MacBook
com.microsoft.Outlook,0,1736057319,1736057319,1736057328,-21600,MacBook
com.valvesoftware.steam,1,1736057318,1736057319,1736057327,-21600,MacBook
com.microsoft.Outlook,3,1736057315,1736057318,1736057321,-21600,MacBook
com.google.Chrome,4,1736057311,1736057315,1736057318,-21600,MacBook
com.tencent.xin,2,1736057250,1736057252,1736057253,-21600,iPhone
com.tencent.xin,6,1736056648,1736056654,1736056655,-21600,iPhone
com.tencent.xin,2,1736056639,1736056641,1736056642,-21600,iPhone
com.tencent.xin,2,1736056632,1736056634,1736056634,-21600,iPhone
com.tencent.xin,19,1736056580,1736056599,1736056600,-21600,iPhone
tv.danmaku.bilianime,8,1736052907,1736052915,1736052916,-21600,iPhone
com.apple.PassbookUIService,31,1736051551,1736051582,1736051582,-21600,iPhone
tv.danmaku.bilianime,31,1736051551,1736051582,1736051582,-21600,iPhone
tv.danmaku.bilianime,16,1736051518,1736051534,1736051534,-21600,iPhone
com.bilibili.bilicomic,45,1736051473,1736051518,1736051519,-21600,iPhone
tv.danmaku.bilianime,1,1736051472,1736051473,1736051473,-21600,iPhone
com.bilibili.bilicomic,2,1736051470,1736051472,1736051472,-21600,iPhone
com.zimride.instant,11,1736051454,1736051465,1736051466,-21600,iPhone
com.tencent.xin,3,1736051447,1736051450,1736051451,-21600,iPhone
com.tencent.xin,6,1736051389,1736051395,1736051396,-21600,iPhone
com.tencent.xin,4,1736051049,1736051053,1736051054,-21600,iPhone
com.tencent.xin,19,1736050341,1736050360,1736050360,-21600,iPhone
com.apple.camera,1,1736050352,1736050353,1736050354,-21600,iPhone
com.apple.camera,3,1736050344,1736050347,1736050348,-21600,iPhone
com.tencent.xin,6,1736050317,1736050323,1736050323,-21600,iPhone
com.tencent.xin,1,1736050309,1736050310,1736050311,-21600,iPhone
com.tencent.xin,14,1736050251,1736050265,1736050266,-21600,iPhone
com.tencent.xin,2,1736049318,1736049320,1736049321,-21600,iPhone
com.tencent.xin,2,1736046587,1736046589,1736046589,-21600,iPhone
com.tencent.xin,24,1736046069,1736046093,1736046094,-21600,iPhone
com.xingin.discover,260,1736045807,1736046067,1736046067,-21600,iPhone
com.xfinity.digitalhome,2,1736045804,1736045806,1736045807,-21600,iPhone
com.google.chrome.ios,2,1736045798,1736045800,1736045802,-21600,iPhone
com.amazon.Amazon,61,1736045732,1736045793,1736045795,-21600,iPhone
com.tencent.xin,2,1736045728,1736045730,1736045731,-21600,iPhone
com.tencent.xin,23,1736045701,1736045724,1736045725,-21600,iPhone
com.xingin.discover,4,1736045697,1736045701,1736045701,-21600,iPhone
com.xingin.discover,48,1736045640,1736045688,1736045689,-21600,iPhone
com.tencent.xin,3,1736045637,1736045640,1736045641,-21600,iPhone
com.xingin.discover,12,1736045625,1736045637,1736045638,-21600,iPhone
com.tencent.xin,1,1736045624,1736045625,1736045626,-21600,iPhone
com.xingin.discover,1,1736045621,1736045622,1736045623,-21600,iPhone
tv.danmaku.bilianime,114,1736045505,1736045619,1736045620,-21600,iPhone
com.apple.mobiletimer,4,1736045501,1736045505,1736045506,-21600,iPhone
tv.danmaku.bilianime,8,1736045493,1736045501,1736045501,-21600,iPhone
com.google.Chrome,160,1736044778,1736044938,1736044939,-21600,MacBook
com.microsoft.Outlook,2,1736044776,1736044778,1736044778,-21600,MacBook
com.google.Chrome,12,1736044764,1736044776,1736044777,-21600,MacBook
com.microsoft.Outlook,13,1736044751,1736044764,1736044764,-21600,MacBook
com.apple.finder,1,1736044750,1736044751,1736044752,-21600,MacBook
com.google.Chrome,46,1736044704,1736044750,1736044751,-21600,MacBook
com.apple.finder,1,1736044703,1736044704,1736044705,-21600,MacBook
com.google.Chrome,6,1736044697,1736044703,1736044704,-21600,MacBook
com.microsoft.Outlook,8,1736044689,1736044697,1736044698,-21600,MacBook
com.google.Chrome,350,1736044339,1736044689,1736044690,-21600,MacBook
tv.danmaku.bilianime,7,1736044332,1736044339,1736044339,-21600,iPhone
tv.danmaku.bilianime,29,1736043955,1736043984,1736043985,-21600,iPhone
com.netease.cloudmusic,3,1736043951,1736043954,1736043954,-21600,iPhone
com.netease.cloudmusic,37,1736043576,1736043613,1736043614,-21600,iPhone
com.xingin.discover,1,1736043575,1736043576,1736043577,-21600,iPhone
tv.danmaku.bilianime,3,1736043571,1736043574,1736043574,-21600,iPhone
tv.danmaku.bilianime,37,1736043524,1736043561,1736043561,-21600,iPhone
tv.danmaku.bilianime,16,1736043427,1736043443,1736043444,-21600,iPhone
com.microsoft.Outlook,35,1736043230,1736043265,1736043266,-21600,MacBook
com.apple.finder,0,1736043230,1736043230,1736043230,-21600,MacBook
com.google.Chrome,76,1736043154,1736043230,1736043230,-21600,MacBook
com.apple.mobiletimer,5,1736042023,1736042028,1736042028,-21600,iPhone
com.tencent.xin,63,1736041958,1736042021,1736042022,-21600,iPhone
com.microsoft.Office.Outlook,13,1736041945,1736041958,1736041959,-21600,iPhone
com.microsoft.Outlook,3,1736041948,1736041951,1736041952,-21600,MacBook
com.google.Chrome,83,1736041865,1736041948,1736041948,-21600,MacBook
com.tencent.xin,6,1736041938,1736041944,1736041945,-21600,iPhone
com.microsoft.Outlook,29,1736041836,1736041865,1736041865,-21600,MacBook
com.google.Chrome,33,1736041803,1736041836,1736041836,-21600,MacBook
com.microsoft.Outlook,39,1736041764,1736041803,1736041804,-21600,MacBook
com.apple.finder,0,1736041764,1736041764,1736041764,-21600,MacBook
com.google.Chrome,194,1736041570,1736041764,1736041764,-21600,MacBook
com.apple.finder,10,1736041560,1736041570,1736041571,-21600,MacBook
com.google.Chrome,28,1736041532,1736041560,1736041561,-21600,MacBook
com.apple.finder,2,1736041530,1736041532,1736041533,-21600,MacBook
com.google.Chrome,55,1736041475,1736041530,1736041531,-21600,MacBook
com.apple.mobiletimer,2,1736041484,1736041486,1736041486,-21600,iPhone
com.ubercab.UberEats,5,1736041479,1736041484,1736041485,-21600,iPhone
com.apple.mobiletimer,4,1736041480,1736041484,1736041485,-21600,iPhone
com.google.Chrome,340,1736041103,1736041443,1736041443,-21600,MacBook
com.apple.finder,1,1736041102,1736041103,1736041103,-21600,MacBook
com.microsoft.Outlook,24,1736041078,1736041102,1736041102,-21600,MacBook
com.google.Chrome,29,1736041049,1736041078,1736041078,-21600,MacBook
com.microsoft.Outlook,41,1736041008,1736041049,1736041050,-21600,MacBook
com.apple.finder,0,1736041008,1736041008,1736041009,-21600,MacBook
com.google.Chrome,232,1736040776,1736041008,1736041009,-21600,MacBook
com.apple.finder,1,1736040775,1736040776,1736040777,-21600,MacBook
com.google.Chrome,21,1736040754,1736040775,1736040775,-21600,MacBook
com.microsoft.Outlook,1,1736040753,1736040754,1736040755,-21600,MacBook
com.google.Chrome,17,1736040736,1736040753,1736040754,-21600,MacBook
com.apple.finder,6,1736040730,1736040736,1736040737,-21600,MacBook
com.google.Chrome,25,1736040705,1736040730,1736040730,-21600,MacBook
com.apple.mobilenotes,5,1736040317,1736040322,1736040323,-21600,iPhone
com.ubercab.UberEats,11,1736040306,1736040317,1736040317,-21600,iPhone
com.ubercab.UberEats,18,1736040285,1736040303,1736040304,-21600,iPhone
com.apple.mobilenotes,7,1736040278,1736040285,1736040285,-21600,iPhone
com.ubercab.UberEats,19,1736040259,1736040278,1736040279,-21600,iPhone
com.apple.mobilenotes,13,1736040246,1736040259,1736040260,-21600,iPhone
com.ubercab.UberEats,20,1736040226,1736040246,1736040246,-21600,iPhone
com.apple.mobilenotes,6,1736040220,1736040226,1736040227,-21600,iPhone
com.ubercab.UberEats,16,1736040204,1736040220,1736040221,-21600,iPhone
com.apple.mobilenotes,6,1736040195,1736040201,1736040202,-21600,iPhone
com.apple.mobilenotes,8,1736040182,1736040190,1736040191,-21600,iPhone
com.apple.mobilenotes,10,1736040161,1736040171,1736040172,-21600,iPhone
com.differentsocial.Weee,12,1736040149,1736040161,1736040162,-21600,iPhone
com.apple.mobilenotes,76,1736040070,1736040146,1736040146,-21600,iPhone
com.amazon.Amazon,3,1736040067,1736040070,1736040071,-21600,iPhone
com.amazon.Amazon,11,1736040037,1736040048,1736040049,-21600,iPhone
com.amazon.Amazon,258,1736039771,1736040029,1736040030,-21600,iPhone
com.xingin.discover,17,1736039535,1736039552,1736039552,-21600,iPhone
com.xingin.discover,28,1736039452,1736039480,1736039480,-21600,iPhone
com.zimride.instant,1,1736039451,1736039452,1736039453,-21600,iPhone
com.xingin.discover,1,1736039450,1736039451,1736039451,-21600,iPhone
com.zimride.instant,2,1736039448,1736039450,1736039450,-21600,iPhone
com.apple.mobilenotes,70,1736039376,1736039446,1736039447,-21600,iPhone
com.apple.MobileSMS,4,1736039370,1736039374,1736039374,-21600,iPhone
com.apple.MobileSMS,5,1736038996,1736039001,1736039001,-21600,iPhone
com.zimride.instant,1,1736038992,1736038993,1736038994,-21600,iPhone
com.tencent.xin,3,1736038989,1736038992,1736038993,-21600,iPhone
com.tencent.xin,13,1736038621,1736038634,1736038635,-21600,iPhone
com.tencent.xin,3,1736038482,1736038485,1736038486,-21600,iPhone
com.tencent.xin,1,1736038453,1736038454,1736038455,-21600,iPhone
com.apple.MobileSMS,4,1736038449,1736038453,1736038453,-21600,iPhone
com.apple.mobiletimer,2,1736038444,1736038446,1736038447,-21600,iPhone
com.tencent.xin,3,1736038441,1736038444,1736038445,-21600,iPhone
com.zimride.instant,11,1736038430,1736038441,1736038441,-21600,iPhone
com.tencent.xin,35,1736038395,1736038430,1736038431,-21600,iPhone
com.zimride.instant,5,1736038390,1736038395,1736038396,-21600,iPhone
com.zimride.instant,39,1736038282,1736038321,1736038322,-21600,iPhone
com.zimride.instant,17,1736038177,1736038194,1736038194,-21600,iPhone
com.apple.camera,0,1736038187,1736038187,1736038188,-21600,iPhone
com.apple.camera,0,1736038180,1736038180,1736038181,-21600,iPhone
com.zimride.instant,17,1736038156,1736038173,1736038174,-21600,iPhone
com.zimride.instant,36,1736038029,1736038065,1736038066,-21600,iPhone
com.ridewithvia.UCA.UniversityOfChicagoRider,2,1736038022,1736038024,1736038025,-21600,iPhone
com.ridewithvia.UCA.UniversityOfChicagoRider,22,1736037999,1736038021,1736038022,-21600,iPhone
com.tencent.xin,5,1736037994,1736037999,1736038000,-21600,iPhone
com.ridewithvia.UCA.UniversityOfChicagoRider,1,1736037993,1736037994,1736037995,-21600,iPhone
com.tencent.xin,2,1736037989,1736037991,1736037991,-21600,iPhone
com.apple.mobiletimer,3,1736037657,1736037660,1736037661,-21600,iPhone
com.tencent.xin,3,1736037654,1736037657,1736037658,-21600,iPhone
com.tencent.xin,32,1736037462,1736037494,1736037495,-21600,iPhone
com.ridewithvia.UCA.UniversityOfChicagoRider,21,1736037441,1736037462,1736037463,-21600,iPhone
com.ridewithvia.UCA.UniversityOfChicagoRider,51,1736037284,1736037335,1736037336,-21600,iPhone
com.tencent.xin,11,1736037269,1736037280,1736037281,-21600,iPhone
com.tencent.xin,10,1736036670,1736036680,1736036681,-21600,iPhone
com.tencent.xin,2,1736036398,1736036400,1736036401,-21600,iPhone
com.tencent.xin,1,1736036312,1736036313,1736036313,-21600,iPhone
com.tencent.xin,12,1736036287,1736036299,1736036300,-21600,iPhone
com.tencent.xin,10,1736036077,1736036087,1736036087,-21600,iPhone
com.tencent.xin,8,1736036061,1736036069,1736036070,-21600,iPhone
com.tencent.xin,38,1736036020,1736036058,1736036059,-21600,iPhone
com.apple.mobiletimer,2,1736035918,1736035920,1736035921,-21600,iPhone
com.xingin.discover,8,1736035910,1736035918,1736035918,-21600,iPhone
com.tencent.xin,3,1736035907,1736035910,1736035910,-21600,iPhone
com.xingin.discover,492,1736035415,1736035907,1736035908,-21600,iPhone
com.tencent.xin,4,1736035411,1736035415,1736035416,-21600,iPhone
com.xingin.discover,398,1736035013,1736035411,1736035411,-21600,iPhone
com.tencent.xin,2,1736035011,1736035013,1736035013,-21600,iPhone
com.tencent.xin,6,1736034703,1736034709,1736034709,-21600,iPhone
com.xingin.discover,401,1736034302,1736034703,1736034703,-21600,iPhone
tv.danmaku.bilianime,1,1736034301,1736034302,1736034304,-21600,iPhone
com.xingin.discover,1,1736034300,1736034301,1736034301,-21600,iPhone
com.apple.mobiletimer,2,1736034295,1736034297,1736034298,-21600,iPhone
com.tencent.xin,2,1736034293,1736034295,1736034296,-21600,iPhone
com.tencent.xin,24,1736034269,1736034293,1736034294,-21600,iPhone
com.tencent.xin,27,1736034241,1736034268,1736034270,-21600,iPhone
com.apple.mobiletimer,1,1736034240,1736034241,1736034242,-21600,iPhone
com.tencent.xin,9,1736034231,1736034240,1736034240,-21600,iPhone
com.xingin.discover,519,1736033705,1736034224,1736034225,-21600,iPhone
com.tencent.xin,6,1736033698,1736033704,1736033705,-21600,iPhone
com.xingin.discover,681,1736033017,1736033698,1736033699,-21600,iPhone
com.tencent.xin,3,1736033014,1736033017,1736033018,-21600,iPhone
com.xingin.discover,379,1736032635,1736033014,1736033014,-21600,iPhone
com.tencent.xin,4,1736032631,1736032635,1736032636,-21600,iPhone
com.xingin.discover,534,1736032097,1736032631,1736032632,-21600,iPhone
com.tencent.xin,5,1736032092,1736032097,1736032097,-21600,iPhone
com.xingin.discover,1,1736032091,1736032092,1736032093,-21600,iPhone
com.tencent.xin,12,1736032079,1736032091,1736032092,-21600,iPhone
com.xingin.discover,1296,1736030783,1736032079,1736032080,-21600,iPhone
com.tencent.xin,43,1736030740,1736030783,1736030784,-21600,iPhone
com.google.chrome.ios,14,1736030726,1736030740,1736030741,-21600,iPhone
com.tencent.xin,29,1736030696,1736030725,1736030725,-21600,iPhone
com.google.chrome.ios,3,1736030693,1736030696,1736030697,-21600,iPhone
com.tencent.xin,7,1736030686,1736030693,1736030693,-21600,iPhone
com.tencent.xin,14,1736030672,1736030686,1736030686,-21600,iPhone
com.google.chrome.ios,11,1736030661,1736030672,1736030673,-21600,iPhone
com.tencent.xin,1,1736030660,1736030661,1736030661,-21600,iPhone
com.google.chrome.ios,128,1736030531,1736030659,1736030660,-21600,iPhone
com.apple.CoreAuthUI,2,1736030559,1736030561,1736030562,-21600,iPhone
com.apple.CoreAuthUI,2,1736030553,1736030555,1736030556,-21600,iPhone
com.xingin.discover,2,1736030529,1736030531,1736030531,-21600,iPhone
com.tencent.xin,12,1736030512,1736030524,1736030524,-21600,iPhone
com.tencent.xin,27,1736030395,1736030422,1736030423,-21600,iPhone
com.apple.camera,4,1736030403,1736030407,1736030407,-21600,iPhone
com.tencent.xin,14,1736030289,1736030303,1736030304,-21600,iPhone
com.openai.chat,1,1736030286,1736030287,1736030288,-21600,iPhone
com.apple.mobiletimer,3,1736030283,1736030286,1736030286,-21600,iPhone
com.apple.mobiletimer,3,1736029992,1736029995,1736029995,-21600,iPhone
com.apple.mobiletimer,6,1736029944,1736029950,1736029950,-21600,iPhone
com.apple.mobiletimer,2,1736029941,1736029943,1736029943,-21600,iPhone
com.tencent.xin,7,1736029934,1736029941,1736029941,-21600,iPhone
com.openai.chat,1,1736029933,1736029934,1736029935,-21600,iPhone
com.apple.mobiletimer,6,1736029927,1736029933,1736029933,-21600,iPhone
com.openai.chat,38,1736029888,1736029926,1736029927,-21600,iPhone
com.apple.MobileSMS,3,1736029884,1736029887,1736029887,-21600,iPhone
com.tencent.xin,40,1736029841,1736029881,1736029882,-21600,iPhone
com.tencent.xin,12,1736029440,1736029452,1736029453,-21600,iPhone
com.tencent.xin,11,1736029409,1736029420,1736029420,-21600,iPhone
com.tencent.xin,49,1736029355,1736029404,1736029405,-21600,iPhone
com.apple.mobilephone,8,1736029347,1736029355,1736029356,-21600,iPhone
com.tencent.xin,1,1736029344,1736029345,1736029346,-21600,iPhone
com.tencent.xin,5,1736029336,1736029341,1736029342,-21600,iPhone
com.apple.camera,4,1736029337,1736029341,1736029342,-21600,iPhone
com.tencent.xin,12,1736029279,1736029291,1736029292,-21600,iPhone
com.tencent.xin,1,1736029271,1736029272,1736029273,-21600,iPhone
com.tencent.xin,32,1736029213,1736029245,1736029246,-21600,iPhone
com.microsoft.Office.Outlook,8,1736029205,1736029213,1736029214,-21600,iPhone
com.tencent.xin,1,1736029204,1736029205,1736029206,-21600,iPhone
com.xingin.discover,7,1736029195,1736029202,1736029203,-21600,iPhone
com.xingin.discover,1,1736029194,1736029195,1736029195,-21600,iPhone
com.xingin.discover,6,1736020319,1736020325,1736020326,-21600,iPhone
com.xingin.discover,995,1736019324,1736020319,1736020320,-21600,iPhone
com.microsoft.Office.Outlook,13,1736019309,1736019322,1736019323,-21600,iPhone
com.google.chrome.ios,2,1736019307,1736019309,1736019310,-21600,iPhone
com.tencent.xin,343,1736018963,1736019306,1736019307,-21600,iPhone
com.chase,21,1736019118,1736019139,1736019140,-21600,iPhone
com.discoverfinancial.mobile,15,1736019103,1736019118,1736019119,-21600,iPhone
com.apple.CoreAuthUI,3,1736019110,1736019113,1736019114,-21600,iPhone
com.chase,12,1736019091,1736019103,1736019104,-21600,iPhone
com.discoverfinancial.mobile,5,1736019086,1736019091,1736019092,-21600,iPhone
com.chase,30,1736019055,1736019085,1736019086,-21600,iPhone
com.apple.CoreAuthUI,2,1736019066,1736019068,1736019070,-21600,iPhone
com.google.calendar,4,1736019044,1736019048,1736019049,-21600,iPhone
com.google.chrome.ios,3,1736019038,1736019041,1736019042,-21600,iPhone
com.microsoft.Office.Outlook,3,1736018960,1736018963,1736018964,-21600,iPhone
com.tencent.xin,2,1736018958,1736018960,1736018960,-21600,iPhone
com.apple.camera,1,1736018955,1736018956,1736018956,-21600,iPhone
com.tencent.xin,17,1736018734,1736018751,1736018751,-21600,iPhone
com.tencent.xin,49,1736018684,1736018733,1736018733,-21600,iPhone
com.tinyspeck.chatlyio,7,1736018675,1736018682,1736018682,-21600,iPhone
com.xingin.discover,5,1736018670,1736018675,1736018676,-21600,iPhone
com.xingin.discover,1351,1735990307,1735991658,1735991659,-21600,iPhone
com.tencent.xin,4,1735990303,1735990307,1735990308,-21600,iPhone
com.google.chrome.ios,19,1735990284,1735990303,1735990304,-21600,iPhone
com.google.chrome.ios,4,1735990120,1735990124,1735990124,-21600,iPhone
com.google.chrome.ios,102,1735989658,1735989760,1735989761,-21600,iPhone
com.apple.mobilesafari,4761,1735984897,1735989658,1735989659,-21600,iPhone
com.apple.mobilesafari,211,1735984637,1735984848,1735984848,-21600,iPhone
com.apple.mobilesafari,195,1735984398,1735984593,1735984593,-21600,iPhone
com.apple.camera,38,1735984403,1735984441,1735984442,-21600,iPhone
com.apple.camera,1,1735984400,1735984401,1735984401,-21600,iPhone
com.apple.mobilesafari,10,1735984375,1735984385,1735984386,-21600,iPhone
com.apple.camera,1,1735984378,1735984379,1735984379,-21600,iPhone
com.apple.mobilesafari,119,1735984207,1735984326,1735984327,-21600,iPhone
com.apple.mobilesafari,6,1735984137,1735984143,1735984143,-21600,iPhone
com.apple.mobilesafari,2048,1735981945,1735983993,1735983994,-21600,iPhone
com.google.chrome.ios,2810,1735979133,1735981943,1735981944,-21600,iPhone
com.apple.camera,11,1735979122,1735979133,1735979134,-21600,iPhone
com.google.chrome.ios,300,1735978820,1735979120,1735979120,-21600,iPhone
com.apple.camera,23,1735978796,1735978819,1735978820,-21600,iPhone
com.google.chrome.ios,843,1735977951,1735978794,1735978795,-21600,iPhone
com.google.chrome.ios,303,1735977643,1735977946,1735977946,-21600,iPhone
com.google.chrome.ios,439,1735977180,1735977619,1735977619,-21600,iPhone
com.xingin.discover,46,1735977133,1735977179,1735977180,-21600,iPhone
com.microsoft.Office.Outlook,3,1735977129,1735977132,1735977133,-21600,iPhone
com.apple.Preferences,5,1735977124,1735977129,1735977130,-21600,iPhone
com.microsoft.Office.Outlook,2,1735977122,1735977124,1735977124,-21600,iPhone
com.xingin.discover,11,1735977108,1735977119,1735977120,-21600,iPhone
com.xingin.discover,2,1735977019,1735977021,1735977021,-21600,iPhone
com.xingin.discover,2263,1735974742,1735977005,1735977006,-21600,iPhone
com.microsoft.Office.Outlook,5,1735974737,1735974742,1735974742,-21600,iPhone
com.google.chrome.ios,9,1735974728,1735974737,1735974738,-21600,iPhone
com.microsoft.Office.Outlook,1,1735974727,1735974728,1735974729,-21600,iPhone
com.google.chrome.ios,2,1735974725,1735974727,1735974727,-21600,iPhone
com.xingin.discover,743,1735973981,1735974724,1735974725,-21600,iPhone
com.xingin.discover,1,1735973978,1735973979,1735973980,-21600,iPhone
com.xingin.discover,168,1735973628,1735973796,1735973796,-21600,iPhone
com.xingin.discover,76,1735972985,1735973061,1735973061,-21600,iPhone
com.xingin.discover,214,1735969928,1735970142,1735970143,-21600,iPhone
com.xingin.discover,94,1735969373,1735969467,1735969468,-21600,iPhone
com.xingin.discover,1,1735969067,1735969068,1735969069,-21600,iPhone
com.xingin.discover,4,1735969055,1735969059,1735969060,-21600,iPhone
com.xingin.discover,75,1735968498,1735968573,1735968574,-21600,iPhone
com.xingin.discover,106,1735968231,1735968337,1735968338,-21600,iPhone
com.xingin.discover,48,1735968169,1735968217,1735968218,-21600,iPhone
com.xingin.discover,104,1735967726,1735967830,1735967831,-21600,iPhone
com.google.Chrome,21,1735967502,1735967523,1735967523,-21600,MacBook
com.xingin.discover,39,1735967455,1735967494,1735967495,-21600,iPhone
com.google.Chrome,17,1735967153,1735967170,1735967170,-21600,MacBook
com.xingin.discover,531,1735966610,1735967141,1735967141,-21600,iPhone
com.xingin.discover,559,1735966050,1735966609,1735966610,-21600,iPhone
com.google.Chrome,511,1735965756,1735966267,1735966268,-21600,MacBook
com.tencent.xin,67,1735965981,1735966048,1735966049,-21600,iPhone
com.tencent.xin,51,1735965514,1735965565,1735965566,-21600,iPhone
com.tencent.xin,3,1735965479,1735965482,1735965483,-21600,iPhone
com.zimride.instant,58,1735965421,1735965479,1735965480,-21600,iPhone
com.google.Chrome,370,1735965082,1735965452,1735965452,-21600,MacBook
com.microsoft.Office.Outlook,6,1735965413,1735965419,1735965419,-21600,iPhone
com.tencent.xin,3,1735965410,1735965413,1735965413,-21600,iPhone
com.tencent.xin,1,1735965401,1735965402,1735965402,-21600,iPhone
com.tencent.xin,9,1735965391,1735965400,1735965401,-21600,iPhone
com.tencent.xin,123,1735964959,1735965082,1735965083,-21600,iPhone
com.tencent.xin,27,1735964922,1735964949,1735964949,-21600,iPhone
com.tencent.xin,13,1735964907,1735964920,1735964921,-21600,iPhone
com.tencent.xin,2,1735964848,1735964850,1735964850,-21600,iPhone
com.tencent.xin,94,1735964601,1735964695,1735964697,-21600,iPhone
com.xingin.discover,4,1735964597,1735964601,1735964601,-21600,iPhone
com.xingin.discover,6333,1735958063,1735964396,1735964397,-21600,iPhone
com.xingin.discover,639,1735957412,1735958051,1735958052,-21600,iPhone
com.xingin.discover,2969,1735954432,1735957401,1735957402,-21600,iPhone
com.google.Chrome,807,1735953750,1735954557,1735954557,-21600,MacBook
com.xingin.discover,285,1735954138,1735954423,1735954424,-21600,iPhone
com.tencent.xin,6,1735954131,1735954137,1735954138,-21600,iPhone
com.tencent.xin,56,1735953258,1735953314,1735953315,-21600,iPhone
com.google.Chrome,673,1735952464,1735953137,1735953138,-21600,MacBook
com.apple.finder,35,1735952429,1735952464,1735952465,-21600,MacBook
com.tencent.xin,29,1735952434,1735952463,1735952464,-21600,iPhone
com.tencent.xin,10,1735950523,1735950533,1735950533,-21600,iPhone
com.apple.finder,5,1735950261,1735950266,1735950266,-21600,MacBook
com.google.Chrome,2806,1735947455,1735950261,1735950261,-21600,MacBook
com.google.Chrome,5,1735947361,1735947366,1735947367,-21600,MacBook
com.apple.finder,19,1735947342,1735947361,1735947362,-21600,MacBook
com.google.Chrome,5,1735947337,1735947342,1735947342,-21600,MacBook
com.tencent.xin,8,1735947301,1735947309,1735947310,-21600,iPhone
com.tencent.xin,6,1735947271,1735947277,1735947278,-21600,iPhone
com.tencent.xin,7,1735947257,1735947264,1735947264,-21600,iPhone
tv.danmaku.bilianime,9,1735946923,1735946932,1735946933,-21600,iPhone
com.bilibili.bilicomic,22,1735946900,1735946922,1735946923,-21600,iPhone
tv.danmaku.bilianime,1,1735946899,1735946900,1735946900,-21600,iPhone
com.bilibili.bilicomic,1,1735946898,1735946899,1735946899,-21600,iPhone
tv.danmaku.bilianime,1,1735946897,1735946898,1735946898,-21600,iPhone
tv.danmaku.bilianime,2,1735946894,1735946896,1735946897,-21600,iPhone
com.tencent.xin,5,1735946666,1735946671,1735946671,-21600,iPhone
com.tencent.xin,10,1735946654,1735946664,1735946664,-21600,iPhone
com.xingin.discover,666,1735945983,1735946649,1735946650,-21600,iPhone
com.tencent.xin,12,1735945971,1735945983,1735945984,-21600,iPhone
com.xingin.discover,736,1735945234,1735945970,1735945971,-21600,iPhone
tv.danmaku.bilianime,2,1735945232,1735945234,1735945234,-21600,iPhone
com.apple.MobileSMS,4,1735945226,1735945230,1735945231,-21600,iPhone
com.tencent.xin,7,1735945215,1735945222,1735945223,-21600,iPhone
com.xingin.discover,315,1735944900,1735945215,1735945216,-21600,iPhone
com.tencent.xin,2,1735944898,1735944900,1735944900,-21600,iPhone
com.xingin.discover,4,1735944894,1735944898,1735944899,-21600,iPhone
com.tencent.xin,67,1735944827,1735944894,1735944895,-21600,iPhone
com.xingin.discover,139,1735944688,1735944827,1735944828,-21600,iPhone
com.tencent.xin,24,1735944664,1735944688,1735944689,-21600,iPhone
com.xingin.discover,22,1735944642,1735944664,1735944665,-21600,iPhone
com.xingin.discover,187,1735944455,1735944642,1735944642,-21600,iPhone
com.tencent.xin,12,1735944443,1735944455,1735944456,-21600,iPhone
com.xingin.discover,5,1735944438,1735944443,1735944443,-21600,iPhone
com.tencent.xin,1,1735944437,1735944438,1735944439,-21600,iPhone
com.xingin.discover,401,1735944036,1735944437,1735944437,-21600,iPhone
com.bilibili.bilicomic,82,1735943951,1735944033,1735944033,-21600,iPhone
tv.danmaku.bilianime,37,1735943912,1735943949,1735943950,-21600,iPhone
com.tencent.xin,22,1735943890,1735943912,1735943913,-21600,iPhone
tv.danmaku.bilianime,2,1735943887,1735943889,1735943890,-21600,iPhone
com.bilibili.bilicomic,2,1735943885,1735943887,1735943888,-21600,iPhone
com.tencent.xin,2,1735943883,1735943885,1735943886,-21600,iPhone
com.bilibili.bilicomic,127,1735943756,1735943883,1735943883,-21600,iPhone
tv.danmaku.bilianime,1,1735943755,1735943756,1735943756,-21600,iPhone
com.xingin.discover,1,1735943751,1735943752,1735943753,-21600,iPhone
com.bilibili.bilicomic,1,1735943749,1735943750,1735943751,-21600,iPhone
com.tencent.xin,168,1735943579,1735943747,1735943747,-21600,iPhone
com.tencent.xin,2,1735943577,1735943579,1735943579,-21600,iPhone
com.google.chrome.ios,4,1735943573,1735943577,1735943577,-21600,iPhone
com.google.chrome.ios,1,1735943485,1735943486,1735943486,-21600,iPhone
com.google.chrome.ios,1377,1735942095,1735943472,1735943472,-21600,iPhone
com.apple.CoreAuthUI,2,1735942113,1735942115,1735942115,-21600,iPhone
tv.danmaku.bilianime,75,1735942017,1735942092,1735942093,-21600,iPhone
tv.danmaku.bilianime,609,1735941386,1735941995,1735941996,-21600,iPhone
com.naver.linewebtoon,3,1735941383,1735941386,1735941387,-21600,iPhone
com.tencent.xin,299,1735941082,1735941381,1735941381,-21600,iPhone
com.microsoft.Office.Outlook,45,1735941037,1735941082,1735941083,-21600,iPhone
com.tencent.xin,1,1735941036,1735941037,1735941038,-21600,iPhone
com.tencent.xin,5,1735941030,1735941035,1735941035,-21600,iPhone
com.apple.camera,1,1735941011,1735941012,1735941012,-21600,iPhone
com.netease.lofter,712,1735905892,1735906604,1735906605,-21600,iPhone
com.google.Chrome,296,1735905476,1735905772,1735905773,-21600,MacBook
com.google.Chrome,1410,1735904056,1735905466,1735905467,-21600,MacBook
com.bilibili.bilicomic,29,1735904214,1735904243,1735904243,-21600,iPhone
com.naver.linewebtoon,1,1735904213,1735904214,1735904215,-21600,iPhone
com.bilibili.bilicomic,1,1735904212,1735904213,1735904214,-21600,iPhone
com.xingin.discover,13,1735904090,1735904103,1735904104,-21600,iPhone
com.ubercab.UberEats,2,1735904088,1735904090,1735904090,-21600,iPhone
tv.danmaku.bilianime,2,1735903776,1735903778,1735903779,-21600,iPhone
com.tencent.xin,2,1735903771,1735903773,1735903774,-21600,iPhone
com.apple.Health,13,1735903755,1735903768,1735903768,-21600,iPhone
com.tencent.xin,2,1735903752,1735903754,1735903755,-21600,iPhone
com.tencent.xin,2,1735903734,1735903736,1735903737,-21600,iPhone
com.tencent.xin,1,1735903701,1735903702,1735903703,-21600,iPhone
com.apple.camera,0,1735903702,1735903702,1735903703,-21600,iPhone
com.google.Chrome,412,1735903286,1735903698,1735903698,-21600,MacBook
com.tencent.xin,20,1735903500,1735903520,1735903521,-21600,iPhone
com.tencent.xin,18,1735903402,1735903420,1735903421,-21600,iPhone
com.tencent.xin,36,1735901943,1735901979,1735901980,-21600,iPhone
com.tencent.xin,2,1735901596,1735901598,1735901598,-21600,iPhone
com.tencent.xin,10,1735901259,1735901269,1735901270,-21600,iPhone
com.tencent.xin,7,1735900880,1735900887,1735900887,-21600,iPhone
com.tencent.xin,1,1735900826,1735900827,1735900828,-21600,iPhone
com.tencent.xin,290,1735900516,1735900806,1735900807,-21600,iPhone
com.tencent.xin,1,1735900510,1735900511,1735900512,-21600,iPhone
com.tencent.xin,144,1735900309,1735900453,1735900453,-21600,iPhone
com.google.Chrome,690,1735899726,1735900416,1735900417,-21600,MacBook
com.tencent.xin,36,1735900236,1735900272,1735900273,-21600,iPhone
com.apple.camera,15,1735900220,1735900235,1735900237,-21600,iPhone
com.tencent.xin,15,1735900218,1735900233,1735900236,-21600,iPhone
com.tencent.xin,32,1735899878,1735899910,1735899911,-21600,iPhone
com.tencent.xin,3,1735899874,1735899877,1735899877,-21600,iPhone
com.tencent.xin,21,1735899705,1735899726,1735899727,-21600,iPhone
com.tencent.xin,8,1735899693,1735899701,1735899701,-21600,iPhone
com.tencent.xin,17,1735899520,1735899537,1735899538,-21600,iPhone
com.tencent.xin,33,1735899486,1735899519,1735899520,-21600,iPhone
com.apple.PassbookUIService,33,1735899486,1735899519,1735899520,-21600,iPhone
com.tencent.xin,3,1735899479,1735899482,1735899483,-21600,iPhone
com.tencent.xin,2,1735899477,1735899479,1735899479,-21600,iPhone
com.apple.mobiletimer,6,1735897115,1735897121,1735897122,-21600,iPhone
com.google.Chrome,901,1735895663,1735896564,1735896565,-21600,MacBook
com.apple.mobiletimer,8,1735896182,1735896190,1735896190,-21600,iPhone
com.google.Chrome,310,1735895345,1735895655,1735895656,-21600,MacBook
com.apple.mobiletimer,7,1735895405,1735895412,1735895412,-21600,iPhone
com.apple.camera,2,1735895402,1735895404,1735895405,-21600,iPhone
com.tencent.xin,33,1735895368,1735895401,1735895401,-21600,iPhone
com.google.Chrome,16,1735895235,1735895251,1735895252,-21600,MacBook
com.bilibili.bilicomic,9,1735895208,1735895217,1735895217,-21600,iPhone
com.bilibili.bilicomic,303,1735894903,1735895206,1735895207,-21600,iPhone
tv.danmaku.bilianime,3,1735894899,1735894902,1735894902,-21600,iPhone
com.bilibili.bilicomic,1,1735894898,1735894899,1735894900,-21600,iPhone
com.tencent.xin,147,1735894747,1735894894,1735894895,-21600,iPhone
com.tencent.xin,7,1735894668,1735894675,1735894675,-21600,iPhone
com.google.Chrome,31,1735894641,1735894672,1735894673,-21600,MacBook
com.tencent.xin,12,1735894651,1735894663,1735894663,-21600,iPhone
us.zoom.xos,2,1735894639,1735894641,1735894641,-21600,MacBook
com.tencent.xin,115,1735894523,1735894638,1735894638,-21600,iPhone
com.tencent.xin,45,1735894478,1735894523,1735894523,-21600,iPhone
com.tencent.xin,257,1735894212,1735894469,1735894469,-21600,iPhone
com.tencent.xin,402,1735893795,1735894197,1735894198,-21600,iPhone
com.apple.Preferences,9,1735893786,1735893795,1735893795,-21600,iPhone
com.yardi.rentcafe.resident,2,1735893783,1735893785,1735893785,-21600,iPhone
com.tencent.xin,408,1735893374,1735893782,1735893783,-21600,iPhone
com.tencent.xin,492,1735892878,1735893370,1735893371,-21600,iPhone
com.tencent.xin,35,1735892701,1735892736,1735892737,-21600,iPhone
com.tencent.xin,155,1735892491,1735892646,1735892647,-21600,iPhone
com.tencent.xin,94,1735892396,1735892490,1735892491,-21600,iPhone
com.tencent.xin,261,1735892099,1735892360,1735892361,-21600,iPhone
com.tencent.xin,21,1735892061,1735892082,1735892083,-21600,iPhone
com.tencent.xin,96,1735891964,1735892060,1735892060,-21600,iPhone
com.apple.mobiletimer,2,1735891962,1735891964,1735891964,-21600,iPhone
com.tencent.xin,1,1735891961,1735891962,1735891963,-21600,iPhone
com.apple.mobiletimer,4,1735891957,1735891961,1735891962,-21600,iPhone
com.tencent.xin,5,1735891951,1735891956,1735891956,-21600,iPhone
com.yardi.rentcafe.resident,8,1735891943,1735891951,1735891951,-21600,iPhone
com.tencent.xin,3,1735891940,1735891943,1735891943,-21600,iPhone
com.yardi.rentcafe.resident,1,1735891939,1735891940,1735891940,-21600,iPhone
com.tencent.xin,172,1735891766,1735891938,1735891938,-21600,iPhone
com.tencent.xin,2,1735891763,1735891765,1735891765,-21600,iPhone
com.tencent.xin,532,1735891230,1735891762,1735891763,-21600,iPhone
com.tencent.xin,1,1735891228,1735891229,1735891230,-21600,iPhone
com.microsoft.Office.Outlook,2,1735891224,1735891226,1735891227,-21600,iPhone
us.zoom.xos,8,1735891214,1735891222,1735891223,-21600,MacBook
com.apple.iWork.Keynote,1187,1735890027,1735891214,1735891215,-21600,MacBook
com.apple.iWork.Keynote,2147,1735887854,1735890001,1735890001,-21600,MacBook
com.microsoft.Office.Outlook,2,1735888514,1735888516,1735888517,-21600,iPhone
us.zoom.xos,4,1735887850,1735887854,1735887855,-21600,MacBook
com.apple.iWork.Keynote,11,1735887839,1735887850,1735887850,-21600,MacBook
us.zoom.xos,20,1735887819,1735887839,1735887840,-21600,MacBook
com.apple.iWork.Keynote,3,1735887816,1735887819,1735887820,-21600,MacBook
us.zoom.xos,11,1735887805,1735887816,1735887817,-21600,MacBook
com.apple.iWork.Keynote,4,1735887801,1735887805,1735887806,-21600,MacBook
us.zoom.xos,8,1735887793,1735887801,1735887802,-21600,MacBook
com.apple.finder,2,1735887791,1735887793,1735887793,-21600,MacBook
us.zoom.xos,36,1735887755,1735887791,1735887791,-21600,MacBook
com.microsoft.Office.Outlook,21,1735887766,1735887787,1735887788,-21600,iPhone
com.apple.sidecar,3,1735887766,1735887769,1735887770,-21600,iPhone
com.apple.iWork.Keynote,3,1735887752,1735887755,1735887756,-21600,MacBook
us.zoom.xos,2,1735887750,1735887752,1735887752,-21600,MacBook
com.apple.iWork.Keynote,26,1735887724,1735887750,1735887750,-21600,MacBook
com.apple.finder,1,1735887723,1735887724,1735887725,-21600,MacBook
us.zoom.xos,2,1735887721,1735887723,1735887724,-21600,MacBook
com.apple.finder,1,1735887720,1735887721,1735887721,-21600,MacBook
us.zoom.xos,1,1735887719,1735887720,1735887720,-21600,MacBook
com.apple.iWork.Keynote,10,1735887709,1735887719,1735887720,-21600,MacBook
us.zoom.xos,1,1735887708,1735887709,1735887709,-21600,MacBook
com.apple.iWork.Keynote,11,1735887697,1735887708,1735887709,-21600,MacBook
us.zoom.xos,1,1735887696,1735887697,1735887697,-21600,MacBook
com.apple.iWork.Keynote,11,1735887685,1735887696,1735887696,-21600,MacBook
com.apple.finder,13,1735887672,1735887685,1735887686,-21600,MacBook
com.apple.iWork.Keynote,17,1735887655,1735887672,1735887672,-21600,MacBook
com.apple.finder,4,1735887651,1735887655,1735887655,-21600,MacBook
com.apple.iWork.Keynote,2,1735887649,1735887651,1735887651,-21600,MacBook
com.apple.finder,5,1735887644,1735887649,1735887649,-21600,MacBook
com.apple.iWork.Keynote,5,1735887639,1735887644,1735887644,-21600,MacBook
us.zoom.xos,28,1735887611,1735887639,1735887639,-21600,MacBook
com.microsoft.Office.Outlook,13,1735887622,1735887635,1735887636,-21600,iPhone
com.apple.mobiletimer,3,1735887619,1735887622,1735887622,-21600,iPhone
com.google.Chrome,24,1735887587,1735887611,1735887612,-21600,MacBook
com.apple.finder,28,1735887559,1735887587,1735887587,-21600,MacBook
com.apple.Preview,3,1735887556,1735887559,1735887560,-21600,MacBook
com.apple.iWork.Keynote,283,1735887273,1735887556,1735887557,-21600,MacBook
com.apple.mobiletimer,4,1735887537,1735887541,1735887542,-21600,iPhone
com.google.Chrome,2,1735887271,1735887273,1735887273,-21600,MacBook
com.apple.iWork.Keynote,27,1735887244,1735887271,1735887272,-21600,MacBook
com.apple.mobiletimer,14,1735887233,1735887247,1735887248,-21600,iPhone
com.google.Chrome,17,1735887227,1735887244,1735887245,-21600,MacBook
com.apple.Preview,1,1735887226,1735887227,1735887228,-21600,MacBook
com.apple.iWork.Keynote,23,1735887203,1735887226,1735887227,-21600,MacBook
com.apple.Preview,2,1735887201,1735887203,1735887204,-21600,MacBook
com.apple.iWork.Keynote,3,1735887198,1735887201,1735887202,-21600,MacBook
com.apple.Preview,12,1735887186,1735887198,1735887198,-21600,MacBook
com.apple.finder,1,1735887185,1735887186,1735887187,-21600,MacBook
com.tinyspeck.slackmacgap,10,1735887175,1735887185,1735887185,-21600,MacBook
com.apple.Preview,1,1735887174,1735887175,1735887175,-21600,MacBook
com.google.Chrome,3,1735887171,1735887174,1735887174,-21600,MacBook
com.apple.iWork.Keynote,267,1735886904,1735887171,1735887171,-21600,MacBook
com.apple.mobiletimer,10,1735886924,1735886934,1735886935,-21600,iPhone
com.google.Chrome,6,1735886898,1735886904,1735886905,-21600,MacBook
com.apple.iWork.Keynote,17,1735886881,1735886898,1735886899,-21600,MacBook
com.google.Chrome,7,1735886874,1735886881,1735886882,-21600,MacBook
com.apple.iWork.Keynote,36,1735886838,1735886874,1735886875,-21600,MacBook
com.apple.finder,2,1735886836,1735886838,1735886838,-21600,MacBook
com.apple.iWork.Keynote,8,1735886828,1735886836,1735886836,-21600,MacBook
com.apple.finder,7,1735886821,1735886828,1735886828,-21600,MacBook
com.apple.iWork.Keynote,1,1735886820,1735886821,1735886822,-21600,MacBook
com.google.Chrome,34,1735886786,1735886820,1735886821,-21600,MacBook
com.apple.iWork.Keynote,1,1735886785,1735886786,1735886786,-21600,MacBook
com.apple.finder,9,1735886776,1735886785,1735886785,-21600,MacBook
com.apple.iWork.Keynote,152,1735886624,1735886776,1735886776,-21600,MacBook
com.apple.finder,7,1735886617,1735886624,1735886625,-21600,MacBook
com.apple.iWork.Keynote,28,1735886589,1735886617,1735886617,-21600,MacBook
com.apple.finder,3,1735886586,1735886589,1735886589,-21600,MacBook
com.apple.iWork.Keynote,24,1735886562,1735886586,1735886586,-21600,MacBook
com.apple.finder,2,1735886560,1735886562,1735886562,-21600,MacBook
com.apple.iWork.Keynote,10,1735886550,1735886560,1735886560,-21600,MacBook
com.apple.finder,2,1735886548,1735886550,1735886551,-21600,MacBook
com.apple.iWork.Keynote,134,1735886414,1735886548,1735886549,-21600,MacBook
com.apple.finder,7,1735886407,1735886414,1735886414,-21600,MacBook
com.google.Chrome,2,1735886405,1735886407,1735886407,-21600,MacBook
com.apple.iWork.Keynote,37,1735886368,1735886405,1735886406,-21600,MacBook
com.apple.finder,5,1735886363,1735886368,1735886369,-21600,MacBook
com.mcneel.rhinoceros.7,160,1735886203,1735886363,1735886364,-21600,MacBook
com.apple.mobiletimer,6,1735886319,1735886325,1735886326,-21600,iPhone
com.apple.PassbookUIService,1,1735886321,1735886322,1735886322,-21600,iPhone
com.apple.mobiletimer,11,1735886308,1735886319,1735886319,-21600,iPhone
com.apple.finder,7,1735886196,1735886203,1735886203,-21600,MacBook
com.mcneel.rhinoceros.7,24,1735886172,1735886196,1735886197,-21600,MacBook
com.apple.iWork.Keynote,20,1735886152,1735886172,1735886173,-21600,MacBook
com.google.Chrome,5,1735886147,1735886152,1735886153,-21600,MacBook
com.apple.iWork.Keynote,2,1735886145,1735886147,1735886148,-21600,MacBook
com.google.Chrome,3,1735886142,1735886145,1735886146,-21600,MacBook
com.apple.iWork.Keynote,21,1735886121,1735886142,1735886143,-21600,MacBook
com.google.Chrome,5,1735886116,1735886121,1735886122,-21600,MacBook
com.apple.iWork.Keynote,6,1735886110,1735886116,1735886116,-21600,MacBook
com.google.Chrome,1,1735886109,1735886110,1735886111,-21600,MacBook
com.apple.iWork.Keynote,15,1735886094,1735886109,1735886110,-21600,MacBook
com.google.Chrome,4,1735886090,1735886094,1735886094,-21600,MacBook
com.apple.iWork.Keynote,5,1735886085,1735886090,1735886090,-21600,MacBook
com.google.Chrome,4,1735886081,1735886085,1735886086,-21600,MacBook
com.apple.iWork.Keynote,1,1735886080,1735886081,1735886082,-21600,MacBook
com.google.Chrome,5,1735886075,1735886080,1735886080,-21600,MacBook
com.apple.iWork.Keynote,2,1735886073,1735886075,1735886076,-21600,MacBook
com.google.Chrome,3,1735886070,1735886073,1735886073,-21600,MacBook
com.apple.iWork.Keynote,8,1735886062,1735886070,1735886071,-21600,MacBook
com.google.Chrome,2,1735886060,1735886062,1735886063,-21600,MacBook
com.apple.iWork.Keynote,0,1735886060,1735886060,1735886061,-21600,MacBook
com.google.Chrome,4,1735886056,1735886060,1735886060,-21600,MacBook
com.apple.iWork.Keynote,6,1735886050,1735886056,1735886056,-21600,MacBook
com.google.Chrome,5,1735886045,1735886050,1735886050,-21600,MacBook
com.apple.iWork.Keynote,9,1735886036,1735886045,1735886046,-21600,MacBook
com.google.Chrome,63,1735885973,1735886036,1735886036,-21600,MacBook
com.apple.iWork.Keynote,1,1735885972,1735885973,1735885974,-21600,MacBook
com.apple.Preview,14,1735885958,1735885972,1735885973,-21600,MacBook
com.mcneel.rhinoceros.7,3,1735885955,1735885958,1735885958,-21600,MacBook
com.apple.finder,14,1735885941,1735885955,1735885956,-21600,MacBook
com.google.Chrome,64,1735885877,1735885941,1735885942,-21600,MacBook
com.apple.iWork.Keynote,8,1735885869,1735885877,1735885878,-21600,MacBook
com.google.Chrome,10,1735885859,1735885869,1735885870,-21600,MacBook
com.apple.iWork.Keynote,30,1735885829,1735885859,1735885860,-21600,MacBook
com.apple.finder,7,1735885822,1735885829,1735885829,-21600,MacBook
com.apple.Preview,1,1735885821,1735885822,1735885822,-21600,MacBook
com.apple.iWork.Keynote,1,1735885820,1735885821,1735885822,-21600,MacBook
com.google.Chrome,120,1735885700,1735885820,1735885821,-21600,MacBook
com.apple.mobiletimer,5,1735885703,1735885708,1735885709,-21600,iPhone
com.apple.iWork.Keynote,2,1735885691,1735885693,1735885693,-21600,MacBook
com.google.Chrome,3,1735885688,1735885691,1735885692,-21600,MacBook
notion.id,1,1735885687,1735885688,1735885689,-21600,MacBook
com.google.Chrome,2,1735885685,1735885687,1735885688,-21600,MacBook
com.apple.iWork.Keynote,11,1735885674,1735885685,1735885686,-21600,MacBook
com.apple.Preview,30,1735885644,1735885674,1735885675,-21600,MacBook
com.google.Chrome,6,1735885638,1735885644,1735885645,-21600,MacBook
com.apple.iWork.Keynote,0,1735885638,1735885638,1735885639,-21600,MacBook
com.apple.Preview,6,1735885632,1735885638,1735885638,-21600,MacBook
com.apple.finder,1,1735885631,1735885632,1735885632,-21600,MacBook
com.tinyspeck.slackmacgap,3,1735885628,1735885631,1735885631,-21600,MacBook
com.apple.finder,1,1735885627,1735885628,1735885629,-21600,MacBook
com.apple.Preview,6,1735885621,1735885627,1735885627,-21600,MacBook
com.apple.iWork.Keynote,1,1735885620,1735885621,1735885621,-21600,MacBook
com.google.Chrome,5,1735885615,1735885620,1735885620,-21600,MacBook
com.apple.iWork.Keynote,0,1735885615,1735885615,1735885616,-21600,MacBook
com.apple.Preview,9,1735885606,1735885615,1735885615,-21600,MacBook
com.apple.iWork.Keynote,1,1735885605,1735885606,1735885607,-21600,MacBook
com.google.Chrome,23,1735885582,1735885605,1735885605,-21600,MacBook
com.apple.iWork.Keynote,1,1735885581,1735885582,1735885583,-21600,MacBook
com.apple.Preview,8,1735885573,1735885581,1735885582,-21600,MacBook
com.apple.finder,4,1735885569,1735885573,1735885573,-21600,MacBook
com.tinyspeck.slackmacgap,29,1735885540,1735885569,1735885569,-21600,MacBook
com.apple.finder,0,1735885540,1735885540,1735885540,-21600,MacBook
com.apple.iWork.Keynote,2,1735885538,1735885540,1735885540,-21600,MacBook
com.google.Chrome,61,1735885477,1735885538,1735885539,-21600,MacBook
com.apple.iWork.Keynote,1,1735885476,1735885477,1735885477,-21600,MacBook
com.google.Chrome,6,1735885470,1735885476,1735885477,-21600,MacBook
com.apple.finder,3,1735885467,1735885470,1735885470,-21600,MacBook
com.autodesk.fusion360,7,1735885460,1735885467,1735885467,-21600,MacBook
com.apple.finder,1,1735885459,1735885460,1735885462,-21600,MacBook
com.apple.iWork.Keynote,87,1735885372,1735885459,1735885460,-21600,MacBook
com.apple.finder,4,1735885368,1735885372,1735885373,-21600,MacBook
com.google.Chrome,4,1735885364,1735885368,1735885368,-21600,MacBook
com.apple.iWork.Keynote,21,1735885343,1735885364,1735885365,-21600,MacBook
com.google.Chrome,134,1735885209,1735885343,1735885344,-21600,MacBook
com.apple.finder,1,1735885208,1735885209,1735885210,-21600,MacBook
com.apple.iWork.Keynote,44,1735885164,1735885208,1735885209,-21600,MacBook
com.apple.finder,7,1735885157,1735885164,1735885165,-21600,MacBook
com.apple.iWork.Keynote,39,1735885118,1735885157,1735885157,-21600,MacBook
com.apple.finder,2,1735885116,1735885118,1735885119,-21600,MacBook
com.google.Chrome,0,1735885116,1735885116,1735885117,-21600,MacBook
com.apple.iWork.Keynote,1,1735885115,1735885116,1735885116,-21600,MacBook
com.apple.finder,13,1735885102,1735885115,1735885116,-21600,MacBook
com.apple.iWork.Keynote,1,1735885101,1735885102,1735885103,-21600,MacBook
com.apple.finder,5,1735885096,1735885101,1735885102,-21600,MacBook
com.apple.iWork.Keynote,8,1735885088,1735885096,1735885096,-21600,MacBook
com.apple.finder,1,1735885087,1735885088,1735885089,-21600,MacBook
com.apple.iWork.Keynote,90,1735884997,1735885087,1735885088,-21600,MacBook
com.apple.finder,6,1735884991,1735884997,1735884997,-21600,MacBook
com.microsoft.VSCode,9,1735884982,1735884991,1735884991,-21600,MacBook
com.apple.iWork.Keynote,10,1735884972,1735884982,1735884983,-21600,MacBook
com.microsoft.VSCode,11,1735884961,1735884972,1735884972,-21600,MacBook
com.apple.finder,1,1735884960,1735884961,1735884961,-21600,MacBook
com.microsoft.VSCode,1,1735884959,1735884960,1735884961,-21600,MacBook
com.apple.iWork.Keynote,9,1735884950,1735884959,1735884959,-21600,MacBook
com.microsoft.VSCode,4,1735884946,1735884950,1735884951,-21600,MacBook
com.apple.finder,1,1735884945,1735884946,1735884946,-21600,MacBook
com.apple.TextEdit,7,1735884938,1735884945,1735884946,-21600,MacBook
com.apple.finder,0,1735884938,1735884938,1735884938,-21600,MacBook
com.microsoft.VSCode,3,1735884935,1735884938,1735884938,-21600,MacBook
com.apple.finder,14,1735884921,1735884935,1735884936,-21600,MacBook
com.microsoft.VSCode,2,1735884919,1735884921,1735884921,-21600,MacBook
com.apple.iWork.Keynote,211,1735884708,1735884919,1735884920,-21600,MacBook
com.apple.mobiletimer,5,1735884826,1735884831,1735884832,-21600,iPhone
com.google.Chrome,2,1735884706,1735884708,1735884709,-21600,MacBook
com.apple.iWork.Keynote,2,1735884704,1735884706,1735884706,-21600,MacBook
com.google.Chrome,15,1735884689,1735884704,1735884704,-21600,MacBook
com.apple.iWork.Keynote,7,1735884682,1735884689,1735884689,-21600,MacBook
com.google.Chrome,45,1735884637,1735884682,1735884682,-21600,MacBook
com.apple.iWork.Keynote,1,1735884636,1735884637,1735884637,-21600,MacBook
com.microsoft.VSCode,18,1735884618,1735884636,1735884636,-21600,MacBook
com.apple.finder,17,1735884601,1735884618,1735884619,-21600,MacBook
com.apple.iWork.Keynote,3,1735884598,1735884601,1735884602,-21600,MacBook
com.google.Chrome,563,1735884035,1735884598,1735884599,-21600,MacBook
com.apple.iWork.Keynote,2,1735884005,1735884007,1735884007,-21600,MacBook
com.apple.finder,5,1735884000,1735884005,1735884005,-21600,MacBook
com.apple.TextEdit,4,1735883996,1735884000,1735884001,-21600,MacBook
com.apple.finder,5,1735883991,1735883996,1735883996,-21600,MacBook
com.microsoft.VSCode,30,1735883961,1735883991,1735883991,-21600,MacBook
com.apple.iWork.Keynote,90,1735883871,1735883961,1735883961,-21600,MacBook
com.apple.mobiletimer,7,1735883921,1735883928,1735883929,-21600,iPhone
com.microsoft.VSCode,2,1735883869,1735883871,1735883871,-21600,MacBook
com.apple.iWork.Keynote,1,1735883868,1735883869,1735883869,-21600,MacBook
com.apple.finder,1,1735883866,1735883867,1735883868,-21600,MacBook
com.apple.TextEdit,2,1735883864,1735883866,1735883866,-21600,MacBook
com.apple.finder,8,1735883856,1735883864,1735883864,-21600,MacBook
com.apple.TextEdit,3,1735883853,1735883856,1735883856,-21600,MacBook
com.apple.finder,24,1735883829,1735883853,1735883854,-21600,MacBook
com.apple.iWork.Keynote,50,1735883779,1735883829,1735883829,-21600,MacBook
com.apple.finder,4,1735883775,1735883779,1735883779,-21600,MacBook
com.apple.iWork.Keynote,7,1735883768,1735883775,1735883776,-21600,MacBook
com.apple.finder,3,1735883765,1735883768,1735883768,-21600,MacBook
com.apple.iWork.Keynote,4,1735883761,1735883765,1735883766,-21600,MacBook
com.google.Chrome,49,1735883712,1735883761,1735883762,-21600,MacBook
com.apple.iWork.Keynote,42,1735883670,1735883712,1735883712,-21600,MacBook
com.apple.finder,3,1735883667,1735883670,1735883671,-21600,MacBook
com.apple.iWork.Keynote,17,1735883650,1735883667,1735883668,-21600,MacBook
com.apple.finder,1,1735883649,1735883650,1735883651,-21600,MacBook
com.apple.iWork.Keynote,1,1735883648,1735883649,1735883649,-21600,MacBook
com.google.Chrome,221,1735883427,1735883648,1735883648,-21600,MacBook
com.apple.mobiletimer,2,1735883491,1735883493,1735883493,-21600,iPhone
com.apple.finder,1,1735883426,1735883427,1735883428,-21600,MacBook
com.apple.iWork.Keynote,254,1735883172,1735883426,1735883427,-21600,MacBook
com.apple.finder,4,1735883168,1735883172,1735883172,-21600,MacBook
com.apple.iWork.Keynote,1,1735883167,1735883168,1735883168,-21600,MacBook
com.google.Chrome,26,1735883141,1735883167,1735883167,-21600,MacBook
com.microsoft.Outlook,2,1735883139,1735883141,1735883142,-21600,MacBook
com.google.Chrome,6,1735883133,1735883139,1735883140,-21600,MacBook
com.apple.iWork.Keynote,2,1735883131,1735883133,1735883134,-21600,MacBook
com.apple.finder,2,1735883129,1735883131,1735883132,-21600,MacBook
com.autodesk.fusion360,51,1735883078,1735883129,1735883129,-21600,MacBook
com.apple.finder,1,1735883077,1735883078,1735883078,-21600,MacBook
com.apple.iWork.Keynote,27,1735883050,1735883077,1735883077,-21600,MacBook
com.apple.finder,7,1735883043,1735883050,1735883050,-21600,MacBook
com.apple.iWork.Keynote,0,1735883043,1735883043,1735883044,-21600,MacBook
com.google.Chrome,63,1735882980,1735883043,1735883043,-21600,MacBook
com.apple.mobiletimer,5,1735883019,1735883024,1735883024,-21600,iPhone
com.tencent.xin,3,1735883015,1735883018,1735883019,-21600,iPhone
com.apple.iWork.Keynote,1,1735882979,1735882980,1735882981,-21600,MacBook
com.google.Chrome,15,1735882964,1735882979,1735882979,-21600,MacBook
com.apple.iWork.Keynote,38,1735882926,1735882964,1735882965,-21600,MacBook
com.apple.finder,1,1735882925,1735882926,1735882927,-21600,MacBook
com.google.Chrome,115,1735882810,1735882925,1735882926,-21600,MacBook
com.tencent.xin,31,1735882759,1735882790,1735882791,-21600,iPhone
com.tencent.xin,19,1735882669,1735882688,1735882689,-21600,iPhone
com.tencent.xin,27,1735882527,1735882554,1735882555,-21600,iPhone
com.tencent.xin,4,1735882522,1735882526,1735882526,-21600,iPhone
com.tencent.xin,87,1735882433,1735882520,1735882521,-21600,iPhone
com.google.Chrome,303,1735882156,1735882459,1735882459,-21600,MacBook
tv.danmaku.bilianime,30,1735882403,1735882433,1735882434,-21600,iPhone
com.bilibili.bilicomic,66,1735882337,1735882403,1735882404,-21600,iPhone
tv.danmaku.bilianime,1,1735882336,1735882337,1735882338,-21600,iPhone
com.bilibili.bilicomic,1,1735882334,1735882335,1735882336,-21600,iPhone
tv.danmaku.bilianime,2,1735882332,1735882334,1735882335,-21600,iPhone
com.tencent.xin,40,1735882290,1735882330,1735882331,-21600,iPhone
com.tencent.xin,12,1735882277,1735882289,1735882290,-21600,iPhone
com.google.chrome.ios,13,1735882264,1735882277,1735882278,-21600,iPhone
com.tencent.xin,28,1735882236,1735882264,1735882265,-21600,iPhone
com.google.chrome.ios,7,1735882229,1735882236,1735882236,-21600,iPhone
com.tencent.xin,13,1735882216,1735882229,1735882229,-21600,iPhone
com.apple.mobiletimer,7,1735882207,1735882214,1735882214,-21600,iPhone
com.tencent.xin,3,1735882204,1735882207,1735882208,-21600,iPhone
com.tencent.xin,2,1735882166,1735882168,1735882169,-21600,iPhone
com.apple.mobiletimer,3,1735882163,1735882166,1735882166,-21600,iPhone
com.apple.iWork.Keynote,62,1735882094,1735882156,1735882156,-21600,MacBook
com.google.Chrome,19,1735882075,1735882094,1735882094,-21600,MacBook
com.apple.iWork.Keynote,39,1735882036,1735882075,1735882075,-21600,MacBook
com.google.Chrome,26,1735882010,1735882036,1735882036,-21600,MacBook
com.apple.iWork.Keynote,51,1735881959,1735882010,1735882010,-21600,MacBook
com.apple.mobiletimer,11,1735881974,1735881985,1735881986,-21600,iPhone
com.google.Chrome,81,1735881878,1735881959,1735881960,-21600,MacBook
com.apple.iWork.Keynote,45,1735881833,1735881878,1735881879,-21600,MacBook
com.google.Chrome,2,1735881831,1735881833,1735881833,-21600,MacBook
com.apple.iWork.Keynote,3,1735881828,1735881831,1735881832,-21600,MacBook
com.google.Chrome,6,1735881822,1735881828,1735881829,-21600,MacBook
com.apple.iWork.Keynote,52,1735881770,1735881822,1735881823,-21600,MacBook
com.google.Chrome,7,1735881763,1735881770,1735881771,-21600,MacBook
com.apple.iWork.Keynote,1,1735881762,1735881763,1735881763,-21600,MacBook
com.google.Chrome,7,1735881755,1735881762,1735881762,-21600,MacBook
notion.id,2,1735881753,1735881755,1735881756,-21600,MacBook
com.apple.iWork.Keynote,38,1735881715,1735881753,1735881754,-21600,MacBook
com.google.Chrome,2,1735881713,1735881715,1735881716,-21600,MacBook
com.apple.iWork.Keynote,82,1735881631,1735881713,1735881713,-21600,MacBook
com.google.Chrome,131,1735881500,1735881631,1735881631,-21600,MacBook
notion.id,1,1735881499,1735881500,1735881501,-21600,MacBook
com.apple.iWork.Keynote,525,1735880974,1735881499,1735881500,-21600,MacBook
com.google.Chrome,1,1735880973,1735880974,1735880974,-21600,MacBook
com.apple.iWork.Keynote,64,1735880909,1735880973,1735880973,-21600,MacBook
com.apple.finder,1,1735880908,1735880909,1735880910,-21600,MacBook
com.google.Chrome,85,1735880823,1735880908,1735880909,-21600,MacBook
notion.id,2,1735880821,1735880823,1735880823,-21600,MacBook
com.apple.iWork.Keynote,88,1735880733,1735880821,1735880822,-21600,MacBook
com.google.Chrome,11,1735880722,1735880733,1735880733,-21600,MacBook
com.apple.iWork.Keynote,6,1735880716,1735880722,1735880722,-21600,MacBook
com.google.Chrome,13,1735880703,1735880716,1735880717,-21600,MacBook
com.apple.iWork.Keynote,2,1735880701,1735880703,1735880704,-21600,MacBook
com.google.Chrome,42,1735880659,1735880701,1735880702,-21600,MacBook
com.apple.iWork.Keynote,175,1735880484,1735880659,1735880659,-21600,MacBook
com.google.Chrome,4,1735880480,1735880484,1735880485,-21600,MacBook
com.apple.iWork.Keynote,28,1735880452,1735880480,1735880481,-21600,MacBook
com.apple.mobiletimer,9,1735880467,1735880476,1735880476,-21600,iPhone
com.tencent.xin,5,1735880460,1735880465,1735880466,-21600,iPhone
com.google.Chrome,17,1735880435,1735880452,1735880452,-21600,MacBook
com.apple.iWork.Keynote,9,1735880426,1735880435,1735880436,-21600,MacBook
com.apple.finder,1,1735880425,1735880426,1735880427,-21600,MacBook
com.google.Chrome,39,1735880386,1735880425,1735880426,-21600,MacBook
com.apple.iWork.Keynote,8,1735880378,1735880386,1735880387,-21600,MacBook
com.google.Chrome,1,1735880377,1735880378,1735880378,-21600,MacBook
com.apple.iWork.Keynote,2,1735880375,1735880377,1735880378,-21600,MacBook
com.google.Chrome,1,1735880374,1735880375,1735880376,-21600,MacBook
com.apple.iWork.Keynote,2,1735880372,1735880374,1735880375,-21600,MacBook
com.google.Chrome,6,1735880366,1735880372,1735880373,-21600,MacBook
notion.id,1,1735880365,1735880366,1735880367,-21600,MacBook
com.apple.iWork.Keynote,63,1735880302,1735880365,1735880365,-21600,MacBook
com.apple.finder,1,1735880301,1735880302,1735880303,-21600,MacBook
com.google.Chrome,19,1735880282,1735880301,1735880302,-21600,MacBook
com.apple.iWork.Keynote,51,1735880231,1735880282,1735880283,-21600,MacBook
com.google.Chrome,1,1735880230,1735880231,1735880231,-21600,MacBook
com.apple.finder,3,1735880227,1735880230,1735880230,-21600,MacBook
com.apple.iWork.Keynote,4,1735880223,1735880227,1735880227,-21600,MacBook
com.google.Chrome,1,1735880222,1735880223,1735880223,-21600,MacBook
com.apple.finder,10,1735880212,1735880222,1735880223,-21600,MacBook
com.google.Chrome,4,1735880208,1735880212,1735880212,-21600,MacBook
com.apple.finder,3,1735880205,1735880208,1735880209,-21600,MacBook
com.apple.iWork.Keynote,1,1735880204,1735880205,1735880205,-21600,MacBook
com.google.Chrome,7,1735880197,1735880204,1735880204,-21600,MacBook
com.apple.iWork.Keynote,1,1735880196,1735880197,1735880197,-21600,MacBook
com.apple.finder,4,1735880192,1735880196,1735880196,-21600,MacBook
com.google.Chrome,101,1735880091,1735880192,1735880193,-21600,MacBook
com.apple.iWork.Keynote,2,1735880089,1735880091,1735880091,-21600,MacBook
com.google.Chrome,7,1735880082,1735880089,1735880090,-21600,MacBook
com.apple.iWork.Keynote,31,1735880051,1735880082,1735880083,-21600,MacBook
com.google.Chrome,0,1735880051,1735880051,1735880052,-21600,MacBook
com.apple.finder,2,1735880049,1735880051,1735880051,-21600,MacBook
com.apple.Preview,3,1735880046,1735880049,1735880049,-21600,MacBook
com.apple.finder,1,1735880045,1735880046,1735880047,-21600,MacBook
com.apple.Preview,0,1735880045,1735880045,1735880045,-21600,MacBook
com.apple.finder,7,1735880038,1735880045,1735880045,-21600,MacBook
com.google.Chrome,64,1735879974,1735880038,1735880039,-21600,MacBook
com.apple.finder,1,1735879973,1735879974,1735879974,-21600,MacBook
com.apple.iWork.Keynote,11,1735879962,1735879973,1735879973,-21600,MacBook
com.google.Chrome,89,1735879873,1735879962,1735879962,-21600,MacBook
com.apple.iWork.Keynote,1,1735879872,1735879873,1735879873,-21600,MacBook
com.apple.finder,6,1735879866,1735879872,1735879872,-21600,MacBook
com.apple.Preview,3,1735879863,1735879866,1735879866,-21600,MacBook
com.apple.finder,0,1735879863,1735879863,1735879864,-21600,MacBook
com.apple.Preview,0,1735879863,1735879863,1735879864,-21600,MacBook
com.apple.finder,14,1735879849,1735879863,1735879863,-21600,MacBook
com.apple.iWork.Keynote,129,1735879720,1735879849,1735879849,-21600,MacBook
com.apple.finder,6,1735879714,1735879720,1735879720,-21600,MacBook
com.apple.iWork.Keynote,206,1735879508,1735879714,1735879714,-21600,MacBook
com.apple.finder,1,1735879507,1735879508,1735879508,-21600,MacBook
com.autodesk.fusion360,6,1735879501,1735879507,1735879507,-21600,MacBook
com.apple.iWork.Keynote,1,1735879500,1735879501,1735879502,-21600,MacBook
com.apple.finder,3,1735879497,1735879500,1735879500,-21600,MacBook
com.apple.iWork.Keynote,13,1735879484,1735879497,1735879498,-21600,MacBook
com.apple.finder,2,1735879482,1735879484,1735879485,-21600,MacBook
com.apple.iWork.Keynote,1,1735879481,1735879482,1735879482,-21600,MacBook
com.apple.finder,1,1735879480,1735879481,1735879481,-21600,MacBook
com.autodesk.fusion360,41,1735879439,1735879480,1735879480,-21600,MacBook
com.apple.finder,1,1735879438,1735879439,1735879440,-21600,MacBook
com.autodesk.fusion360,3,1735879435,1735879438,1735879439,-21600,MacBook
com.apple.finder,2,1735879433,1735879435,1735879435,-21600,MacBook
com.apple.iWork.Keynote,203,1735879230,1735879433,1735879434,-21600,MacBook
com.google.Chrome,14,1735879216,1735879230,1735879231,-21600,MacBook
com.apple.iWork.Keynote,4,1735879212,1735879216,1735879217,-21600,MacBook
com.google.Chrome,15,1735879197,1735879212,1735879212,-21600,MacBook
com.apple.iWork.Keynote,9,1735879188,1735879197,1735879197,-21600,MacBook
com.google.Chrome,35,1735879153,1735879188,1735879188,-21600,MacBook
com.tencent.xin,1,1735879167,1735879168,1735879169,-21600,iPhone
com.apple.iWork.Keynote,320,1735878833,1735879153,1735879154,-21600,MacBook
com.apple.finder,10,1735878823,1735878833,1735878834,-21600,MacBook
com.apple.Preview,3,1735878820,1735878823,1735878824,-21600,MacBook
com.apple.finder,5,1735878815,1735878820,1735878820,-21600,MacBook
com.apple.iWork.Keynote,1,1735878814,1735878815,1735878815,-21600,MacBook
com.google.Chrome,4,1735878810,1735878814,1735878814,-21600,MacBook
com.apple.finder,1,1735878809,1735878810,1735878811,-21600,MacBook
com.apple.iWork.Keynote,37,1735878772,1735878809,1735878809,-21600,MacBook
com.apple.finder,3,1735878769,1735878772,1735878772,-21600,MacBook
com.google.Chrome,135,1735878634,1735878769,1735878769,-21600,MacBook
com.apple.iWork.Keynote,45,1735878589,1735878634,1735878634,-21600,MacBook
com.apple.finder,5,1735878584,1735878589,1735878589,-21600,MacBook
com.apple.iWork.Keynote,1,1735878583,1735878584,1735878584,-21600,MacBook
com.google.Chrome,9,1735878574,1735878583,1735878584,-21600,MacBook
com.apple.iWork.Keynote,10,1735878564,1735878574,1735878575,-21600,MacBook
com.google.Chrome,9,1735878555,1735878564,1735878564,-21600,MacBook
com.apple.iWork.Keynote,14,1735878541,1735878555,1735878556,-21600,MacBook
com.tencent.xin,4,1735878549,1735878553,1735878554,-21600,iPhone
com.apple.finder,1,1735878540,1735878541,1735878542,-21600,MacBook
com.microsoft.Outlook,9,1735878531,1735878540,1735878540,-21600,MacBook
com.apple.finder,0,1735878531,1735878531,1735878532,-21600,MacBook
com.apple.iWork.Keynote,7,1735878524,1735878531,1735878531,-21600,MacBook
com.tencent.xin,3,1735878512,1735878515,1735878515,-21600,iPhone
com.tencent.xin,23,1735878487,1735878510,1735878511,-21600,iPhone
com.microsoft.Office.Outlook,7,1735878480,1735878487,1735878488,-21600,iPhone
com.tencent.xin,1,1735878479,1735878480,1735878481,-21600,iPhone
com.google.chrome.ios,370,1735878107,1735878477,1735878477,-21600,iPhone
com.naver.linewebtoon,91,1735878016,1735878107,1735878107,-21600,iPhone
com.google.chrome.ios,247,1735877769,1735878016,1735878017,-21600,iPhone
com.apple.mobileslideshow,11,1735877758,1735877769,1735877770,-21600,iPhone
com.naver.linewebtoon,21,1735877736,1735877757,1735877758,-21600,iPhone
com.google.chrome.ios,141,1735877595,1735877736,1735877737,-21600,iPhone
com.naver.linewebtoon,278,1735877317,1735877595,1735877596,-21600,iPhone
com.google.chrome.ios,67,1735877250,1735877317,1735877317,-21600,iPhone
com.naver.linewebtoon,8,1735877242,1735877250,1735877250,-21600,iPhone
net.whatsapp.WhatsApp,13,1735877229,1735877242,1735877242,-21600,iPhone
com.burbn.instagram,160,1735877065,1735877225,1735877226,-21600,iPhone
com.google.chrome.ios,37,1735877028,1735877065,1735877065,-21600,iPhone
com.naver.linewebtoon,165,1735876861,1735877026,1735877027,-21600,iPhone
com.naver.linewebtoon,302,1735876550,1735876852,1735876856,-21600,iPhone
com.naver.linewebtoon,362,1735876187,1735876549,1735876549,-21600,iPhone
com.apple.mobiletimer,2,1735876185,1735876187,1735876187,-21600,iPhone
com.bilibili.bilicomic,237,1735875947,1735876184,1735876185,-21600,iPhone
com.apple.mobiletimer,2,1735875945,1735875947,1735875948,-21600,iPhone
com.bilibili.bilicomic,173,1735875768,1735875941,1735875942,-21600,iPhone
com.bilibili.bilicomic,234,1735875532,1735875766,1735875766,-21600,iPhone
com.bilibili.bilicomic,33,1735875498,1735875531,1735875532,-21600,iPhone
com.naver.linewebtoon,4,1735875494,1735875498,1735875498,-21600,iPhone
com.bilibili.bilicomic,1,1735875491,1735875492,1735875493,-21600,iPhone
com.google.chrome.ios,25,1735875466,1735875491,1735875492,-21600,iPhone
com.apple.mobiletimer,2,1735875464,1735875466,1735875466,-21600,iPhone
com.google.chrome.ios,17,1735875447,1735875464,1735875465,-21600,iPhone
com.google.chrome.ios,6,1735875440,1735875446,1735875447,-21600,iPhone
com.tencent.xin,5,1735875435,1735875440,1735875441,-21600,iPhone
com.google.chrome.ios,10,1735875425,1735875435,1735875436,-21600,iPhone
com.tencent.xin,12,1735875413,1735875425,1735875426,-21600,iPhone
com.google.chrome.ios,2,1735875410,1735875412,1735875412,-21600,iPhone
com.naver.linewebtoon,139,1735875270,1735875409,1735875410,-21600,iPhone
com.naver.linewebtoon,230,1735875039,1735875269,1735875269,-21600,iPhone
com.apple.mobiletimer,2,1735875037,1735875039,1735875040,-21600,iPhone
com.naver.linewebtoon,190,1735874847,1735875037,1735875038,-21600,iPhone
com.apple.camera,0,1735874848,1735874848,1735874849,-21600,iPhone
com.naver.linewebtoon,319,1735874475,1735874794,1735874794,-21600,iPhone
com.tencent.xin,1,1735874474,1735874475,1735874476,-21600,iPhone
com.tencent.xin,1,1735874472,1735874473,1735874474,-21600,iPhone
com.tencent.xin,202,1735874269,1735874471,1735874472,-21600,iPhone
com.naver.linewebtoon,132,1735874136,1735874268,1735874268,-21600,iPhone
com.apple.iWork.Keynote,300,1735873958,1735874258,1735874259,-21600,MacBook
com.apple.mobiletimer,7,1735874129,1735874136,1735874137,-21600,iPhone
com.naver.linewebtoon,153,1735873974,1735874127,1735874128,-21600,iPhone
com.bilibili.bilicomic,2,1735873972,1735873974,1735873974,-21600,iPhone
com.naver.linewebtoon,2,1735873970,1735873972,1735873973,-21600,iPhone
com.bilibili.bilicomic,3,1735873967,1735873970,1735873970,-21600,iPhone
com.bilibili.bilicomic,2,1735873965,1735873967,1735873968,-21600,iPhone
com.apple.finder,3,1735873955,1735873958,1735873958,-21600,MacBook
com.autodesk.fusion360,41,1735873914,1735873955,1735873955,-21600,MacBook
com.apple.finder,1,1735873913,1735873914,1735873914,-21600,MacBook
com.apple.iWork.Keynote,6,1735873907,1735873913,1735873913,-21600,MacBook
com.apple.finder,7,1735873900,1735873907,1735873907,-21600,MacBook
com.google.Chrome,1,1735873899,1735873900,1735873901,-21600,MacBook
com.apple.finder,5,1735873894,1735873899,1735873899,-21600,MacBook
com.autodesk.fusion360,117,1735873777,1735873894,1735873895,-21600,MacBook
com.google.Chrome,7,1735873770,1735873777,1735873778,-21600,MacBook
com.apple.finder,4,1735873766,1735873770,1735873770,-21600,MacBook
com.google.Chrome,2,1735873764,1735873766,1735873767,-21600,MacBook
com.autodesk.fusion360,2,1735873762,1735873764,1735873765,-21600,MacBook
com.apple.finder,1,1735873761,1735873762,1735873762,-21600,MacBook
com.apple.iWork.Keynote,38,1735873723,1735873761,1735873761,-21600,MacBook
com.apple.finder,2,1735873721,1735873723,1735873724,-21600,MacBook
com.apple.iWork.Keynote,1,1735873720,1735873721,1735873721,-21600,MacBook
com.google.Chrome,4,1735873716,1735873720,1735873720,-21600,MacBook
com.apple.iWork.Keynote,8,1735873708,1735873716,1735873716,-21600,MacBook
com.autodesk.fusion360,5,1735873703,1735873708,1735873708,-21600,MacBook
com.google.Chrome,1,1735873702,1735873703,1735873704,-21600,MacBook
com.autodesk.fusion360,2,1735873700,1735873702,1735873702,-21600,MacBook
com.google.Chrome,10,1735873690,1735873700,1735873700,-21600,MacBook
com.apple.finder,7,1735873680,1735873687,1735873688,-21600,MacBook
com.apple.Preview,2,1735873678,1735873680,1735873681,-21600,MacBook
com.microsoft.Outlook,2,1735873676,1735873678,1735873679,-21600,MacBook
com.google.Chrome,4,1735873672,1735873676,1735873676,-21600,MacBook
com.tencent.xin,4,1735873651,1735873655,1735873655,-21600,iPhone
com.tinyspeck.slackmacgap,2,1735873059,1735873061,1735873062,-21600,MacBook
com.google.Chrome,364,1735872695,1735873059,1735873059,-21600,MacBook
com.tencent.xin,1,1735872877,1735872878,1735872879,-21600,iPhone
com.google.calendar,3,1735872874,1735872877,1735872878,-21600,iPhone
com.tencent.xin,5,1735872869,1735872874,1735872875,-21600,iPhone
com.google.calendar,7,1735872862,1735872869,1735872869,-21600,iPhone
com.tencent.xin,14,1735872848,1735872862,1735872863,-21600,iPhone
com.tencent.xin,12,1735872698,1735872710,1735872711,-21600,iPhone
com.tencent.xin,1,1735872545,1735872546,1735872547,-21600,iPhone
com.tencent.xin,306,1735872227,1735872533,1735872534,-21600,iPhone
com.google.Chrome,324,1735872059,1735872383,1735872383,-21600,MacBook
com.tencent.xin,4,1735872222,1735872226,1735872227,-21600,iPhone
com.tencent.xin,98,1735872122,1735872220,1735872221,-21600,iPhone
com.xingin.discover,29,1735872093,1735872122,1735872123,-21600,iPhone
com.tencent.xin,0,1735872093,1735872093,1735872094,-21600,iPhone
com.xingin.discover,1,1735872091,1735872092,1735872093,-21600,iPhone
com.apple.mobiletimer,4,1735872087,1735872091,1735872091,-21600,iPhone
com.google.calendar,2,1735872085,1735872087,1735872087,-21600,iPhone
com.google.calendar,24,1735872053,1735872077,1735872077,-21600,iPhone
com.microsoft.Outlook,11,1735872048,1735872059,1735872060,-21600,MacBook
com.apple.mobiletimer,3,1735872050,1735872053,1735872053,-21600,iPhone
com.google.Chrome,12,1735872036,1735872048,1735872049,-21600,MacBook
com.microsoft.Outlook,7,1735872029,1735872036,1735872037,-21600,MacBook
com.google.Chrome,2,1735872027,1735872029,1735872029,-21600,MacBook
com.microsoft.Outlook,2,1735872025,1735872027,1735872027,-21600,MacBook
com.apple.finder,2,1735872023,1735872025,1735872025,-21600,MacBook
com.microsoft.Outlook,4,1735872019,1735872023,1735872024,-21600,MacBook
com.tinyspeck.slackmacgap,0,1735872019,1735872019,1735872019,-21600,MacBook
com.google.Chrome,807,1735871212,1735872019,1735872019,-21600,MacBook
com.tinyspeck.slackmacgap,2,1735871210,1735871212,1735871212,-21600,MacBook
com.google.Chrome,70,1735871140,1735871210,1735871210,-21600,MacBook
com.apple.iWork.Keynote,0,1735871140,1735871140,1735871141,-21600,MacBook
com.autodesk.fusion360,1,1735871139,1735871140,1735871140,-21600,MacBook
com.apple.iWork.Keynote,2,1735871137,1735871139,1735871139,-21600,MacBook
com.autodesk.fusion360,1,1735871136,1735871137,1735871138,-21600,MacBook
com.apple.iWork.Keynote,2,1735871134,1735871136,1735871136,-21600,MacBook
com.google.Chrome,1,1735871133,1735871134,1735871135,-21600,MacBook
com.tinyspeck.slackmacgap,1,1735871132,1735871133,1735871134,-21600,MacBook
com.google.Chrome,3,1735871129,1735871132,1735871133,-21600,MacBook
com.tinyspeck.slackmacgap,2,1735871127,1735871129,1735871129,-21600,MacBook
com.apple.iWork.Keynote,3,1735871124,1735871127,1735871127,-21600,MacBook
com.autodesk.fusion360,1,1735871123,1735871124,1735871124,-21600,MacBook
com.apple.iWork.Keynote,11,1735871112,1735871123,1735871123,-21600,MacBook
com.tinyspeck.slackmacgap,6,1735871106,1735871112,1735871112,-21600,MacBook
com.google.Chrome,70,1735871036,1735871106,1735871107,-21600,MacBook
com.autodesk.fusion360,1,1735871035,1735871036,1735871036,-21600,MacBook
com.google.Chrome,3,1735871032,1735871035,1735871035,-21600,MacBook
com.autodesk.fusion360,1,1735871031,1735871032,1735871033,-21600,MacBook
com.google.Chrome,0,1735871031,1735871031,1735871032,-21600,MacBook
com.autodesk.fusion360,0,1735871031,1735871031,1735871031,-21600,MacBook
com.google.Chrome,2,1735871029,1735871031,1735871031,-21600,MacBook
com.autodesk.fusion360,1,1735871028,1735871029,1735871030,-21600,MacBook
com.google.Chrome,76,1735870952,1735871028,1735871028,-21600,MacBook
com.tinyspeck.slackmacgap,2,1735870950,1735870952,1735870953,-21600,MacBook
com.google.Chrome,0,1735870950,1735870950,1735870952,-21600,MacBook
com.tinyspeck.slackmacgap,1,1735870949,1735870950,1735870950,-21600,MacBook
com.apple.iWork.Keynote,0,1735870949,1735870949,1735870949,-21600,MacBook
com.tinyspeck.slackmacgap,2,1735870947,1735870949,1735870949,-21600,MacBook
com.apple.finder,5,1735870942,1735870947,1735870947,-21600,MacBook
notion.id,1,1735870941,1735870942,1735870942,-21600,MacBook
com.apple.finder,3,1735870938,1735870941,1735870942,-21600,MacBook
notion.id,2,1735870936,1735870938,1735870938,-21600,MacBook
com.apple.iWork.Keynote,131,1735870805,1735870936,1735870937,-21600,MacBook
notion.id,0,1735870805,1735870805,1735870806,-21600,MacBook
com.apple.finder,3,1735870802,1735870805,1735870805,-21600,MacBook
notion.id,1,1735870801,1735870802,1735870803,-21600,MacBook
com.apple.iWork.Keynote,123,1735870678,1735870801,1735870801,-21600,MacBook
notion.id,1,1735870677,1735870678,1735870679,-21600,MacBook
com.apple.finder,3,1735870674,1735870677,1735870678,-21600,MacBook
notion.id,2,1735870672,1735870674,1735870674,-21600,MacBook
com.apple.iWork.Keynote,1,1735870671,1735870672,1735870673,-21600,MacBook
com.google.Chrome,92,1735870579,1735870671,1735870672,-21600,MacBook
com.apple.iWork.Keynote,1,1735870578,1735870579,1735870579,-21600,MacBook
notion.id,7,1735870571,1735870578,1735870578,-21600,MacBook
com.apple.finder,2,1735870569,1735870571,1735870572,-21600,MacBook
com.apple.iWork.Keynote,68,1735870501,1735870569,1735870570,-21600,MacBook
com.google.Chrome,14,1735870487,1735870501,1735870501,-21600,MacBook
notion.id,1,1735870486,1735870487,1735870487,-21600,MacBook
com.apple.iWork.Keynote,2,1735870484,1735870486,1735870486,-21600,MacBook
com.apple.finder,1,1735870483,1735870484,1735870485,-21600,MacBook
com.apple.iWork.Keynote,1,1735870482,1735870483,1735870483,-21600,MacBook
notion.id,17,1735870465,1735870482,1735870483,-21600,MacBook
com.apple.iWork.Keynote,16,1735870449,1735870465,1735870465,-21600,MacBook
com.apple.finder,0,1735870449,1735870449,1735870450,-21600,MacBook
com.google.Chrome,190,1735870259,1735870449,1735870450,-21600,MacBook
com.apple.mobiletimer,7,1735870302,1735870309,1735870310,-21600,iPhone
com.apple.iWork.Keynote,7,1735870252,1735870259,1735870259,-21600,MacBook
com.google.Chrome,263,1735869989,1735870252,1735870252,-21600,MacBook
com.apple.iWork.Keynote,8,1735869981,1735869989,1735869989,-21600,MacBook
com.google.Chrome,151,1735869830,1735869981,1735869981,-21600,MacBook
com.apple.iWork.Keynote,52,1735869778,1735869830,1735869831,-21600,MacBook
com.google.Chrome,10,1735869768,1735869778,1735869778,-21600,MacBook
com.apple.iWork.Keynote,1,1735869767,1735869768,1735869769,-21600,MacBook
com.google.Chrome,2,1735869765,1735869767,1735869768,-21600,MacBook
com.apple.iWork.Keynote,82,1735869683,1735869765,1735869765,-21600,MacBook
com.google.Chrome,13,1735869670,1735869683,1735869684,-21600,MacBook
com.apple.iWork.Keynote,6,1735869664,1735869670,1735869671,-21600,MacBook
com.google.Chrome,1,1735869663,1735869664,1735869665,-21600,MacBook
com.apple.iWork.Keynote,15,1735869648,1735869663,1735869663,-21600,MacBook
com.google.Chrome,7,1735869641,1735869648,1735869649,-21600,MacBook
com.apple.iWork.Keynote,25,1735869616,1735869641,1735869641,-21600,MacBook
com.google.Chrome,21,1735869595,1735869616,1735869617,-21600,MacBook
notion.id,15,1735869580,1735869595,1735869596,-21600,MacBook
com.google.Chrome,14,1735869566,1735869580,1735869580,-21600,MacBook
notion.id,1,1735869565,1735869566,1735869567,-21600,MacBook
com.apple.finder,8,1735869557,1735869565,1735869566,-21600,MacBook
com.microsoft.Outlook,2,1735869555,1735869557,1735869557,-21600,MacBook
notion.id,1,1735869554,1735869555,1735869556,-21600,MacBook
com.google.Chrome,3,1735869551,1735869554,1735869554,-21600,MacBook
com.apple.iWork.Keynote,3,1735869548,1735869551,1735869551,-21600,MacBook
com.google.Chrome,1,1735869547,1735869548,1735869549,-21600,MacBook
com.apple.iWork.Keynote,41,1735869506,1735869547,1735869547,-21600,MacBook
com.google.Chrome,13,1735869493,1735869506,1735869506,-21600,MacBook
com.apple.iWork.Keynote,16,1735869477,1735869493,1735869493,-21600,MacBook
com.google.Chrome,4,1735869473,1735869477,1735869477,-21600,MacBook
com.apple.iWork.Keynote,4,1735869469,1735869473,1735869473,-21600,MacBook
com.google.Chrome,1,1735869468,1735869469,1735869470,-21600,MacBook
com.apple.iWork.Keynote,5,1735869463,1735869468,1735869468,-21600,MacBook
com.google.Chrome,23,1735869440,1735869463,1735869463,-21600,MacBook
com.microsoft.Outlook,2,1735869438,1735869440,1735869441,-21600,MacBook
com.google.Chrome,5,1735869433,1735869438,1735869439,-21600,MacBook
com.apple.iWork.Keynote,72,1735869361,1735869433,1735869434,-21600,MacBook
com.google.Chrome,13,1735869348,1735869361,1735869362,-21600,MacBook
com.apple.iWork.Keynote,56,1735869292,1735869348,1735869348,-21600,MacBook
com.google.Chrome,3,1735869289,1735869292,1735869293,-21600,MacBook
com.apple.iWork.Keynote,20,1735869269,1735869289,1735869289,-21600,MacBook
com.google.Chrome,3,1735869266,1735869269,1735869270,-21600,MacBook
com.apple.iWork.Keynote,1,1735869265,1735869266,1735869266,-21600,MacBook
com.google.Chrome,28,1735869237,1735869265,1735869265,-21600,MacBook
com.apple.iWork.Keynote,4,1735869233,1735869237,1735869237,-21600,MacBook
com.google.Chrome,6,1735869227,1735869233,1735869233,-21600,MacBook
com.apple.iWork.Keynote,26,1735869201,1735869227,1735869227,-21600,MacBook
com.google.Chrome,9,1735869192,1735869201,1735869202,-21600,MacBook
com.apple.iWork.Keynote,12,1735869180,1735869192,1735869192,-21600,MacBook
com.google.Chrome,1,1735869179,1735869180,1735869180,-21600,MacBook
notion.id,31,1735869148,1735869179,1735869179,-21600,MacBook
com.apple.iWork.Keynote,1,1735869147,1735869148,1735869148,-21600,MacBook
notion.id,2,1735869145,1735869147,1735869148,-21600,MacBook
com.apple.iWork.Keynote,1,1735869144,1735869145,1735869145,-21600,MacBook
notion.id,2,1735869142,1735869144,1735869144,-21600,MacBook
com.apple.iWork.Keynote,1,1735869141,1735869142,1735869142,-21600,MacBook
com.google.Chrome,1,1735869140,1735869141,1735869142,-21600,MacBook
notion.id,5,1735869135,1735869140,1735869141,-21600,MacBook
com.apple.iWork.Keynote,19,1735869116,1735869135,1735869135,-21600,MacBook
com.google.Chrome,1,1735869115,1735869116,1735869117,-21600,MacBook
com.apple.iWork.Keynote,4,1735869111,1735869115,1735869116,-21600,MacBook
com.google.Chrome,0,1735869111,1735869111,1735869112,-21600,MacBook
com.apple.iWork.Keynote,12,1735869099,1735869111,1735869111,-21600,MacBook
com.google.Chrome,10,1735869089,1735869099,1735869099,-21600,MacBook
com.apple.iWork.Keynote,1,1735869088,1735869089,1735869090,-21600,MacBook
com.google.Chrome,0,1735869088,1735869088,1735869089,-21600,MacBook
com.apple.iWork.Keynote,2,1735869086,1735869088,1735869088,-21600,MacBook
com.google.Chrome,5,1735869081,1735869086,1735869087,-21600,MacBook
com.apple.iWork.Keynote,1,1735869080,1735869081,1735869081,-21600,MacBook
com.google.Chrome,3,1735869077,1735869080,1735869080,-21600,MacBook
com.apple.iWork.Keynote,4,1735869073,1735869077,1735869077,-21600,MacBook
com.google.Chrome,1,1735869072,1735869073,1735869074,-21600,MacBook
com.apple.iWork.Keynote,48,1735869024,1735869072,1735869072,-21600,MacBook
com.google.Chrome,7,1735869017,1735869024,1735869025,-21600,MacBook
com.apple.iWork.Keynote,0,1735869017,1735869017,1735869018,-21600,MacBook
notion.id,2,1735869015,1735869017,1735869017,-21600,MacBook
com.apple.iWork.Keynote,2,1735869013,1735869015,1735869016,-21600,MacBook
notion.id,3,1735869010,1735869013,1735869014,-21600,MacBook
com.apple.iWork.Keynote,6,1735869004,1735869010,1735869010,-21600,MacBook
notion.id,1,1735869003,1735869004,1735869004,-21600,MacBook
com.google.Chrome,177,1735868826,1735869003,1735869003,-21600,MacBook
notion.id,0,1735868826,1735868826,1735868827,-21600,MacBook
com.apple.iWork.Keynote,1,1735868825,1735868826,1735868826,-21600,MacBook
com.microsoft.Outlook,14,1735868811,1735868825,1735868825,-21600,MacBook
com.apple.iWork.Keynote,1,1735868810,1735868811,1735868811,-21600,MacBook
notion.id,1,1735868809,1735868810,1735868811,-21600,MacBook
com.google.Chrome,195,1735868614,1735868809,1735868810,-21600,MacBook
notion.id,1,1735868613,1735868614,1735868614,-21600,MacBook
com.google.Chrome,92,1735868521,1735868613,1735868614,-21600,MacBook
notion.id,1,1735868520,1735868521,1735868521,-21600,MacBook
com.google.Chrome,14,1735868506,1735868520,1735868521,-21600,MacBook
notion.id,3,1735868503,1735868506,1735868506,-21600,MacBook
com.apple.iWork.Keynote,28,1735868475,1735868503,1735868504,-21600,MacBook
com.apple.mobiletimer,11,1735868492,1735868503,1735868503,-21600,iPhone
com.apple.mobiletimer,1,1735868490,1735868491,1735868492,-21600,iPhone
com.microsoft.Outlook,10,1735868465,1735868475,1735868475,-21600,MacBook
com.apple.iWork.Keynote,2,1735868463,1735868465,1735868465,-21600,MacBook
notion.id,1,1735868462,1735868463,1735868463,-21600,MacBook
com.google.Chrome,205,1735868257,1735868462,1735868463,-21600,MacBook
com.tinyspeck.chatlyio,10,1735868227,1735868237,1735868237,-21600,iPhone
com.google.Chrome,333,1735867883,1735868216,1735868216,-21600,MacBook
com.tinyspeck.chatlyio,0,1735868079,1735868079,1735868080,-21600,iPhone
com.tinyspeck.chatlyio,48,1735867969,1735868017,1735868018,-21600,iPhone
com.apple.mobiletimer,1,1735867968,1735867969,1735867969,-21600,iPhone
com.tencent.xin,8,1735867959,1735867967,1735867968,-21600,iPhone
com.tencent.xin,19,1735867926,1735867945,1735867946,-21600,iPhone
com.apple.mobiletimer,2,1735867924,1735867926,1735867926,-21600,iPhone
com.tencent.xin,1,1735867923,1735867924,1735867926,-21600,iPhone
notion.id,2,1735867881,1735867883,1735867883,-21600,MacBook
com.microsoft.Outlook,1,1735867880,1735867881,1735867882,-21600,MacBook
com.apple.iWork.Keynote,3,1735867877,1735867880,1735867880,-21600,MacBook
com.google.Chrome,309,1735867568,1735867877,1735867877,-21600,MacBook
com.microsoft.Outlook,1,1735867567,1735867568,1735867569,-21600,MacBook
notion.id,3,1735867564,1735867567,1735867567,-21600,MacBook
com.apple.iWork.Keynote,2,1735867562,1735867564,1735867565,-21600,MacBook
com.microsoft.Outlook,3,1735867559,1735867562,1735867563,-21600,MacBook
com.apple.finder,0,1735867559,1735867559,1735867560,-21600,MacBook
com.apple.iWork.Keynote,25,1735867534,1735867559,1735867559,-21600,MacBook
com.apple.finder,2,1735867532,1735867534,1735867535,-21600,MacBook
com.microsoft.Outlook,1,1735867531,1735867532,1735867532,-21600,MacBook
com.apple.finder,2,1735867529,1735867531,1735867531,-21600,MacBook
com.apple.iWork.Keynote,45,1735867484,1735867529,1735867530,-21600,MacBook
com.apple.finder,17,1735867467,1735867484,1735867484,-21600,MacBook
com.microsoft.Outlook,1,1735867466,1735867467,1735867468,-21600,MacBook
com.apple.iWork.Keynote,1,1735867465,1735867466,1735867467,-21600,MacBook
notion.id,20,1735867445,1735867465,1735867465,-21600,MacBook
com.apple.iWork.Keynote,9,1735867436,1735867445,1735867445,-21600,MacBook
notion.id,0,1735867436,1735867436,1735867437,-21600,MacBook
com.google.Chrome,105,1735867331,1735867436,1735867436,-21600,MacBook
notion.id,1,1735867330,1735867331,1735867332,-21600,MacBook
com.apple.iWork.Keynote,1,1735867329,1735867330,1735867331,-21600,MacBook
com.microsoft.Outlook,14,1735867315,1735867329,1735867330,-21600,MacBook
notion.id,2,1735867313,1735867315,1735867315,-21600,MacBook
com.apple.iWork.Keynote,5,1735867308,1735867313,1735867313,-21600,MacBook
notion.id,2,1735867306,1735867308,1735867309,-21600,MacBook
com.apple.iWork.Keynote,1,1735867305,1735867306,1735867307,-21600,MacBook
com.microsoft.Outlook,20,1735867285,1735867305,1735867306,-21600,MacBook
com.apple.iWork.Keynote,1,1735867284,1735867285,1735867285,-21600,MacBook
notion.id,1,1735867283,1735867284,1735867284,-21600,MacBook
com.microsoft.Outlook,2,1735867281,1735867283,1735867284,-21600,MacBook
com.apple.Preview,37,1735867244,1735867281,1735867281,-21600,MacBook
com.apple.iWork.Keynote,78,1735867166,1735867244,1735867244,-21600,MacBook
com.apple.Preview,5,1735867161,1735867166,1735867166,-21600,MacBook
com.apple.iWork.Keynote,29,1735867132,1735867161,1735867161,-21600,MacBook
com.apple.Preview,1,1735867131,1735867132,1735867133,-21600,MacBook
notion.id,1,1735867130,1735867131,1735867131,-21600,MacBook
com.apple.Preview,88,1735867042,1735867130,1735867130,-21600,MacBook
notion.id,1,1735867041,1735867042,1735867043,-21600,MacBook
com.google.Chrome,52,1735866989,1735867041,1735867042,-21600,MacBook
notion.id,1,1735866988,1735866989,1735866990,-21600,MacBook
com.apple.Preview,1,1735866987,1735866988,1735866988,-21600,MacBook
com.microsoft.Outlook,22,1735866965,1735866987,1735866988,-21600,MacBook
notion.id,1,1735866964,1735866965,1735866965,-21600,MacBook
com.microsoft.Outlook,2,1735866962,1735866964,1735866965,-21600,MacBook
com.apple.Preview,58,1735866904,1735866962,1735866962,-21600,MacBook
notion.id,1,1735866903,1735866904,1735866905,-21600,MacBook
com.google.Chrome,73,1735866830,1735866903,1735866904,-21600,MacBook
notion.id,1,1735866829,1735866830,1735866830,-21600,MacBook
com.apple.Preview,153,1735866676,1735866829,1735866830,-21600,MacBook
com.apple.finder,2,1735866674,1735866676,1735866676,-21600,MacBook
com.apple.Preview,2,1735866672,1735866674,1735866675,-21600,MacBook
com.apple.finder,1,1735866671,1735866672,1735866672,-21600,MacBook
notion.id,7,1735866664,1735866671,1735866672,-21600,MacBook
com.google.Chrome,228,1735866436,1735866664,1735866664,-21600,MacBook
notion.id,10,1735866426,1735866436,1735866436,-21600,MacBook
com.google.Chrome,5,1735866421,1735866426,1735866426,-21600,MacBook
notion.id,6,1735866415,1735866421,1735866422,-21600,MacBook
com.google.Chrome,3,1735866412,1735866415,1735866415,-21600,MacBook
notion.id,23,1735866389,1735866412,1735866412,-21600,MacBook
com.google.Chrome,15,1735866374,1735866389,1735866389,-21600,MacBook
com.apple.finder,1,1735866373,1735866374,1735866375,-21600,MacBook
notion.id,62,1735866311,1735866373,1735866373,-21600,MacBook
com.apple.finder,1,1735866310,1735866311,1735866312,-21600,MacBook
com.google.Chrome,188,1735866122,1735866310,1735866311,-21600,MacBook
com.apple.finder,4,1735866118,1735866122,1735866123,-21600,MacBook
com.apple.Preview,1,1735866117,1735866118,1735866119,-21600,MacBook
com.google.Chrome,506,1735865611,1735866117,1735866117,-21600,MacBook
com.tencent.xin,5,1735865612,1735865617,1735865618,-21600,iPhone
com.tencent.xin,34,1735865577,1735865611,1735865612,-21600,iPhone
com.tinyspeck.chatlyio,15,1735865562,1735865577,1735865578,-21600,iPhone
com.tencent.xin,3,1735865559,1735865562,1735865563,-21600,iPhone
com.tinyspeck.chatlyio,16,1735865543,1735865559,1735865560,-21600,iPhone
com.tencent.xin,1,1735865542,1735865543,1735865543,-21600,iPhone
com.apple.mobiletimer,2,1735865539,1735865541,1735865542,-21600,iPhone
com.apple.Preview,2,1735865472,1735865474,1735865474,-21600,MacBook
com.apple.mobiletimer,9,1735865340,1735865349,1735865350,-21600,iPhone
notion.id,1,1735865125,1735865126,1735865127,-21600,MacBook
com.google.Chrome,60,1735865065,1735865125,1735865125,-21600,MacBook
com.apple.Preview,6,1735865059,1735865065,1735865066,-21600,MacBook
com.apple.iWork.Keynote,1,1735865058,1735865059,1735865060,-21600,MacBook
notion.id,1,1735865057,1735865058,1735865058,-21600,MacBook
com.apple.Preview,6,1735865051,1735865057,1735865057,-21600,MacBook
notion.id,15,1735865036,1735865051,1735865051,-21600,MacBook
com.apple.iWork.Keynote,1,1735865035,1735865036,1735865037,-21600,MacBook
com.apple.Preview,1,1735865034,1735865035,1735865036,-21600,MacBook
notion.id,1,1735865033,1735865034,1735865035,-21600,MacBook
com.apple.Preview,66,1735864967,1735865033,1735865033,-21600,MacBook
com.google.Chrome,90,1735864877,1735864967,1735864967,-21600,MacBook
com.apple.Preview,61,1735864816,1735864877,1735864878,-21600,MacBook
com.google.Chrome,110,1735864706,1735864816,1735864816,-21600,MacBook
com.apple.Preview,179,1735864527,1735864706,1735864707,-21600,MacBook
us.zoom.xos,668,1735863859,1735864527,1735864528,-21600,MacBook
com.apple.mobiletimer,9,1735864370,1735864379,1735864380,-21600,iPhone
com.apple.sidecar,3,1735864370,1735864373,1735864373,-21600,iPhone
com.apple.mobiletimer,6,1735863998,1735864004,1735864004,-21600,iPhone
com.google.Chrome,5,1735863854,1735863859,1735863859,-21600,MacBook
us.zoom.xos,10,1735863844,1735863854,1735863854,-21600,MacBook
com.apple.Preview,2,1735863842,1735863844,1735863844,-21600,MacBook
com.apple.finder,5,1735863837,1735863842,1735863842,-21600,MacBook
us.zoom.xos,1,1735863836,1735863837,1735863838,-21600,MacBook
com.google.Chrome,168,1735863668,1735863836,1735863836,-21600,MacBook
us.zoom.xos,3,1735863665,1735863668,1735863668,-21600,MacBook
com.google.Chrome,14,1735863651,1735863665,1735863665,-21600,MacBook
us.zoom.xos,0,1735863651,1735863651,1735863652,-21600,MacBook
com.google.Chrome,1,1735863650,1735863651,1735863651,-21600,MacBook
com.apple.Preview,1,1735863649,1735863650,1735863650,-21600,MacBook
com.google.Chrome,1,1735863648,1735863649,1735863649,-21600,MacBook
us.zoom.xos,1,1735863647,1735863648,1735863648,-21600,MacBook
com.google.Chrome,201,1735863446,1735863647,1735863647,-21600,MacBook
com.apple.Preview,55,1735863391,1735863446,1735863447,-21600,MacBook
us.zoom.xos,0,1735863391,1735863391,1735863391,-21600,MacBook
com.google.Chrome,4,1735863387,1735863391,1735863391,-21600,MacBook
us.zoom.xos,7,1735863380,1735863387,1735863388,-21600,MacBook
com.apple.Preview,2,1735863378,1735863380,1735863380,-21600,MacBook
us.zoom.xos,2,1735863376,1735863378,1735863378,-21600,MacBook
com.apple.Preview,2,1735863374,1735863376,1735863377,-21600,MacBook
us.zoom.xos,3,1735863371,1735863374,1735863375,-21600,MacBook
com.apple.Preview,16,1735863355,1735863371,1735863371,-21600,MacBook
us.zoom.xos,4,1735863347,1735863351,1735863351,-21600,MacBook
com.apple.Preview,158,1735863189,1735863347,1735863348,-21600,MacBook
com.apple.finder,4,1735862857,1735862861,1735862862,-21600,MacBook
com.apple.Preview,2,1735862855,1735862857,1735862858,-21600,MacBook
com.google.Chrome,258,1735862597,1735862855,1735862856,-21600,MacBook
com.apple.Preview,4,1735862593,1735862597,1735862598,-21600,MacBook
com.google.Chrome,423,1735862170,1735862593,1735862594,-21600,MacBook
notion.id,1,1735862169,1735862170,1735862171,-21600,MacBook
com.apple.Preview,4,1735862165,1735862169,1735862169,-21600,MacBook
com.apple.finder,1,1735862164,1735862165,1735862166,-21600,MacBook
com.apple.Preview,1,1735862163,1735862164,1735862165,-21600,MacBook
notion.id,3,1735862160,1735862163,1735862164,-21600,MacBook
com.apple.finder,1,1735862159,1735862160,1735862161,-21600,MacBook
com.apple.Preview,1,1735862158,1735862159,1735862160,-21600,MacBook
com.apple.finder,0,1735862158,1735862158,1735862159,-21600,MacBook
notion.id,1,1735862157,1735862158,1735862158,-21600,MacBook
com.google.Chrome,2,1735862155,1735862157,1735862158,-21600,MacBook
notion.id,26,1735862129,1735862155,1735862156,-21600,MacBook
com.apple.finder,3,1735862126,1735862129,1735862129,-21600,MacBook
notion.id,2,1735862124,1735862126,1735862126,-21600,MacBook
com.apple.Preview,1,1735862123,1735862124,1735862124,-21600,MacBook
com.apple.iWork.Keynote,6,1735862117,1735862123,1735862123,-21600,MacBook
com.google.Chrome,1,1735862116,1735862117,1735862117,-21600,MacBook
com.apple.Preview,1,1735862115,1735862116,1735862116,-21600,MacBook
com.apple.finder,2,1735862113,1735862115,1735862115,-21600,MacBook
com.google.Chrome,8,1735862105,1735862113,1735862113,-21600,MacBook
com.apple.finder,2,1735862103,1735862105,1735862105,-21600,MacBook
notion.id,32,1735862071,1735862103,1735862104,-21600,MacBook
com.google.Chrome,3,1735862068,1735862071,1735862071,-21600,MacBook
notion.id,59,1735862009,1735862068,1735862068,-21600,MacBook
com.microsoft.Outlook,6,1735862003,1735862009,1735862010,-21600,MacBook
com.google.Chrome,51,1735861952,1735862003,1735862004,-21600,MacBook
com.microsoft.Outlook,6,1735861946,1735861952,1735861953,-21600,MacBook
com.google.Chrome,105,1735861841,1735861946,1735861947,-21600,MacBook
com.microsoft.Outlook,35,1735861806,1735861841,1735861841,-21600,MacBook
com.apple.iWork.Keynote,1,1735861762,1735861763,1735861764,-21600,MacBook
com.google.Chrome,47,1735861715,1735861762,1735861762,-21600,MacBook
com.apple.mobiletimer,9,1735861732,1735861741,1735861741,-21600,iPhone
com.apple.iWork.Keynote,7,1735861708,1735861715,1735861715,-21600,MacBook
com.google.Chrome,28,1735861680,1735861708,1735861709,-21600,MacBook
com.tencent.xin,4,1735861690,1735861694,1735861695,-21600,iPhone
com.apple.iWork.Keynote,1,1735861602,1735861603,1735861604,-21600,MacBook
com.microsoft.Outlook,5,1735861597,1735861602,1735861603,-21600,MacBook
com.apple.iWork.Keynote,0,1735861597,1735861597,1735861598,-21600,MacBook
com.google.Chrome,4,1735861593,1735861597,1735861597,-21600,MacBook
com.apple.iWork.Keynote,1,1735861592,1735861593,1735861594,-21600,MacBook
com.google.Chrome,25,1735861567,1735861592,1735861593,-21600,MacBook
com.apple.iWork.Keynote,2,1735861565,1735861567,1735861568,-21600,MacBook
com.microsoft.Outlook,16,1735861549,1735861565,1735861565,-21600,MacBook
com.apple.iWork.Keynote,10,1735861539,1735861549,1735861549,-21600,MacBook
com.microsoft.Outlook,5,1735861534,1735861539,1735861539,-21600,MacBook
com.apple.iWork.Keynote,1,1735861533,1735861534,1735861535,-21600,MacBook
com.microsoft.Outlook,2,1735861531,1735861533,1735861533,-21600,MacBook
com.google.Chrome,6,1735861525,1735861531,1735861532,-21600,MacBook
com.microsoft.Outlook,4,1735861521,1735861525,1735861525,-21600,MacBook
com.apple.finder,6,1735861515,1735861521,1735861522,-21600,MacBook
com.google.Chrome,2,1735861513,1735861515,1735861516,-21600,MacBook
com.microsoft.Outlook,3,1735861510,1735861513,1735861514,-21600,MacBook
com.google.Chrome,11,1735861499,1735861510,1735861511,-21600,MacBook
com.apple.finder,6,1735861493,1735861499,1735861500,-21600,MacBook
com.microsoft.Office.Outlook,10,1735861364,1735861374,1735861375,-21600,iPhone
com.tencent.xin,35,1735861329,1735861364,1735861364,-21600,iPhone
com.apple.mobiletimer,3,1735861325,1735861328,1735861329,-21600,iPhone
com.apple.mobiletimer,8,1735860788,1735860796,1735860797,-21600,iPhone
com.apple.mobiletimer,2,1735860769,1735860771,1735860771,-21600,iPhone
com.apple.mobiletimer,2,1735860767,1735860769,1735860769,-21600,iPhone
com.apple.PassbookUIService,1,1735860768,1735860769,1735860769,-21600,iPhone
com.apple.mobiletimer,2,1735860691,1735860693,1735860693,-21600,iPhone
com.apple.mobiletimer,1,1735860417,1735860418,1735860419,-21600,iPhone
com.apple.mobiletimer,3,1735860244,1735860247,1735860247,-21600,iPhone
com.xingin.discover,9,1735860233,1735860242,1735860243,-21600,iPhone
com.xingin.discover,171,1735859870,1735860041,1735860042,-21600,iPhone
com.apple.mobiletimer,3,1735859867,1735859870,1735859870,-21600,iPhone
com.apple.mobiletimer,4,1735859329,1735859333,1735859334,-21600,iPhone
com.xingin.discover,2,1735859325,1735859327,1735859328,-21600,iPhone
com.xingin.discover,454,1735858745,1735859199,1735859199,-21600,iPhone
com.apple.mobileslideshow,4,1735858739,1735858743,1735858744,-21600,iPhone
com.apple.mobileslideshow,1,1735858701,1735858702,1735858702,-21600,iPhone
com.apple.mobileslideshow,6,1735858596,1735858602,1735858604,-21600,iPhone
com.apple.camera,5,1735858557,1735858562,1735858563,-21600,iPhone
com.tencent.xin,7,1735858553,1735858560,1735858561,-21600,iPhone
com.tencent.xin,7,1735858365,1735858372,1735858373,-21600,iPhone
com.tencent.xin,9,1735858260,1735858269,1735858269,-21600,iPhone
com.xingin.discover,1,1735858256,1735858257,1735858257,-21600,iPhone
com.apple.mobiletimer,4,1735858252,1735858256,1735858256,-21600,iPhone
com.apple.mobiletimer,5,1735858014,1735858019,1735858019,-21600,iPhone
com.xingin.discover,5,1735858008,1735858013,1735858013,-21600,iPhone
com.xingin.discover,36,1735857904,1735857940,1735857941,-21600,iPhone
com.tencent.xin,3,1735857901,1735857904,1735857905,-21600,iPhone
com.tencent.xin,21,1735857155,1735857176,1735857176,-21600,iPhone
com.xingin.discover,4,1735857151,1735857155,1735857156,-21600,iPhone
com.xingin.discover,35,1735856769,1735856804,1735856805,-21600,iPhone
com.xingin.discover,133,1735856344,1735856477,1735856478,-21600,iPhone
com.xingin.discover,10,1735856132,1735856142,1735856142,-21600,iPhone
com.xingin.discover,198,1735855793,1735855991,1735855992,-21600,iPhone
com.xingin.discover,2,1735855401,1735855403,1735855403,-21600,iPhone
com.microsoft.Office.Outlook,6,1735855395,1735855401,1735855401,-21600,iPhone
com.apple.MobileSMS,3,1735855391,1735855394,1735855395,-21600,iPhone
com.apple.mobiletimer,3,1735855387,1735855390,1735855390,-21600,iPhone
com.xingin.discover,4,1735855381,1735855385,1735855385,-21600,iPhone
com.xingin.discover,5918,1735849229,1735855147,1735855147,-21600,iPhone
com.apple.mobiletimer,3,1735849222,1735849225,1735849225,-21600,iPhone
com.apple.mobiletimer,6,1735849175,1735849181,1735849182,-21600,iPhone
com.microsoft.Office.Outlook,8,1735849166,1735849174,1735849175,-21600,iPhone
com.apple.camera,1,1735849167,1735849168,1735849168,-21600,iPhone
com.microsoft.Office.Outlook,16,1735849097,1735849113,1735849114,-21600,iPhone
com.microsoft.Office.Outlook,23,1735849074,1735849097,1735849098,-21600,iPhone
com.tencent.xin,59,1735849013,1735849072,1735849073,-21600,iPhone
com.chase,4,1735849009,1735849013,1735849013,-21600,iPhone
com.tencent.xin,3,1735849006,1735849009,1735849009,-21600,iPhone
com.chase,6,1735849000,1735849006,1735849007,-21600,iPhone
com.tencent.xin,10,1735848990,1735849000,1735849000,-21600,iPhone
com.chase,21,1735848969,1735848990,1735848991,-21600,iPhone
com.apple.CoreAuthUI,7,1735848971,1735848978,1735848979,-21600,iPhone
com.chase,60,1735848903,1735848963,1735848964,-21600,iPhone
com.openai.chat,44,1735848859,1735848903,1735848903,-21600,iPhone
com.chase,44,1735848814,1735848858,1735848858,-21600,iPhone
com.microsoft.Office.Outlook,42,1735848772,1735848814,1735848814,-21600,iPhone
com.chase,39,1735848733,1735848772,1735848773,-21600,iPhone
com.apple.CoreAuthUI,2,1735848738,1735848740,1735848740,-21600,iPhone
com.tencent.xin,7,1735848724,1735848731,1735848731,-21600,iPhone
com.microsoft.Office.Outlook,78,1735848644,1735848722,1735848723,-21600,iPhone
com.tencent.xin,6,1735848638,1735848644,1735848644,-21600,iPhone
com.microsoft.Office.Outlook,7,1735848631,1735848638,1735848638,-21600,iPhone
com.tencent.xin,10,1735848621,1735848631,1735848632,-21600,iPhone
com.yardi.rentcafe.resident,45,1735848576,1735848621,1735848622,-21600,iPhone
com.tencent.xin,9,1735848567,1735848576,1735848576,-21600,iPhone
com.yardi.rentcafe.resident,5,1735848562,1735848567,1735848568,-21600,iPhone
com.tencent.xin,1,1735848561,1735848562,1735848562,-21600,iPhone
com.yardi.rentcafe.resident,1,1735848559,1735848560,1735848560,-21600,iPhone
com.discoverfinancial.mobile,9,1735848548,1735848557,1735848558,-21600,iPhone
com.apple.CoreAuthUI,2,1735848553,1735848555,1735848555,-21600,iPhone
com.apple.MobileSMS,4,1735848544,1735848548,1735848548,-21600,iPhone
com.tencent.xin,6,1735848534,1735848540,1735848541,-21600,iPhone
com.apple.finder,2,1735848530,1735848532,1735848533,-21600,MacBook
com.microsoft.Outlook,1,1735848529,1735848530,1735848530,-21600,MacBook
us.zoom.xos,4,1735848525,1735848529,1735848530,-21600,MacBook
com.microsoft.Outlook,0,1735848525,1735848525,1735848526,-21600,MacBook
com.apple.Preview,2,1735848523,1735848525,1735848525,-21600,MacBook
com.google.Chrome,8,1735848515,1735848523,1735848523,-21600,MacBook
com.microsoft.Outlook,4,1735848511,1735848515,1735848516,-21600,MacBook
com.google.Chrome,17,1735848494,1735848511,1735848511,-21600,MacBook
com.microsoft.Outlook,74,1735848420,1735848494,1735848495,-21600,MacBook
com.google.Chrome,17,1735848403,1735848420,1735848421,-21600,MacBook
com.microsoft.Outlook,16,1735848387,1735848403,1735848403,-21600,MacBook
com.google.Chrome,27,1735848360,1735848387,1735848388,-21600,MacBook
com.microsoft.Outlook,8,1735848352,1735848360,1735848361,-21600,MacBook
com.google.Chrome,21,1735848331,1735848352,1735848353,-21600,MacBook
com.microsoft.Outlook,16,1735848292,1735848308,1735848309,-21600,MacBook
com.tencent.xin,26,1735848277,1735848303,1735848304,-21600,iPhone
com.google.Chrome,47,1735848245,1735848292,1735848293,-21600,MacBook
com.duosecurity.DuoMobile,4,1735848270,1735848274,1735848275,-21600,iPhone
com.duosecurity.DuoMobile,6,1735848258,1735848264,1735848265,-21600,iPhone
com.apple.finder,6,1735848239,1735848245,1735848245,-21600,MacBook
com.apple.Preview,6,1735848233,1735848239,1735848240,-21600,MacBook
com.microsoft.Outlook,4,1735848229,1735848233,1735848233,-21600,MacBook
com.google.Chrome,3,1735848226,1735848229,1735848230,-21600,MacBook
com.apple.Preview,1,1735848225,1735848226,1735848227,-21600,MacBook
com.google.Chrome,111,1735848114,1735848225,1735848225,-21600,MacBook
com.microsoft.Outlook,179,1735847935,1735848114,1735848115,-21600,MacBook
com.duosecurity.DuoMobile,10,1735847933,1735847943,1735847943,-21600,iPhone
com.google.Chrome,330,1735847605,1735847935,1735847936,-21600,MacBook
com.apple.Preview,4,1735847601,1735847605,1735847606,-21600,MacBook
com.apple.finder,2,1735847599,1735847601,1735847601,-21600,MacBook
com.apple.Preview,1,1735847598,1735847599,1735847600,-21600,MacBook
com.google.Chrome,2,1735847596,1735847598,1735847599,-21600,MacBook
com.apple.Preview,4,1735847592,1735847596,1735847597,-21600,MacBook
com.apple.finder,2,1735847590,1735847592,1735847593,-21600,MacBook
com.google.Chrome,645,1735846945,1735847590,1735847591,-21600,MacBook
com.duosecurity.DuoMobile,10,1735847485,1735847495,1735847496,-21600,iPhone
com.microsoft.Outlook,1,1735846944,1735846945,1735846946,-21600,MacBook
com.google.Chrome,1,1735846943,1735846944,1735846946,-21600,MacBook
com.microsoft.Outlook,16,1735846927,1735846943,1735846943,-21600,MacBook
com.apple.finder,3,1735846924,1735846927,1735846928,-21600,MacBook
com.apple.Preview,1,1735846923,1735846924,1735846925,-21600,MacBook
com.google.Chrome,5,1735846918,1735846923,1735846924,-21600,MacBook
com.apple.Preview,1,1735846917,1735846918,1735846918,-21600,MacBook
com.google.Chrome,83,1735846834,1735846917,1735846918,-21600,MacBook
com.apple.Preview,9,1735846825,1735846834,1735846834,-21600,MacBook
com.google.Chrome,5,1735846820,1735846825,1735846825,-21600,MacBook
com.apple.Preview,6,1735846814,1735846820,1735846821,-21600,MacBook
com.google.Chrome,8,1735846806,1735846814,1735846815,-21600,MacBook
com.apple.Preview,3,1735846803,1735846806,1735846806,-21600,MacBook
com.google.Chrome,68,1735846735,1735846803,1735846804,-21600,MacBook
com.apple.Preview,18,1735846717,1735846735,1735846736,-21600,MacBook
com.apple.finder,4,1735846713,1735846717,1735846718,-21600,MacBook
com.apple.Preview,3,1735846710,1735846713,1735846714,-21600,MacBook
com.apple.finder,49,1735846661,1735846710,1735846710,-21600,MacBook
com.google.Chrome,214,1735846447,1735846661,1735846662,-21600,MacBook
com.apple.finder,2,1735846445,1735846447,1735846448,-21600,MacBook
com.microsoft.Outlook,14,1735846431,1735846445,1735846446,-21600,MacBook
com.duosecurity.DuoMobile,10,1735846423,1735846433,1735846434,-21600,iPhone
com.google.Chrome,385,1735846046,1735846431,1735846432,-21600,MacBook
com.apple.finder,1,1735846045,1735846046,1735846046,-21600,MacBook
com.google.Chrome,115,1735845930,1735846045,1735846045,-21600,MacBook
com.apple.finder,6,1735845924,1735845930,1735845931,-21600,MacBook
com.google.Chrome,90,1735845834,1735845924,1735845924,-21600,MacBook
com.apple.finder,5,1735845829,1735845834,1735845835,-21600,MacBook
com.google.Chrome,1,1735845828,1735845829,1735845829,-21600,MacBook
com.apple.finder,10,1735845818,1735845828,1735845828,-21600,MacBook
com.google.Chrome,12,1735845806,1735845818,1735845818,-21600,MacBook
com.apple.finder,17,1735845789,1735845806,1735845807,-21600,MacBook
com.google.Chrome,7,1735845782,1735845789,1735845790,-21600,MacBook
com.apple.finder,7,1735845775,1735845782,1735845782,-21600,MacBook
com.google.Chrome,2,1735845773,1735845775,1735845776,-21600,MacBook
com.apple.finder,3,1735845770,1735845773,1735845773,-21600,MacBook
com.google.Chrome,1,1735845769,1735845770,1735845771,-21600,MacBook
com.apple.finder,17,1735845752,1735845769,1735845770,-21600,MacBook
com.google.Chrome,115,1735845637,1735845752,1735845753,-21600,MacBook
com.apple.finder,23,1735845614,1735845637,1735845637,-21600,MacBook
com.google.Chrome,189,1735845425,1735845614,1735845614,-21600,MacBook
com.apple.finder,13,1735845412,1735845425,1735845426,-21600,MacBook
com.microsoft.Outlook,1,1735845411,1735845412,1735845412,-21600,MacBook
com.google.Chrome,14,1735845397,1735845411,1735845411,-21600,MacBook
com.microsoft.Outlook,23,1735845374,1735845397,1735845397,-21600,MacBook
com.google.Chrome,23,1735845351,1735845374,1735845375,-21600,MacBook
com.microsoft.Outlook,6,1735845345,1735845351,1735845352,-21600,MacBook
com.google.Chrome,2,1735845343,1735845345,1735845346,-21600,MacBook
com.microsoft.Outlook,24,1735845319,1735845343,1735845343,-21600,MacBook
com.google.Chrome,508,1735844811,1735845319,1735845320,-21600,MacBook
com.duosecurity.DuoMobile,62,1735845183,1735845245,1735845245,-21600,iPhone
com.apple.mobiletimer,3,1735845176,1735845179,1735845179,-21600,iPhone
com.microsoft.Outlook,9,1735844802,1735844811,1735844812,-21600,MacBook
com.google.Chrome,38,1735844764,1735844802,1735844802,-21600,MacBook
com.apple.mobiletimer,19,1735844762,1735844781,1735844782,-21600,iPhone
com.microsoft.Outlook,8,1735844756,1735844764,1735844764,-21600,MacBook
com.apple.finder,1,1735844755,1735844756,1735844757,-21600,MacBook
com.google.Chrome,3,1735844752,1735844755,1735844755,-21600,MacBook
com.apple.finder,1,1735844751,1735844752,1735844753,-21600,MacBook
com.google.Chrome,65,1735844686,1735844751,1735844752,-21600,MacBook
com.apple.mobiletimer,7,1735844737,1735844744,1735844744,-21600,iPhone
com.apple.mobiletimer,3,1735844710,1735844713,1735844714,-21600,iPhone
com.xingin.discover,4,1735844706,1735844710,1735844710,-21600,iPhone
com.apple.camera,1,1735844708,1735844709,1735844710,-21600,iPhone
com.microsoft.Outlook,23,1735844663,1735844686,1735844687,-21600,MacBook
com.google.Chrome,3,1735844660,1735844663,1735844663,-21600,MacBook
com.microsoft.Outlook,10,1735844650,1735844660,1735844661,-21600,MacBook
com.google.Chrome,3,1735844647,1735844650,1735844651,-21600,MacBook
com.microsoft.Outlook,2,1735844645,1735844647,1735844647,-21600,MacBook
com.google.Chrome,8,1735844637,1735844645,1735844646,-21600,MacBook
com.microsoft.Outlook,22,1735844615,1735844637,1735844638,-21600,MacBook
com.google.Chrome,2,1735844613,1735844615,1735844616,-21600,MacBook
com.microsoft.Outlook,29,1735844584,1735844613,1735844614,-21600,MacBook
com.google.Chrome,6,1735844578,1735844584,1735844584,-21600,MacBook
com.xingin.discover,2,1735844540,1735844542,1735844543,-21600,iPhone
com.apple.sidecar,1,1735844540,1735844541,1735844541,-21600,iPhone
com.xingin.discover,2,1735844537,1735844539,1735844540,-21600,iPhone
com.apple.sidecar,2,1735844537,1735844539,1735844540,-21600,iPhone
com.microsoft.Outlook,8,1735844520,1735844528,1735844529,-21600,MacBook
us.zoom.xos,1,1735844519,1735844520,1735844521,-21600,MacBook
com.microsoft.Outlook,29,1735844490,1735844519,1735844519,-21600,MacBook
com.google.Chrome,15,1735844475,1735844490,1735844490,-21600,MacBook
com.microsoft.Outlook,0,1735844475,1735844475,1735844476,-21600,MacBook
com.google.Chrome,4,1735844471,1735844475,1735844475,-21600,MacBook
com.apple.finder,3,1735844468,1735844471,1735844473,-21600,MacBook
com.google.Chrome,7,1735844461,1735844468,1735844470,-21600,MacBook
com.xingin.discover,190,1735844260,1735844450,1735844451,-21600,iPhone
com.tencent.xin,23,1735844235,1735844258,1735844259,-21600,iPhone
com.apple.mobiletimer,4,1735844227,1735844231,1735844232,-21600,iPhone
com.apple.mobiletimer,3,1735844178,1735844181,1735844181,-21600,iPhone
com.xingin.discover,3,1735844175,1735844178,1735844178,-21600,iPhone
com.xingin.discover,755,1735843390,1735844145,1735844146,-21600,iPhone
com.apple.mobiletimer,2,1735843388,1735843390,1735843391,-21600,iPhone
com.xingin.discover,484,1735842904,1735843388,1735843389,-21600,iPhone
com.tencent.xin,6,1735842898,1735842904,1735842904,-21600,iPhone
com.xingin.discover,582,1735842316,1735842898,1735842898,-21600,iPhone
com.tencent.xin,28,1735842288,1735842316,1735842317,-21600,iPhone
com.xingin.discover,3,1735842285,1735842288,1735842289,-21600,iPhone
com.tencent.xin,1,1735842284,1735842285,1735842286,-21600,iPhone
com.xingin.discover,78,1735842204,1735842282,1735842282,-21600,iPhone
com.ubercab.UberEats,108,1735842092,1735842200,1735842200,-21600,iPhone
com.xingin.discover,1451,1735840641,1735842092,1735842093,-21600,iPhone
com.ubercab.UberEats,2,1735840638,1735840640,1735840640,-21600,iPhone
com.tencent.xin,65,1735840567,1735840632,1735840633,-21600,iPhone
com.xingin.discover,17,1735840550,1735840567,1735840568,-21600,iPhone
com.tencent.xin,49,1735840500,1735840549,1735840550,-21600,iPhone
com.microsoft.Office.Outlook,31,1735840469,1735840500,1735840501,-21600,iPhone
com.tencent.xin,1,1735840468,1735840469,1735840469,-21600,iPhone
com.apple.mobiletimer,9,1735840456,1735840465,1735840465,-21600,iPhone
com.apple.mobiletimer,11,1735839615,1735839626,1735839627,-21600,iPhone
com.apple.MobileSMS,8,1735839607,1735839615,1735839615,-21600,iPhone
com.apple.MobileSMS,6,1735839600,1735839606,1735839607,-21600,iPhone
com.apple.MobileSMS,6,1735839069,1735839075,1735839076,-21600,iPhone
com.apple.mobiletimer,5,1735839064,1735839069,1735839070,-21600,iPhone
com.apple.mobilenotes,5,1735839059,1735839064,1735839065,-21600,iPhone
com.apple.mobilenotes,25,1735839000,1735839025,1735839026,-21600,iPhone
com.apple.mobilenotes,10,1735832706,1735832716,1735832716,-21600,iPhone
com.apple.mobilenotes,3,1735823261,1735823264,1735823264,-21600,iPhone
com.apple.mobilenotes,79,1735822480,1735822559,1735822560,-21600,iPhone
com.apple.mobilenotes,1495,1735820547,1735822042,1735822043,-21600,iPhone
com.apple.mobilenotes,6,1735820539,1735820545,1735820546,-21600,iPhone
com.apple.mobiletimer,2,1735820536,1735820538,1735820539,-21600,iPhone
com.apple.mobiletimer,23,1735820499,1735820522,1735820522,-21600,iPhone
com.tencent.xin,3,1735820496,1735820499,1735820499,-21600,iPhone
com.tencent.xin,60,1735820246,1735820306,1735820307,-21600,iPhone
com.xingin.discover,3,1735820242,1735820245,1735820246,-21600,iPhone
com.xingin.discover,14,1735820226,1735820240,1735820241,-21600,iPhone
com.xingin.discover,6,1735820163,1735820169,1735820169,-21600,iPhone
com.xingin.discover,8,1735819520,1735819528,1735819528,-21600,iPhone
com.xingin.discover,18,1735819161,1735819179,1735819180,-21600,iPhone
com.xingin.discover,2,1735818691,1735818693,1735818693,-21600,iPhone
com.xingin.discover,152,1735818420,1735818572,1735818572,-21600,iPhone
com.xingin.discover,10,1735818005,1735818015,1735818016,-21600,iPhone
com.xingin.discover,13,1735817834,1735817847,1735817848,-21600,iPhone
com.apple.camera,3,1735817830,1735817833,1735817834,-21600,iPhone
com.tencent.xin,4,1735817826,1735817830,1735817831,-21600,iPhone
com.tencent.xin,12,1735817721,1735817733,1735817734,-21600,iPhone
com.apple.mobiletimer,5,1735817716,1735817721,1735817722,-21600,iPhone
com.apple.camera,3,1735817712,1735817715,1735817715,-21600,iPhone
com.tencent.xin,1,1735817708,1735817709,1735817710,-21600,iPhone
com.xingin.discover,2,1735817706,1735817708,1735817709,-21600,iPhone
com.xingin.discover,10,1735817379,1735817389,1735817389,-21600,iPhone
com.xingin.discover,10,1735817366,1735817376,1735817377,-21600,iPhone
com.xingin.discover,11,1735816749,1735816760,1735816761,-21600,iPhone
com.xingin.discover,159,1735816480,1735816639,1735816640,-21600,iPhone
com.apple.mobiletimer,1,1735816478,1735816479,1735816480,-21600,iPhone
com.apple.mobiletimer,22,1735816125,1735816147,1735816147,-21600,iPhone
com.xingin.discover,7,1735816116,1735816123,1735816123,-21600,iPhone
com.xingin.discover,105,1735815479,1735815584,1735815585,-21600,iPhone
com.xingin.discover,121,1735815355,1735815476,1735815477,-21600,iPhone
com.tencent.xin,4,1735815351,1735815355,1735815355,-21600,iPhone
com.tencent.xin,33,1735815200,1735815233,1735815234,-21600,iPhone
com.xingin.discover,3,1735815196,1735815199,1735815199,-21600,iPhone
com.xingin.discover,138,1735814755,1735814893,1735814894,-21600,iPhone
com.xingin.discover,302,1735814438,1735814740,1735814741,-21600,iPhone
tv.danmaku.bilianime,6,1735814431,1735814437,1735814437,-21600,iPhone
tv.danmaku.bilianime,1,1735814384,1735814385,1735814386,-21600,iPhone
tv.danmaku.bilianime,192,1735814145,1735814337,1735814338,-21600,iPhone
tv.danmaku.bilianime,25,1735813878,1735813903,1735813904,-21600,iPhone
tv.danmaku.bilianime,0,1735813788,1735813788,1735813789,-21600,iPhone
tv.danmaku.bilianime,232,1735813555,1735813787,1735813788,-21600,iPhone
tv.danmaku.bilianime,4,1735813258,1735813262,1735813263,-21600,iPhone
tv.danmaku.bilianime,472,1735811588,1735812060,1735812061,-21600,iPhone
com.apple.Preferences,2,1735811586,1735811588,1735811588,-21600,iPhone
com.xfinity.digitalhome,29,1735811557,1735811586,1735811587,-21600,iPhone
com.apple.Preferences,13,1735811541,1735811554,1735811554,-21600,iPhone
tv.danmaku.bilianime,47,1735811493,1735811540,1735811541,-21600,iPhone
tv.danmaku.bilianime,6,1735811181,1735811187,1735811188,-21600,iPhone
tv.danmaku.bilianime,54,1735810133,1735810187,1735810187,-21600,iPhone
com.tencent.xin,2,1735810131,1735810133,1735810134,-21600,iPhone
com.tencent.xin,5,1735809830,1735809835,1735809835,-21600,iPhone
tv.danmaku.bilianime,9,1735809821,1735809830,1735809830,-21600,iPhone
tv.danmaku.bilianime,91,1735809730,1735809821,1735809822,-21600,iPhone
com.tencent.xin,8,1735809722,1735809730,1735809730,-21600,iPhone
com.tencent.xin,111,1735809609,1735809720,1735809721,-21600,iPhone
com.tencent.xin,55,1735809498,1735809553,1735809554,-21600,iPhone
tv.danmaku.bilianime,121,1735809377,1735809498,1735809498,-21600,iPhone
com.tencent.xin,28,1735809349,1735809377,1735809377,-21600,iPhone
tv.danmaku.bilianime,2,1735809347,1735809349,1735809350,-21600,iPhone
tv.danmaku.bilianime,10,1735809239,1735809249,1735809249,-21600,iPhone
tv.danmaku.bilianime,59,1735809140,1735809199,1735809199,-21600,iPhone
tv.danmaku.bilianime,172,1735808915,1735809087,1735809088,-21600,iPhone
tv.danmaku.bilianime,3,1735808906,1735808909,1735808909,-21600,iPhone
tv.danmaku.bilianime,16,1735808562,1735808578,1735808579,-21600,iPhone
com.tencent.xin,5,1735808557,1735808562,1735808563,-21600,iPhone
com.tencent.xin,47,1735808507,1735808554,1735808555,-21600,iPhone
tv.danmaku.bilianime,2,1735808504,1735808506,1735808507,-21600,iPhone
tv.danmaku.bilianime,10,1735808402,1735808412,1735808413,-21600,iPhone
tv.danmaku.bilianime,10,1735808391,1735808401,1735808402,-21600,iPhone
tv.danmaku.bilianime,54,1735808304,1735808358,1735808359,-21600,iPhone
com.microsoft.Office.Outlook,6,1735808298,1735808304,1735808304,-21600,iPhone
tv.danmaku.bilianime,4,1735808294,1735808298,1735808299,-21600,iPhone
tv.danmaku.bilianime,102,1735807292,1735807394,1735807395,-21600,iPhone
tv.danmaku.bilianime,2,1735806798,1735806800,1735806800,-21600,iPhone
tv.danmaku.bilianime,34,1735806762,1735806796,1735806796,-21600,iPhone
tv.danmaku.bilianime,105,1735806370,1735806475,1735806475,-21600,iPhone
tv.danmaku.bilianime,59,1735805912,1735805971,1735805972,-21600,iPhone
com.microsoft.Office.Outlook,6,1735805906,1735805912,1735805913,-21600,iPhone
tv.danmaku.bilianime,4,1735805902,1735805906,1735805907,-21600,iPhone
tv.danmaku.bilianime,10,1735805634,1735805644,1735805645,-21600,iPhone
tv.danmaku.bilianime,81,1735805456,1735805537,1735805537,-21600,iPhone
com.microsoft.Office.Outlook,2,1735805454,1735805456,1735805457,-21600,iPhone
com.microsoft.Office.Outlook,38,1735805403,1735805441,1735805442,-21600,iPhone
tv.danmaku.bilianime,1,1735805402,1735805403,1735805404,-21600,iPhone
com.microsoft.Office.Outlook,3,1735805399,1735805402,1735805403,-21600,iPhone
com.microsoft.Office.Outlook,10,1735805345,1735805355,1735805356,-21600,iPhone
tv.danmaku.bilianime,50,1735805295,1735805345,1735805346,-21600,iPhone
tv.danmaku.bilianime,95,1735804067,1735804162,1735804163,-21600,iPhone
tv.danmaku.bilianime,95,1735803666,1735803761,1735803762,-21600,iPhone
tv.danmaku.bilianime,42,1735803461,1735803503,1735803504,-21600,iPhone
tv.danmaku.bilianime,6,1735803150,1735803156,1735803156,-21600,iPhone
tv.danmaku.bilianime,50,1735803098,1735803148,1735803149,-21600,iPhone
tv.danmaku.bilianime,79,1735802624,1735802703,1735802703,-21600,iPhone
com.xingin.discover,15,1735802609,1735802624,1735802625,-21600,iPhone
com.xingin.discover,20,1735802213,1735802233,1735802234,-21600,iPhone
com.xingin.discover,100,1735802102,1735802202,1735802202,-21600,iPhone
tv.danmaku.bilianime,4,1735802097,1735802101,1735802101,-21600,iPhone
tv.danmaku.bilianime,13,1735801692,1735801705,1735801706,-21600,iPhone
tv.danmaku.bilianime,107,1735800932,1735801039,1735801039,-21600,iPhone
tv.danmaku.bilianime,350,1735800582,1735800932,1735800933,-21600,iPhone
com.xingin.discover,92,1735800489,1735800581,1735800581,-21600,iPhone
com.tencent.xin,2,1735800484,1735800486,1735800487,-21600,iPhone
com.tencent.xin,1,1735799809,1735799810,1735799811,-21600,iPhone
com.tencent.xin,8,1735799376,1735799384,1735799384,-21600,iPhone
com.google.Chrome,3,1735799369,1735799372,1735799373,-21600,MacBook
com.tencent.xin,2,1735799366,1735799368,1735799369,-21600,iPhone
com.tencent.xin,6,1735799110,1735799116,1735799117,-21600,iPhone
com.tencent.xin,29,1735798615,1735798644,1735798645,-21600,iPhone
com.microsoft.Office.Outlook,5,1735798610,1735798615,1735798617,-21600,iPhone
com.google.Chrome,571,1735797658,1735798229,1735798229,-21600,MacBook
com.google.Chrome,382,1735796743,1735797125,1735797125,-21600,MacBook
com.google.Chrome,352,1735796086,1735796438,1735796438,-21600,MacBook
com.google.Chrome,313,1735795629,1735795942,1735795942,-21600,MacBook
com.google.Chrome,455,1735794899,1735795354,1735795355,-21600,MacBook
com.microsoft.Office.Outlook,16,1735794883,1735794899,1735794900,-21600,iPhone
com.apple.camera,3,1735794887,1735794890,1735794890,-21600,iPhone
com.google.Chrome,358,1735794075,1735794433,1735794433,-21600,MacBook
com.microsoft.Office.Outlook,2,1735794108,1735794110,1735794111,-21600,iPhone
com.microsoft.Office.Outlook,131,1735793946,1735794077,1735794078,-21600,iPhone
com.apple.finder,10,1735794065,1735794075,1735794075,-21600,MacBook
com.google.Chrome,4,1735794061,1735794065,1735794066,-21600,MacBook
com.apple.finder,1,1735794060,1735794061,1735794061,-21600,MacBook
com.tencent.xinWeChat,2,1735794058,1735794060,1735794060,-21600,MacBook
com.google.Chrome,21,1735794037,1735794058,1735794059,-21600,MacBook
com.tencent.xinWeChat,10,1735794027,1735794037,1735794038,-21600,MacBook
com.google.Chrome,4,1735794023,1735794027,1735794028,-21600,MacBook
com.tencent.xinWeChat,113,1735793910,1735794023,1735794023,-21600,MacBook
com.southwest.iphoneprod,23,1735793922,1735793945,1735793946,-21600,iPhone
com.tencent.xin,6,1735793916,1735793922,1735793923,-21600,iPhone
com.southwest.iphoneprod,1022,1735792894,1735793916,1735793916,-21600,iPhone
com.google.Chrome,3,1735793907,1735793910,1735793910,-21600,MacBook
com.tencent.xinWeChat,14,1735793893,1735793907,1735793908,-21600,MacBook
com.google.Chrome,1,1735793892,1735793893,1735793894,-21600,MacBook
com.tencent.xinWeChat,11,1735793881,1735793892,1735793892,-21600,MacBook
com.google.Chrome,88,1735793793,1735793881,1735793882,-21600,MacBook
com.tencent.xinWeChat,14,1735793313,1735793327,1735793328,-21600,MacBook
com.google.Chrome,44,1735793269,1735793313,1735793314,-21600,MacBook
com.tencent.xin,11,1735792883,1735792894,1735792895,-21600,iPhone
com.southwest.iphoneprod,42,1735792840,1735792882,1735792882,-21600,iPhone
com.apple.PassbookUIService,9,1735792843,1735792852,1735792853,-21600,iPhone
com.chase,130,1735792710,1735792840,1735792840,-21600,iPhone
com.tencent.xinWeChat,5,1735792742,1735792747,1735792748,-21600,MacBook
com.google.Chrome,11,1735792731,1735792742,1735792742,-21600,MacBook
com.apple.CoreAuthUI,1,1735792714,1735792715,1735792716,-21600,iPhone
com.southwest.iphoneprod,378,1735792332,1735792710,1735792710,-21600,iPhone
com.apple.PassbookUIService,20,1735792687,1735792707,1735792708,-21600,iPhone
com.tencent.xinWeChat,17,1735792619,1735792636,1735792637,-21600,MacBook
com.apple.finder,0,1735792619,1735792619,1735792620,-21600,MacBook
com.google.Chrome,10,1735792609,1735792619,1735792620,-21600,MacBook
com.tencent.xin,62,1735792270,1735792332,1735792333,-21600,iPhone
com.tencent.xinWeChat,38,1735792273,1735792311,1735792312,-21600,MacBook
com.apple.finder,1,1735792272,1735792273,1735792273,-21600,MacBook
com.tencent.xinWeChat,26,1735792246,1735792272,1735792273,-21600,MacBook
com.southwest.iphoneprod,123,1735792147,1735792270,1735792270,-21600,iPhone
com.tencent.xin,23,1735792124,1735792147,1735792147,-21600,iPhone
com.southwest.iphoneprod,41,1735792083,1735792124,1735792125,-21600,iPhone
com.southwest.iphoneprod,14,1735792065,1735792079,1735792080,-21600,iPhone
com.tencent.xin,10,1735792055,1735792065,1735792065,-21600,iPhone
com.southwest.iphoneprod,4,1735792051,1735792055,1735792055,-21600,iPhone
com.tencent.xin,12,1735792039,1735792051,1735792052,-21600,iPhone
com.southwest.iphoneprod,286,1735791751,1735792037,1735792038,-21600,iPhone
com.google.Chrome,14,1735791952,1735791966,1735791967,-21600,MacBook
com.tencent.xinWeChat,41,1735791911,1735791952,1735791952,-21600,MacBook
com.apple.CoreAuthUI,2,1735791915,1735791917,1735791917,-21600,iPhone
com.google.Chrome,1,1735791752,1735791753,1735791754,-21600,MacBook
com.discoverfinancial.mobile,27,1735791724,1735791751,1735791751,-21600,iPhone
com.southwest.iphoneprod,86,1735791638,1735791724,1735791726,-21600,iPhone
com.tencent.xin,6,1735791629,1735791635,1735791636,-21600,iPhone
com.tencent.xin,15,1735791610,1735791625,1735791626,-21600,iPhone
com.tencent.xin,55,1735791550,1735791605,1735791606,-21600,iPhone
com.apple.Preferences,18,1735791532,1735791550,1735791551,-21600,iPhone
com.apple.Preferences,2,1735791529,1735791531,1735791531,-21600,iPhone
com.tencent.xin,11,1735791517,1735791528,1735791529,-21600,iPhone
com.discoverfinancial.mobile,45,1735791471,1735791516,1735791517,-21600,iPhone
com.apple.CoreAuthUI,12,1735791479,1735791491,1735791491,-21600,iPhone
com.tencent.xin,9,1735791462,1735791471,1735791471,-21600,iPhone
com.tencent.xinWeChat,26,1735791434,1735791460,1735791461,-21600,MacBook
com.google.Chrome,37,1735791397,1735791434,1735791434,-21600,MacBook
com.apple.finder,1,1735791396,1735791397,1735791397,-21600,MacBook
com.tencent.xinWeChat,2,1735791394,1735791396,1735791396,-21600,MacBook
com.apple.finder,2,1735791392,1735791394,1735791395,-21600,MacBook
com.tencent.xinWeChat,2,1735791390,1735791392,1735791392,-21600,MacBook
com.google.Chrome,17,1735791373,1735791390,1735791391,-21600,MacBook
com.tencent.xinWeChat,2,1735791371,1735791373,1735791373,-21600,MacBook
com.google.Chrome,20,1735791351,1735791371,1735791371,-21600,MacBook
com.tencent.xinWeChat,29,1735791322,1735791351,1735791352,-21600,MacBook
com.google.Chrome,7,1735791315,1735791322,1735791322,-21600,MacBook
com.tencent.xinWeChat,4,1735791311,1735791315,1735791315,-21600,MacBook
com.tencent.xin,335,1735790977,1735791312,1735791313,-21600,iPhone
com.google.Chrome,4,1735791307,1735791311,1735791311,-21600,MacBook
com.tencent.xinWeChat,25,1735791282,1735791307,1735791308,-21600,MacBook
com.google.Chrome,13,1735791269,1735791282,1735791282,-21600,MacBook
com.tencent.xinWeChat,33,1735791236,1735791269,1735791270,-21600,MacBook
com.google.Chrome,27,1735791209,1735791236,1735791237,-21600,MacBook
com.tencent.xinWeChat,2,1735791207,1735791209,1735791209,-21600,MacBook
com.google.Chrome,2,1735791205,1735791207,1735791208,-21600,MacBook
com.tencent.xinWeChat,7,1735791198,1735791205,1735791206,-21600,MacBook
com.google.Chrome,13,1735791185,1735791198,1735791198,-21600,MacBook
com.tencent.xinWeChat,4,1735791181,1735791185,1735791186,-21600,MacBook
com.google.Chrome,18,1735791163,1735791181,1735791182,-21600,MacBook
com.apple.finder,2,1735791161,1735791163,1735791163,-21600,MacBook
com.tencent.xinWeChat,0,1735791161,1735791161,1735791162,-21600,MacBook
com.apple.finder,2,1735791159,1735791161,1735791161,-21600,MacBook
com.tencent.xinWeChat,0,1735791159,1735791159,1735791160,-21600,MacBook
com.google.Chrome,28,1735791131,1735791159,1735791159,-21600,MacBook
com.tencent.xinWeChat,2,1735791129,1735791131,1735791131,-21600,MacBook
com.apple.finder,1,1735791128,1735791129,1735791129,-21600,MacBook
com.tencent.xinWeChat,7,1735791121,1735791128,1735791129,-21600,MacBook
com.google.Chrome,13,1735791108,1735791121,1735791122,-21600,MacBook
com.tencent.xinWeChat,1,1735791107,1735791108,1735791109,-21600,MacBook
com.google.Chrome,1,1735791106,1735791107,1735791108,-21600,MacBook
com.tencent.xinWeChat,24,1735791082,1735791106,1735791107,-21600,MacBook
com.apple.finder,1,1735791081,1735791082,1735791083,-21600,MacBook
com.tencent.xinWeChat,1,1735791080,1735791081,1735791082,-21600,MacBook
com.google.Chrome,1,1735791079,1735791080,1735791080,-21600,MacBook
com.apple.finder,1,1735791078,1735791079,1735791079,-21600,MacBook
com.tencent.xinWeChat,1,1735791077,1735791078,1735791078,-21600,MacBook
com.apple.finder,1,1735791076,1735791077,1735791078,-21600,MacBook
com.tencent.xinWeChat,47,1735791029,1735791076,1735791077,-21600,MacBook
com.google.Chrome,16,1735791013,1735791029,1735791029,-21600,MacBook
com.tencent.xinWeChat,29,1735790984,1735791013,1735791014,-21600,MacBook
com.google.Chrome,49,1735790935,1735790984,1735790984,-21600,MacBook
tv.danmaku.bilianime,2,1735790975,1735790977,1735790977,-21600,iPhone
com.tencent.xinWeChat,0,1735790935,1735790935,1735790936,-21600,MacBook
com.apple.finder,5,1735790930,1735790935,1735790936,-21600,MacBook
com.google.Chrome,126,1735790804,1735790930,1735790931,-21600,MacBook
com.apple.finder,2,1735790802,1735790804,1735790805,-21600,MacBook
tv.danmaku.bilianime,2,1735790528,1735790530,1735790531,-21600,iPhone
com.tencent.xin,3,1735790525,1735790528,1735790528,-21600,iPhone
tv.danmaku.bilianime,7,1735790515,1735790522,1735790523,-21600,iPhone
com.xingin.discover,308,1735790205,1735790513,1735790514,-21600,iPhone
com.xingin.discover,13,1735790180,1735790193,1735790194,-21600,iPhone
com.xingin.discover,132,1735790013,1735790145,1735790146,-21600,iPhone
com.xingin.discover,128,1735789852,1735789980,1735789981,-21600,iPhone
com.xingin.discover,33,1735789783,1735789816,1735789817,-21600,iPhone
com.xingin.discover,41,1735789635,1735789676,1735789676,-21600,iPhone
com.xingin.discover,16,1735788767,1735788783,1735788784,-21600,iPhone
com.xingin.discover,2,1735788511,1735788513,1735788513,-21600,iPhone
com.xingin.discover,371,1735788135,1735788506,1735788506,-21600,iPhone
com.tencent.xin,14,1735788118,1735788132,1735788133,-21600,iPhone
com.tencent.xin,21,1735787655,1735787676,1735787677,-21600,iPhone
com.tencent.xin,3,1735787652,1735787655,1735787655,-21600,iPhone
com.xingin.discover,7,1735787643,1735787650,1735787651,-21600,iPhone
com.xingin.discover,1,1735785282,1735785283,1735785283,-21600,iPhone
com.xingin.discover,63,1735785109,1735785172,1735785173,-21600,iPhone
com.xingin.discover,43,1735783403,1735783446,1735783446,-21600,iPhone
com.xingin.discover,945,1735780930,1735781875,1735781876,-21600,iPhone
com.openai.chat,1,1735780929,1735780930,1735780931,-21600,iPhone
com.xingin.discover,14,1735780914,1735780928,1735780928,-21600,iPhone
com.xingin.discover,728,1735780015,1735780743,1735780744,-21600,iPhone
com.ubercab.UberEats,291,1735779724,1735780015,1735780015,-21600,iPhone
com.xingin.discover,60,1735779664,1735779724,1735779724,-21600,iPhone
com.ubercab.UberEats,0,1735779664,1735779664,1735779665,-21600,iPhone
com.xingin.discover,1908,1735777755,1735779663,1735779663,-21600,iPhone
com.apple.calculator,4,1735777751,1735777755,1735777756,-21600,iPhone
com.xingin.discover,27,1735777724,1735777751,1735777751,-21600,iPhone
com.xingin.discover,34,1735777690,1735777724,1735777724,-21600,iPhone
com.apple.PassbookUIService,13,1735777554,1735777567,1735777568,-21600,iPhone
com.xingin.discover,67,1735777500,1735777567,1735777568,-21600,iPhone
com.xingin.discover,51,1735775521,1735775572,1735775572,-21600,iPhone
com.xingin.discover,0,1735775520,1735775520,1735775521,-21600,iPhone
com.apple.mobiletimer,6,1735775228,1735775234,1735775235,-21600,iPhone
com.xingin.discover,14,1735775220,1735775234,1735775235,-21600,iPhone
com.xingin.discover,21,1735774969,1735774990,1735774991,-21600,iPhone
com.xingin.discover,327,1735774555,1735774882,1735774883,-21600,iPhone
com.microsoft.Office.Outlook,9,1735774004,1735774013,1735774013,-21600,iPhone
com.xingin.discover,37,1735773965,1735774002,1735774003,-21600,iPhone
com.apple.mobiletimer,1,1735773964,1735773965,1735773965,-21600,iPhone
com.xingin.discover,2758,1735771206,1735773964,1735773964,-21600,iPhone
com.apple.mobiletimer,4,1735771202,1735771206,1735771206,-21600,iPhone
com.xingin.discover,4273,1735766929,1735771202,1735771202,-21600,iPhone
com.xingin.discover,5,1735766913,1735766918,1735766918,-21600,iPhone
com.xingin.discover,2,1735766910,1735766912,1735766913,-21600,iPhone
com.xingin.discover,59,1735766724,1735766783,1735766784,-21600,iPhone
com.tencent.xin,2,1735766722,1735766724,1735766724,-21600,iPhone
com.microsoft.Office.Outlook,39,1735766683,1735766722,1735766723,-21600,iPhone
com.tencent.xin,5,1735766677,1735766682,1735766683,-21600,iPhone
com.tencent.xin,1,1735766663,1735766664,1735766665,-21600,iPhone
com.tencent.xin,31,1735766526,1735766557,1735766558,-21600,iPhone
com.apple.MobileSMS,1,1735766522,1735766523,1735766524,-21600,iPhone
com.xingin.discover,641,1735738827,1735739468,1735739469,-21600,iPhone
com.google.chrome.ios,2,1735738824,1735738826,1735738826,-21600,iPhone
com.apple.mobiletimer,7,1735738816,1735738823,1735738823,-21600,iPhone
com.apple.mobiletimer,2,1735738414,1735738416,1735738416,-21600,iPhone
com.apple.mobiletimer,8,1735737518,1735737526,1735737526,-21600,iPhone
com.xingin.discover,2,1735737514,1735737516,1735737516,-21600,iPhone
com.xingin.discover,201,1735732984,1735733185,1735733186,-21600,iPhone
com.xingin.discover,2,1735731962,1735731964,1735731964,-21600,iPhone
com.xingin.discover,1,1735730500,1735730501,1735730502,-21600,iPhone
com.xingin.discover,233,1735728031,1735728264,1735728265,-21600,iPhone
com.xingin.discover,38,1735727992,1735728030,1735728031,-21600,iPhone
com.xingin.discover,144,1735727847,1735727991,1735727991,-21600,iPhone
com.bilibili.bilicomic,25,1735726315,1735726340,1735726340,-21600,iPhone
com.apple.mobiletimer,3,1735726309,1735726312,1735726313,-21600,iPhone
com.apple.mobiletimer,1,1735726307,1735726308,1735726309,-21600,iPhone
com.tencent.xin,7,1735726300,1735726307,1735726307,-21600,iPhone
com.google.calendar,3,1735725778,1735725781,1735725782,-21600,iPhone
com.google.calendar,7,1735725204,1735725211,1735725212,-21600,iPhone
com.apple.mobiletimer,6,1735725198,1735725204,1735725204,-21600,iPhone
com.tencent.xin,5,1735725190,1735725195,1735725196,-21600,iPhone
com.tencent.xin,16,1735725123,1735725139,1735725140,-21600,iPhone
com.tencent.xin,10,1735725104,1735725114,1735725114,-21600,iPhone
com.tencent.xin,14,1735725087,1735725101,1735725101,-21600,iPhone
com.tencent.xin,4,1735725081,1735725085,1735725086,-21600,iPhone
com.tencent.xin,11,1735725070,1735725081,1735725081,-21600,iPhone
com.tencent.xin,4,1735725058,1735725062,1735725063,-21600,iPhone
com.tencent.xin,6,1735725050,1735725056,1735725057,-21600,iPhone
com.tencent.xin,30,1735725011,1735725041,1735725042,-21600,iPhone
com.tencent.xin,1079,1735723918,1735724997,1735724998,-21600,iPhone
com.tencent.xin,50,1735723864,1735723914,1735723915,-21600,iPhone
com.tencent.xin,146,1735723716,1735723862,1735723863,-21600,iPhone
com.tencent.xin,8,1735723704,1735723712,1735723713,-21600,iPhone
com.tencent.xin,31,1735723672,1735723703,1735723704,-21600,iPhone
com.apple.weather,11,1735723661,1735723672,1735723673,-21600,iPhone
com.tencent.xin,5,1735723653,1735723658,1735723659,-21600,iPhone
com.tencent.xin,12,1735723639,1735723651,1735723652,-21600,iPhone
com.xingin.discover,720,1735722918,1735723638,1735723638,-21600,iPhone
com.tencent.xin,60,1735722858,1735722918,1735722918,-21600,iPhone
com.xingin.discover,85,1735722773,1735722858,1735722859,-21600,iPhone
com.tencent.xin,719,1735722054,1735722773,1735722773,-21600,iPhone
com.tencent.xin,1133,1735720921,1735722054,1735722055,-21600,iPhone
com.xingin.discover,13,1735720908,1735720921,1735720921,-21600,iPhone
com.tencent.xin,4,1735720904,1735720908,1735720909,-21600,iPhone
com.xingin.discover,6,1735720898,1735720904,1735720904,-21600,iPhone
com.tencent.xin,6,1735720892,1735720898,1735720899,-21600,iPhone
com.bilibili.bilicomic,1,1735720891,1735720892,1735720893,-21600,iPhone
com.xingin.discover,17,1735720874,1735720891,1735720892,-21600,iPhone
com.tencent.xin,201,1735720673,1735720874,1735720875,-21600,iPhone
com.xingin.discover,10,1735720663,1735720673,1735720674,-21600,iPhone
com.bilibili.bilicomic,1,1735720662,1735720663,1735720664,-21600,iPhone
com.xingin.discover,2,1735720660,1735720662,1735720662,-21600,iPhone
com.tencent.xin,4,1735720655,1735720659,1735720659,-21600,iPhone
com.tencent.xin,7,1735720643,1735720650,1735720651,-21600,iPhone
com.google.chrome.ios,10,1735720633,1735720643,1735720644,-21600,iPhone
com.tencent.xin,61,1735720572,1735720633,1735720634,-21600,iPhone
com.apple.mobiletimer,2,1735720322,1735720324,1735720324,-21600,iPhone
com.apple.CoreAuthUI,2,1735720315,1735720317,1735720318,-21600,iPhone
com.tencent.xin,141,1735720167,1735720308,1735720309,-21600,iPhone
com.google.chrome.ios,12,1735720155,1735720167,1735720168,-21600,iPhone
com.tencent.xin,22,1735720132,1735720154,1735720155,-21600,iPhone
com.tencent.xin,116,1735720002,1735720118,1735720119,-21600,iPhone
com.apple.finder,12,1735719987,1735719999,1735719999,-21600,MacBook
com.valvesoftware.steam,1,1735719986,1735719987,1735719988,-21600,MacBook
com.apple.finder,3,1735719953,1735719956,1735719956,-21600,MacBook
com.valvesoftware.steam,44,1735719909,1735719953,1735719953,-21600,MacBook
com.google.Chrome,75,1735719770,1735719845,1735719845,-21600,MacBook
com.tencent.xin,13,1735718182,1735718195,1735718196,-21600,iPhone
com.valvesoftware.steam,18,1735716846,1735716864,1735716864,-21600,MacBook
com.google.Chrome,7,1735716839,1735716846,1735716846,-21600,MacBook
com.valvesoftware.steam,9,1735716830,1735716839,1735716840,-21600,MacBook
com.google.Chrome,55,1735716775,1735716830,1735716831,-21600,MacBook
com.valvesoftware.steam,52,1735716723,1735716775,1735716776,-21600,MacBook
com.apple.systempreferences,4,1735716719,1735716723,1735716724,-21600,MacBook
com.valvesoftware.steam,3,1735716716,1735716719,1735716720,-21600,MacBook
com.google.Chrome,74,1735716642,1735716716,1735716717,-21600,MacBook
com.valvesoftware.steam,2,1735716640,1735716642,1735716642,-21600,MacBook
com.google.Chrome,3,1735716637,1735716640,1735716640,-21600,MacBook
com.valvesoftware.steam,17,1735716620,1735716637,1735716637,-21600,MacBook
com.apple.finder,0,1735716620,1735716620,1735716621,-21600,MacBook
com.valvesoftware.steam,30,1735716590,1735716620,1735716620,-21600,MacBook
com.apple.finder,1,1735716589,1735716590,1735716591,-21600,MacBook
com.valvesoftware.steam,10,1735716518,1735716528,1735716528,-21600,MacBook
com.apple.finder,1,1735716517,1735716518,1735716519,-21600,MacBook
com.valvesoftware.steam,1,1735716516,1735716517,1735716518,-21600,MacBook
com.apple.finder,1,1735716515,1735716516,1735716516,-21600,MacBook
com.valvesoftware.steam,0,1735716515,1735716515,1735716516,-21600,MacBook
com.apple.finder,2,1735716513,1735716515,1735716515,-21600,MacBook
com.valvesoftware.steam,6,1735716507,1735716513,1735716514,-21600,MacBook
com.apple.finder,0,1735716507,1735716507,1735716508,-21600,MacBook
com.valvesoftware.steam,4,1735716503,1735716507,1735716507,-21600,MacBook
com.apple.finder,1,1735716502,1735716503,1735716504,-21600,MacBook
com.valvesoftware.steam,3,1735716499,1735716502,1735716503,-21600,MacBook
com.apple.finder,1,1735716498,1735716499,1735716499,-21600,MacBook
com.valvesoftware.steam,8,1735716490,1735716498,1735716498,-21600,MacBook
com.apple.finder,1,1735716489,1735716490,1735716490,-21600,MacBook
com.valvesoftware.steam,1,1735716488,1735716489,1735716489,-21600,MacBook
com.apple.finder,0,1735716488,1735716488,1735716489,-21600,MacBook
com.valvesoftware.steam,2,1735716486,1735716488,1735716488,-21600,MacBook
com.apple.finder,1,1735716372,1735716373,1735716373,-21600,MacBook
com.valvesoftware.steam,3,1735716369,1735716372,1735716373,-21600,MacBook
com.apple.finder,1,1735716368,1735716369,1735716369,-21600,MacBook
com.valvesoftware.steam,3,1735716365,1735716368,1735716369,-21600,MacBook
com.apple.finder,1,1735716364,1735716365,1735716365,-21600,MacBook
com.valvesoftware.steam,5,1735716359,1735716364,1735716364,-21600,MacBook
com.tencent.xin,6,1735716228,1735716234,1735716235,-21600,iPhone
com.tencent.xin,23,1735716193,1735716216,1735716217,-21600,iPhone
com.tencent.xin,1,1735716192,1735716193,1735716194,-21600,iPhone
com.tencent.xin,3,1735716187,1735716190,1735716190,-21600,iPhone
com.google.calendar,10,1735716173,1735716183,1735716184,-21600,iPhone
com.apple.finder,0,1735716062,1735716062,1735716063,-21600,MacBook
com.valvesoftware.steam,1,1735716061,1735716062,1735716062,-21600,MacBook
com.apple.finder,1,1735716060,1735716061,1735716062,-21600,MacBook
com.valvesoftware.steam,26,1735716034,1735716060,1735716060,-21600,MacBook
com.adobe.acc.AdobeCreativeCloud,5,1735715728,1735715733,1735715733,-21600,MacBook
com.valvesoftware.steam,16,1735715712,1735715728,1735715729,-21600,MacBook
com.tencent.xin,10,1735715223,1735715233,1735715234,-21600,iPhone
com.chase,4,1735715219,1735715223,1735715224,-21600,iPhone
com.apple.finder,10,1735715180,1735715190,1735715190,-21600,MacBook
com.chase,52,1735715130,1735715182,1735715183,-21600,iPhone
com.apple.systempreferences,3,1735715177,1735715180,1735715181,-21600,MacBook
com.valvesoftware.steam,20,1735715157,1735715177,1735715177,-21600,MacBook
unity.Team17.Overcooked2,962,1735714195,1735715157,1735715157,-21600,MacBook
com.apple.CoreAuthUI,2,1735715133,1735715135,1735715135,-21600,iPhone
com.microsoft.Office.Outlook,4,1735715126,1735715130,1735715131,-21600,iPhone
com.microsoft.Office.Outlook,2,1735715124,1735715126,1735715127,-21600,iPhone
com.chase,2,1735715122,1735715124,1735715124,-21600,iPhone
com.microsoft.Office.Outlook,3,1735715118,1735715121,1735715121,-21600,iPhone
com.microsoft.Office.Outlook,2,1735715116,1735715118,1735715118,-21600,iPhone
com.xingin.discover,6,1735715110,1735715116,1735715117,-21600,iPhone
com.xingin.discover,4,1735714862,1735714866,1735714867,-21600,iPhone
com.tencent.xin,17,1735714844,1735714861,1735714862,-21600,iPhone
com.tencent.xin,22,1735714583,1735714605,1735714605,-21600,iPhone
com.tencent.xin,6,1735714199,1735714205,1735714205,-21600,iPhone
com.valvesoftware.steam,4,1735714191,1735714195,1735714195,-21600,MacBook
unity.Team17.Overcooked2,51,1735714140,1735714191,1735714192,-21600,MacBook
com.tencent.xin,3,1735714125,1735714128,1735714129,-21600,iPhone
com.tencent.xin,19,1735714060,1735714079,1735714079,-21600,iPhone
com.apple.PassbookUIService,2,1735714064,1735714066,1735714067,-21600,iPhone
com.tencent.xin,5,1735714054,1735714059,1735714060,-21600,iPhone
com.tencent.xin,11,1735713761,1735713772,1735713772,-21600,iPhone
com.apple.PassbookUIService,9,1735713763,1735713772,1735713772,-21600,iPhone
com.tencent.xin,26,1735712305,1735712331,1735712332,-21600,iPhone
com.tencent.xin,1,1735712301,1735712302,1735712303,-21600,iPhone
com.tencent.xin,2,1735711000,1735711002,1735711003,-21600,iPhone
com.valvesoftware.steam,6,1735710979,1735710985,1735710985,-21600,MacBook
unity.Team17.Overcooked2,709,1735710270,1735710979,1735710980,-21600,MacBook
com.xingin.discover,169,1735710080,1735710249,1735710250,-21600,iPhone
com.xingin.discover,16,1735710056,1735710072,1735710072,-21600,iPhone
com.valvesoftware.steam,2,1735706224,1735706226,1735706227,-21600,MacBook
unity.Team17.Overcooked2,9,1735706215,1735706224,1735706225,-21600,MacBook
com.valvesoftware.steam,3,1735706212,1735706215,1735706215,-21600,MacBook
unity.Team17.Overcooked2,2,1735706210,1735706212,1735706212,-21600,MacBook
com.valvesoftware.steam,2,1735706208,1735706210,1735706211,-21600,MacBook
unity.Team17.Overcooked2,96,1735706112,1735706208,1735706209,-21600,MacBook
com.valvesoftware.steam,22,1735706090,1735706112,1735706112,-21600,MacBook
unity.Team17.Overcooked2,4,1735706086,1735706090,1735706090,-21600,MacBook
com.valvesoftware.steam,4,1735706082,1735706086,1735706087,-21600,MacBook
unity.Team17.Overcooked2,1,1735706081,1735706082,1735706083,-21600,MacBook
com.valvesoftware.steam,2,1735706079,1735706081,1735706082,-21600,MacBook
unity.Team17.Overcooked2,1401,1735704678,1735706079,1735706080,-21600,MacBook
com.valvesoftware.steam,18,1735704660,1735704678,1735704678,-21600,MacBook
unity.Team17.Overcooked2,65,1735704595,1735704660,1735704660,-21600,MacBook
com.valvesoftware.steam,15,1735704580,1735704595,1735704596,-21600,MacBook
unity.Team17.Overcooked2,721,1735703859,1735704580,1735704581,-21600,MacBook
com.xingin.discover,28,1735704539,1735704567,1735704567,-21600,iPhone
com.xingin.discover,2,1735704536,1735704538,1735704539,-21600,iPhone
com.apple.Chess,16,1735703843,1735703859,1735703860,-21600,MacBook
unity.Team17.Overcooked2,44,1735703799,1735703843,1735703844,-21600,MacBook
com.valvesoftware.steam,6,1735703793,1735703799,1735703799,-21600,MacBook
unity.Team17.Overcooked2,8,1735703785,1735703793,1735703793,-21600,MacBook
com.xingin.discover,1,1735703787,1735703788,1735703789,-21600,iPhone
com.xingin.discover,1,1735703672,1735703673,1735703673,-21600,iPhone
com.xingin.discover,2,1735703386,1735703388,1735703388,-21600,iPhone
com.xingin.discover,5,1735702583,1735702588,1735702589,-21600,iPhone
com.xingin.discover,125,1735702028,1735702153,1735702154,-21600,iPhone
com.xingin.discover,69,1735701959,1735702028,1735702029,-21600,iPhone
com.valvesoftware.steam,11,1735702007,1735702018,1735702018,-21600,MacBook
unity.Team17.Overcooked2,63,1735701944,1735702007,1735702008,-21600,MacBook
com.xingin.discover,107,1735701846,1735701953,1735701954,-21600,iPhone
com.valvesoftware.steam,47,1735701897,1735701944,1735701945,-21600,MacBook
unity.Team17.Overcooked2,66,1735701831,1735701897,1735701898,-21600,MacBook
com.tencent.xin,10,1735701836,1735701846,1735701847,-21600,iPhone
com.microsoft.Office.Outlook,5,1735701831,1735701836,1735701836,-21600,iPhone
com.valvesoftware.steam,26,1735701805,1735701831,1735701831,-21600,MacBook
unity.Team17.Overcooked2,66,1735701739,1735701805,1735701806,-21600,MacBook
com.microsoft.Office.Outlook,10,1735701746,1735701756,1735701756,-21600,iPhone
com.xingin.discover,25,1735701720,1735701745,1735701746,-21600,iPhone
com.valvesoftware.steam,6,1735701733,1735701739,1735701740,-21600,MacBook
unity.Team17.Overcooked2,4,1735701729,1735701733,1735701734,-21600,MacBook
com.valvesoftware.steam,31,1735701698,1735701729,1735701730,-21600,MacBook
com.tencent.xin,7,1735701713,1735701720,1735701721,-21600,iPhone
com.xingin.discover,26,1735701687,1735701713,1735701713,-21600,iPhone
unity.Team17.Overcooked2,169,1735701529,1735701698,1735701699,-21600,MacBook
com.tencent.xin,14,1735701673,1735701687,1735701688,-21600,iPhone
com.xingin.discover,10,1735701606,1735701616,1735701616,-21600,iPhone
com.xingin.discover,64,1735701530,1735701594,1735701595,-21600,iPhone
com.valvesoftware.steam,11,1735701518,1735701529,1735701530,-21600,MacBook
com.apple.finder,3,1735701510,1735701513,1735701513,-21600,MacBook
com.valvesoftware.steam,21,1735701489,1735701510,1735701511,-21600,MacBook
unity.Team17.Overcooked2,3,1735701485,1735701488,1735701489,-21600,MacBook
com.xingin.discover,48,1735701438,1735701486,1735701487,-21600,iPhone
com.valvesoftware.steam,11,1735701474,1735701485,1735701486,-21600,MacBook
unity.Team17.Overcooked2,45,1735701429,1735701474,1735701474,-21600,MacBook
com.openai.chat,2,1735701435,1735701437,1735701437,-21600,iPhone
com.valvesoftware.steam,10,1735701419,1735701429,1735701430,-21600,MacBook
unity.Team17.Overcooked2,2,1735701417,1735701419,1735701420,-21600,MacBook
com.valvesoftware.steam,1,1735701416,1735701417,1735701418,-21600,MacBook
unity.Team17.Overcooked2,1,1735701415,1735701416,1735701417,-21600,MacBook
com.valvesoftware.steam,6,1735701409,1735701415,1735701416,-21600,MacBook
unity.Team17.Overcooked2,34,1735701375,1735701409,1735701410,-21600,MacBook
com.valvesoftware.steam,23,1735701352,1735701375,1735701375,-21600,MacBook
com.apple.systempreferences,1,1735701351,1735701352,1735701353,-21600,MacBook
unity.Team17.Overcooked2,6,1735701345,1735701351,1735701351,-21600,MacBook
com.apple.systempreferences,3,1735701342,1735701345,1735701346,-21600,MacBook
com.openai.chat,6,1735701336,1735701342,1735701343,-21600,iPhone
unity.Team17.Overcooked2,7,1735701335,1735701342,1735701343,-21600,MacBook
com.apple.systempreferences,21,1735701314,1735701335,1735701335,-21600,MacBook
com.openai.chat,8,1735701323,1735701331,1735701331,-21600,iPhone
unity.Team17.Overcooked2,309,1735701005,1735701314,1735701315,-21600,MacBook
com.apple.systempreferences,5,1735701000,1735701005,1735701006,-21600,MacBook
com.apple.finder,5,1735700981,1735700986,1735700987,-21600,MacBook
unity.Team17.Overcooked2,2,1735700979,1735700981,1735700982,-21600,MacBook
com.apple.finder,9,1735700512,1735700521,1735700521,-21600,MacBook
unity.Team17.Overcooked2,13,1735700499,1735700512,1735700513,-21600,MacBook
com.openai.chat,42,1735700408,1735700450,1735700450,-21600,iPhone
com.valvesoftware.steam,4,1735700402,1735700406,1735700407,-21600,MacBook
com.apple.finder,5,1735700397,1735700402,1735700403,-21600,MacBook
com.valvesoftware.steam,2,1735700395,1735700397,1735700398,-21600,MacBook
com.apple.finder,1,1735700394,1735700395,1735700397,-21600,MacBook
com.valvesoftware.steam,8,1735700386,1735700394,1735700395,-21600,MacBook
unity.Team17.Overcooked2,46,1735700340,1735700386,1735700387,-21600,MacBook
com.valvesoftware.steam,8,1735700332,1735700340,1735700340,-21600,MacBook
unity.Team17.Overcooked2,28,1735700304,1735700332,1735700333,-21600,MacBook
com.valvesoftware.steam,109,1735700195,1735700304,1735700305,-21600,MacBook
com.openai.chat,39,1735700255,1735700294,1735700295,-21600,iPhone
com.xingin.discover,38,1735700216,1735700254,1735700254,-21600,iPhone
com.tencent.xin,12,1735700203,1735700215,1735700216,-21600,iPhone
com.apple.systempreferences,6,1735700189,1735700195,1735700196,-21600,MacBook
com.tencent.xin,43,1735700149,1735700192,1735700193,-21600,iPhone
com.valvesoftware.steam,1,1735700188,1735700189,1735700190,-21600,MacBook
com.apple.systempreferences,1,1735700181,1735700182,1735700183,-21600,MacBook
unity.Team17.Overcooked2,61,1735700120,1735700181,1735700182,-21600,MacBook
com.xingin.discover,13,1735700136,1735700149,1735700149,-21600,iPhone
com.tencent.xin,14,1735700120,1735700134,1735700135,-21600,iPhone
com.apple.systempreferences,2,1735700115,1735700117,1735700118,-21600,MacBook
unity.Team17.Overcooked2,32,1735700075,1735700107,1735700108,-21600,MacBook
com.tencent.xin,29,1735700055,1735700084,1735700085,-21600,iPhone
com.valvesoftware.steam,17,1735700058,1735700075,1735700076,-21600,MacBook
unity.Team17.Overcooked2,7,1735700051,1735700058,1735700058,-21600,MacBook
com.xingin.discover,28,1735700027,1735700055,1735700056,-21600,iPhone
com.tencent.xinWeChat,39,1735700012,1735700051,1735700051,-21600,MacBook
com.valvesoftware.steam,6,1735700006,1735700012,1735700012,-21600,MacBook
com.tencent.xinWeChat,27,1735699979,1735700006,1735700007,-21600,MacBook
com.valvesoftware.steam,3,1735699976,1735699979,1735699979,-21600,MacBook
com.tencent.xinWeChat,9,1735699967,1735699976,1735699976,-21600,MacBook
com.apple.finder,1,1735699966,1735699967,1735699967,-21600,MacBook
unity.Team17.Overcooked2,2,1735699964,1735699966,1735699966,-21600,MacBook
com.valvesoftware.steam,1,1735699963,1735699964,1735699965,-21600,MacBook
unity.Team17.Overcooked2,2,1735699961,1735699963,1735699964,-21600,MacBook
com.valvesoftware.steam,1,1735699960,1735699961,1735699962,-21600,MacBook
unity.Team17.Overcooked2,2,1735699958,1735699960,1735699961,-21600,MacBook
com.tencent.xinWeChat,1,1735699957,1735699958,1735699959,-21600,MacBook
com.valvesoftware.steam,3,1735699954,1735699957,1735699957,-21600,MacBook
unity.Team17.Overcooked2,1,1735699953,1735699954,1735699954,-21600,MacBook
com.valvesoftware.steam,2,1735699951,1735699953,1735699954,-21600,MacBook
com.tencent.xinWeChat,6,1735699945,1735699951,1735699952,-21600,MacBook
com.valvesoftware.steam,1,1735699944,1735699945,1735699946,-21600,MacBook
com.apple.finder,2,1735699942,1735699944,1735699944,-21600,MacBook
com.apple.systempreferences,10,1735699932,1735699942,1735699943,-21600,MacBook
com.apple.finder,3,1735699929,1735699932,1735699932,-21600,MacBook
com.valvesoftware.steam,1,1735699928,1735699929,1735699930,-21600,MacBook
com.tencent.xinWeChat,10,1735699918,1735699928,1735699928,-21600,MacBook
com.valvesoftware.steam,2,1735699916,1735699918,1735699919,-21600,MacBook
unity.Team17.Overcooked2,4,1735699900,1735699904,1735699905,-21600,MacBook
com.valvesoftware.steam,4,1735699896,1735699900,1735699901,-21600,MacBook
unity.Team17.Overcooked2,1,1735699895,1735699896,1735699897,-21600,MacBook
com.valvesoftware.steam,6,1735699889,1735699895,1735699896,-21600,MacBook
com.xingin.discover,17,1735699823,1735699840,1735699841,-21600,iPhone
com.apple.finder,1,1735699810,1735699811,1735699817,-21600,MacBook
com.tencent.xinWeChat,3,1735699807,1735699810,1735699816,-21600,MacBook
com.apple.finder,1,1735699806,1735699807,1735699814,-21600,MacBook
com.apple.systempreferences,15,1735699791,1735699806,1735699810,-21600,MacBook
com.tencent.xinWeChat,21,1735699770,1735699791,1735699792,-21600,MacBook
com.valvesoftware.steam,11,1735699759,1735699770,1735699770,-21600,MacBook
unity.Team17.Overcooked2,3,1735699756,1735699759,1735699760,-21600,MacBook
com.apple.systempreferences,3,1735699753,1735699756,1735699757,-21600,MacBook
unity.Team17.Overcooked2,6,1735699737,1735699743,1735699743,-21600,MacBook
com.valvesoftware.steam,9,1735699728,1735699737,1735699737,-21600,MacBook
com.apple.finder,3,1735699725,1735699728,1735699729,-21600,MacBook
com.valvesoftware.steam,3,1735699722,1735699725,1735699725,-21600,MacBook
com.apple.finder,0,1735699722,1735699722,1735699723,-21600,MacBook
com.valvesoftware.steam,24,1735699698,1735699722,1735699723,-21600,MacBook
com.tencent.xinWeChat,3,1735699695,1735699698,1735699703,-21600,MacBook
com.valvesoftware.steam,3,1735699692,1735699695,1735699702,-21600,MacBook
com.tencent.xinWeChat,11,1735699681,1735699692,1735699693,-21600,MacBook
com.valvesoftware.steam,11,1735699670,1735699681,1735699681,-21600,MacBook
com.tencent.xinWeChat,7,1735699663,1735699670,1735699670,-21600,MacBook
com.valvesoftware.steam,2,1735699661,1735699663,1735699664,-21600,MacBook
com.tencent.xinWeChat,1,1735699660,1735699661,1735699662,-21600,MacBook
com.valvesoftware.steam,13,1735699647,1735699660,1735699660,-21600,MacBook
com.tencent.xinWeChat,7,1735699640,1735699647,1735699648,-21600,MacBook
com.valvesoftware.steam,28,1735699612,1735699640,1735699641,-21600,MacBook
com.tencent.xinWeChat,7,1735699603,1735699610,1735699611,-21600,MacBook
com.valvesoftware.steam,92,1735699511,1735699603,1735699603,-21600,MacBook
com.xingin.discover,158,1735699427,1735699585,1735699586,-21600,iPhone
com.tencent.xin,14,1735699413,1735699427,1735699428,-21600,iPhone
com.xingin.discover,2,1735699410,1735699412,1735699413,-21600,iPhone
com.microsoft.Office.Outlook,14,1735699390,1735699404,1735699404,-21600,iPhone
com.apple.finder,4,1735699394,1735699398,1735699400,-21600,MacBook
com.tencent.xinWeChat,1,1735699393,1735699394,1735699396,-21600,MacBook
com.valvesoftware.steam,1,1735699392,1735699393,1735699395,-21600,MacBook
com.tencent.xin,3,1735699386,1735699389,1735699389,-21600,iPhone
com.apple.finder,3,1735699377,1735699380,1735699380,-21600,MacBook
com.valvesoftware.steam,48,1735699329,1735699377,1735699377,-21600,MacBook
com.tencent.xin,24,1735699331,1735699355,1735699356,-21600,iPhone
com.tencent.xinWeChat,1,1735699328,1735699329,1735699330,-21600,MacBook
com.valvesoftware.steam,5,1735699323,1735699328,1735699329,-21600,MacBook
com.tencent.xinWeChat,2,1735699321,1735699323,1735699323,-21600,MacBook
com.valvesoftware.steam,21,1735699300,1735699321,1735699322,-21600,MacBook
com.tencent.xinWeChat,21,1735699279,1735699300,1735699300,-21600,MacBook
com.apple.finder,1,1735699278,1735699279,1735699280,-21600,MacBook
com.tencent.xinWeChat,1,1735699277,1735699278,1735699278,-21600,MacBook
com.apple.finder,5,1735699272,1735699277,1735699277,-21600,MacBook
com.tencent.xinWeChat,2,1735699270,1735699272,1735699272,-21600,MacBook
com.valvesoftware.steam,201,1735699069,1735699270,1735699271,-21600,MacBook
com.tencent.xin,91,1735699130,1735699221,1735699222,-21600,iPhone
com.tencent.xin,44,1735699080,1735699124,1735699124,-21600,iPhone
com.tencent.xinWeChat,40,1735699029,1735699069,1735699070,-21600,MacBook
com.tencent.xin,6,1735699063,1735699069,1735699069,-21600,iPhone
com.xingin.discover,31,1735699032,1735699063,1735699063,-21600,iPhone
com.valvesoftware.steam,2,1735699027,1735699029,1735699030,-21600,MacBook
com.xingin.discover,10,1735699016,1735699026,1735699027,-21600,iPhone
com.tencent.xinWeChat,0,1735699026,1735699026,1735699027,-21600,MacBook
com.valvesoftware.steam,0,1735699026,1735699026,1735699026,-21600,MacBook
com.tencent.xinWeChat,2,1735699021,1735699023,1735699023,-21600,MacBook
com.google.Chrome,3,1735699018,1735699021,1735699022,-21600,MacBook
com.tencent.xinWeChat,19,1735698999,1735699018,1735699019,-21600,MacBook
com.xingin.discover,6,1735699005,1735699011,1735699011,-21600,iPhone
com.valvesoftware.steam,16,1735698983,1735698999,1735699000,-21600,MacBook
com.xingin.discover,15,1735698984,1735698999,1735699000,-21600,iPhone
com.tencent.xin,24,1735698960,1735698984,1735698985,-21600,iPhone
com.tencent.xinWeChat,15,1735698958,1735698973,1735698974,-21600,MacBook
com.valvesoftware.steam,2,1735698956,1735698958,1735698959,-21600,MacBook
com.tencent.xinWeChat,2,1735698928,1735698930,1735698930,-21600,MacBook
com.google.Chrome,8,1735698920,1735698928,1735698929,-21600,MacBook
com.tencent.xinWeChat,6,1735698914,1735698920,1735698921,-21600,MacBook
com.valvesoftware.steam,1,1735698913,1735698914,1735698915,-21600,MacBook
com.google.Chrome,2,1735698892,1735698894,1735698894,-21600,MacBook
com.valvesoftware.steam,1,1735698891,1735698892,1735698892,-21600,MacBook
com.google.Chrome,3,1735698888,1735698891,1735698891,-21600,MacBook
com.tencent.xinWeChat,4,1735698884,1735698888,1735698888,-21600,MacBook
com.valvesoftware.steam,1,1735698883,1735698884,1735698885,-21600,MacBook
com.apple.finder,1,1735698882,1735698883,1735698883,-21600,MacBook
com.valvesoftware.steam,2,1735698880,1735698882,1735698882,-21600,MacBook
com.apple.finder,6,1735698874,1735698880,1735698880,-21600,MacBook
com.valvesoftware.steam,1,1735698873,1735698874,1735698875,-21600,MacBook
com.apple.finder,1,1735698872,1735698873,1735698874,-21600,MacBook
com.valvesoftware.steam,0,1735698872,1735698872,1735698873,-21600,MacBook
com.apple.finder,0,1735698872,1735698872,1735698873,-21600,MacBook
com.tencent.xinWeChat,6,1735698863,1735698869,1735698870,-21600,MacBook
com.apple.finder,3,1735698860,1735698863,1735698864,-21600,MacBook
com.tencent.xinWeChat,7,1735698853,1735698860,1735698861,-21600,MacBook
com.apple.finder,10,1735698843,1735698853,1735698853,-21600,MacBook
com.tencent.xinWeChat,8,1735698835,1735698843,1735698844,-21600,MacBook
com.google.Chrome,12,1735698823,1735698835,1735698836,-21600,MacBook
com.tencent.xinWeChat,3,1735698820,1735698823,1735698824,-21600,MacBook
com.google.Chrome,3,1735698817,1735698820,1735698821,-21600,MacBook
com.apple.finder,2,1735698815,1735698817,1735698818,-21600,MacBook
com.tencent.xinWeChat,2,1735698813,1735698815,1735698816,-21600,MacBook
com.google.Chrome,1,1735698812,1735698813,1735698814,-21600,MacBook
com.tencent.xinWeChat,1,1735698811,1735698812,1735698813,-21600,MacBook
com.google.Chrome,48,1735698763,1735698811,1735698811,-21600,MacBook
com.tencent.xinWeChat,17,1735698746,1735698763,1735698764,-21600,MacBook
com.google.Chrome,5,1735698741,1735698746,1735698747,-21600,MacBook
com.tencent.xinWeChat,2,1735698739,1735698741,1735698742,-21600,MacBook
com.google.Chrome,4,1735698735,1735698739,1735698740,-21600,MacBook
com.tencent.xinWeChat,6,1735698729,1735698735,1735698735,-21600,MacBook
com.apple.Notes,2,1735698727,1735698729,1735698729,-21600,MacBook
com.tencent.xinWeChat,18,1735698709,1735698727,1735698728,-21600,MacBook
com.google.Chrome,1,1735698708,1735698709,1735698710,-21600,MacBook
com.tencent.xinWeChat,3,1735698705,1735698708,1735698709,-21600,MacBook
com.apple.Notes,3,1735698702,1735698705,1735698707,-21600,MacBook
com.tencent.xinWeChat,10,1735698692,1735698702,1735698703,-21600,MacBook
com.tencent.xin,8,1735698694,1735698702,1735698703,-21600,iPhone
com.apple.mobilenotes,21,1735698673,1735698694,1735698695,-21600,iPhone
com.apple.Notes,37,1735698655,1735698692,1735698693,-21600,MacBook
com.apple.Preferences,5,1735698668,1735698673,1735698674,-21600,iPhone
com.apple.mobilenotes,9,1735698658,1735698667,1735698667,-21600,iPhone
com.tencent.xin,6,1735698652,1735698658,1735698658,-21600,iPhone
com.tencent.xinWeChat,1,1735698654,1735698655,1735698656,-21600,MacBook
com.google.Chrome,29,1735698625,1735698654,1735698654,-21600,MacBook
com.xingin.discover,2,1735698650,1735698652,1735698652,-21600,iPhone
com.tencent.xin,1,1735698649,1735698650,1735698651,-21600,iPhone
com.apple.PosterBoard,1,1735698649,1735698650,1735698650,-21600,iPhone
com.tencent.xin,37,1735698611,1735698648,1735698649,-21600,iPhone
com.tencent.xinWeChat,1,1735698624,1735698625,1735698625,-21600,MacBook
com.google.Chrome,8,1735698616,1735698624,1735698624,-21600,MacBook
com.apple.finder,17,1735698599,1735698616,1735698617,-21600,MacBook
com.apple.mobilenotes,27,1735698584,1735698611,1735698612,-21600,iPhone
com.apple.Notes,60,1735698539,1735698599,1735698599,-21600,MacBook
com.tencent.xin,19,1735698565,1735698584,1735698584,-21600,iPhone
com.apple.mobilenotes,21,1735698544,1735698565,1735698566,-21600,iPhone
com.tencent.xin,21,1735698522,1735698543,1735698544,-21600,iPhone
com.google.Chrome,1,1735698538,1735698539,1735698540,-21600,MacBook
com.apple.Notes,4,1735698534,1735698538,1735698538,-21600,MacBook
com.apple.finder,3,1735698531,1735698534,1735698535,-21600,MacBook
com.google.Chrome,84,1735698447,1735698531,1735698531,-21600,MacBook
com.tencent.xin,7,1735698510,1735698517,1735698518,-21600,iPhone
com.tencent.xin,11,1735698499,1735698510,1735698510,-21600,iPhone
com.google.chrome.ios,2,1735698497,1735698499,1735698499,-21600,iPhone
com.apple.finder,8,1735698439,1735698447,1735698447,-21600,MacBook
com.google.chrome.ios,125,1735698284,1735698409,1735698410,-21600,iPhone
com.microsoft.Office.Outlook,11,1735698273,1735698284,1735698285,-21600,iPhone
com.google.chrome.ios,19,1735698254,1735698273,1735698273,-21600,iPhone
com.apple.CoreAuthUI,2,1735698266,1735698268,1735698268,-21600,iPhone
com.discoverfinancial.mobile,2,1735698251,1735698253,1735698254,-21600,iPhone
com.xingin.discover,1,1735698250,1735698251,1735698251,-21600,iPhone
com.tencent.xin,23,1735698227,1735698250,1735698250,-21600,iPhone
com.google.chrome.ios,10,1735698217,1735698227,1735698227,-21600,iPhone
com.tencent.xin,11,1735698206,1735698217,1735698218,-21600,iPhone
com.xingin.discover,2,1735698204,1735698206,1735698207,-21600,iPhone
com.google.chrome.ios,21,1735698183,1735698204,1735698206,-21600,iPhone
com.xingin.discover,3,1735698180,1735698183,1735698183,-21600,iPhone
com.tencent.xin,4,1735698176,1735698180,1735698180,-21600,iPhone
com.xingin.discover,39,1735698137,1735698176,1735698176,-21600,iPhone
com.tencent.xin,23,1735698114,1735698137,1735698138,-21600,iPhone
com.google.chrome.ios,0,1735698114,1735698114,1735698115,-21600,iPhone
com.xingin.discover,39,1735698075,1735698114,1735698114,-21600,iPhone
com.google.chrome.ios,2,1735698072,1735698074,1735698074,-21600,iPhone
com.tencent.xin,50,1735698022,1735698072,1735698073,-21600,iPhone
com.google.chrome.ios,19,1735698003,1735698022,1735698023,-21600,iPhone
com.xingin.discover,1,1735698002,1735698003,1735698004,-21600,iPhone
com.google.chrome.ios,14,1735697987,1735698001,1735698002,-21600,iPhone
com.tencent.xin,10,1735697976,1735697986,1735697987,-21600,iPhone
com.tencent.xin,4,1735697970,1735697974,1735697975,-21600,iPhone
com.xingin.discover,8,1735697962,1735697970,1735697971,-21600,iPhone
com.tencent.xin,36,1735697926,1735697962,1735697963,-21600,iPhone
com.xingin.discover,1036,1735696890,1735697926,1735697926,-21600,iPhone
com.tencent.xin,2,1735696885,1735696887,1735696888,-21600,iPhone
com.tencent.xin,22,1735696776,1735696798,1735696799,-21600,iPhone
com.tencent.xin,42,1735696734,1735696776,1735696777,-21600,iPhone
com.tencent.xin,9,1735696686,1735696695,1735696696,-21600,iPhone
com.tencent.xin,16,1735696527,1735696543,1735696544,-21600,iPhone
com.tencent.xin,26,1735696484,1735696510,1735696511,-21600,iPhone
com.google.chrome.ios,2,1735696482,1735696484,1735696485,-21600,iPhone
com.google.chrome.ios,2,1735696444,1735696446,1735696446,-21600,iPhone
com.google.chrome.ios,1,1735696436,1735696437,1735696437,-21600,iPhone
com.google.chrome.ios,13,1735696344,1735696357,1735696358,-21600,iPhone
com.google.chrome.ios,48,1735696153,1735696201,1735696202,-21600,iPhone
com.tencent.xin,6,1735696147,1735696153,1735696154,-21600,iPhone
com.google.chrome.ios,3,1735696144,1735696147,1735696147,-21600,iPhone
com.tencent.xin,34,1735696110,1735696144,1735696145,-21600,iPhone
com.tencent.xin,16,1735696057,1735696073,1735696074,-21600,iPhone
com.google.chrome.ios,2,1735696055,1735696057,1735696058,-21600,iPhone
com.tencent.xin,17,1735696038,1735696055,1735696056,-21600,iPhone
com.google.chrome.ios,9,1735696029,1735696038,1735696039,-21600,iPhone
com.tencent.xin,9,1735696020,1735696029,1735696030,-21600,iPhone
com.google.chrome.ios,10,1735696010,1735696020,1735696022,-21600,iPhone
com.tencent.xin,7,1735696003,1735696010,1735696010,-21600,iPhone
com.tencent.xin,4,1735695329,1735695333,1735695334,-21600,iPhone
com.xingin.discover,24,1735695305,1735695329,1735695330,-21600,iPhone
com.tencent.xin,1,1735695304,1735695305,1735695305,-21600,iPhone
com.xingin.discover,108,1735695194,1735695302,1735695303,-21600,iPhone
com.tencent.xin,115,1735695078,1735695193,1735695194,-21600,iPhone
com.google.chrome.ios,25,1735695053,1735695078,1735695079,-21600,iPhone
com.tencent.xin,63,1735694990,1735695053,1735695053,-21600,iPhone
com.google.chrome.ios,150,1735694840,1735694990,1735694991,-21600,iPhone
com.tencent.xin,32,1735694808,1735694840,1735694841,-21600,iPhone
com.google.chrome.ios,1,1735694807,1735694808,1735694808,-21600,iPhone
com.tencent.xin,22,1735694784,1735694806,1735694806,-21600,iPhone
com.tencent.xin,2,1735694729,1735694731,1735694732,-21600,iPhone
com.google.chrome.ios,11,1735694718,1735694729,1735694730,-21600,iPhone
com.xingin.discover,1,1735694717,1735694718,1735694719,-21600,iPhone
com.tencent.xin,241,1735694475,1735694716,1735694717,-21600,iPhone
com.google.chrome.ios,1,1735694472,1735694473,1735694473,-21600,iPhone
com.xingin.discover,1,1735694469,1735694470,1735694471,-21600,iPhone
com.tencent.xin,10,1735694459,1735694469,1735694470,-21600,iPhone
com.google.chrome.ios,9,1735694449,1735694458,1735694459,-21600,iPhone
com.tencent.xin,33,1735694415,1735694448,1735694448,-21600,iPhone
com.xingin.discover,227,1735694188,1735694415,1735694415,-21600,iPhone
com.tencent.xin,2,1735694186,1735694188,1735694188,-21600,iPhone
com.xingin.discover,159,1735694027,1735694186,1735694186,-21600,iPhone
com.tencent.xin,116,1735693911,1735694027,1735694028,-21600,iPhone
com.xingin.discover,416,1735693493,1735693909,1735693909,-21600,iPhone
com.tencent.xin,69,1735693424,1735693493,1735693494,-21600,iPhone
com.xingin.discover,292,1735693132,1735693424,1735693425,-21600,iPhone
com.tencent.xin,2,1735693130,1735693132,1735693133,-21600,iPhone
com.google.chrome.ios,2,1735693128,1735693130,1735693130,-21600,iPhone
com.tencent.xin,1,1735693127,1735693128,1735693129,-21600,iPhone
com.xingin.discover,429,1735692697,1735693126,1735693127,-21600,iPhone
com.tencent.xin,2,1735692695,1735692697,1735692697,-21600,iPhone
com.xingin.discover,361,1735692334,1735692695,1735692695,-21600,iPhone
com.tencent.xin,79,1735692255,1735692334,1735692335,-21600,iPhone
com.xingin.discover,435,1735691819,1735692254,1735692255,-21600,iPhone
com.google.chrome.ios,101,1735691714,1735691815,1735691816,-21600,iPhone
com.tencent.xin,9,1735691705,1735691714,1735691715,-21600,iPhone
com.google.chrome.ios,28,1735691677,1735691705,1735691705,-21600,iPhone
com.tencent.xin,15,1735691662,1735691677,1735691678,-21600,iPhone
com.google.chrome.ios,32,1735691630,1735691662,1735691662,-21600,iPhone
com.tencent.xin,12,1735691618,1735691630,1735691630,-21600,iPhone
com.google.chrome.ios,45,1735691573,1735691618,1735691619,-21600,iPhone
com.tencent.xin,7,1735691566,1735691573,1735691573,-21600,iPhone
com.google.chrome.ios,1,1735691565,1735691566,1735691567,-21600,iPhone
com.tencent.xin,12,1735691553,1735691565,1735691566,-21600,iPhone
com.google.chrome.ios,57,1735691496,1735691553,1735691554,-21600,iPhone
com.tencent.xin,58,1735691438,1735691496,1735691497,-21600,iPhone
com.google.chrome.ios,27,1735691411,1735691438,1735691439,-21600,iPhone
com.tencent.xin,9,1735691402,1735691411,1735691412,-21600,iPhone
com.google.chrome.ios,5,1735691397,1735691402,1735691403,-21600,iPhone
com.tencent.xin,7,1735691390,1735691397,1735691398,-21600,iPhone
com.google.chrome.ios,59,1735691331,1735691390,1735691391,-21600,iPhone
com.tencent.xin,23,1735691308,1735691331,1735691332,-21600,iPhone
com.google.chrome.ios,26,1735691282,1735691308,1735691309,-21600,iPhone
com.tencent.xin,4,1735691278,1735691282,1735691283,-21600,iPhone
com.google.chrome.ios,1,1735691277,1735691278,1735691279,-21600,iPhone
com.tencent.xin,32,1735691245,1735691277,1735691277,-21600,iPhone
com.google.chrome.ios,39,1735691206,1735691245,1735691246,-21600,iPhone
com.tencent.xin,14,1735691192,1735691206,1735691206,-21600,iPhone
com.chase,16,1735691176,1735691192,1735691193,-21600,iPhone
com.apple.CoreAuthUI,1,1735691177,1735691178,1735691179,-21600,iPhone
com.chase,4,1735691171,1735691175,1735691175,-21600,iPhone
com.discoverfinancial.mobile,52,1735691118,1735691170,1735691171,-21600,iPhone
com.apple.CoreAuthUI,2,1735691125,1735691127,1735691128,-21600,iPhone
com.tencent.xin,2,1735691116,1735691118,1735691118,-21600,iPhone
com.discoverfinancial.mobile,1,1735691115,1735691116,1735691117,-21600,iPhone
com.tencent.xin,12,1735691102,1735691114,1735691115,-21600,iPhone
com.google.chrome.ios,1,1735691101,1735691102,1735691103,-21600,iPhone
com.tencent.xin,2,1735691099,1735691101,1735691101,-21600,iPhone
com.xingin.discover,3,1735691095,1735691098,1735691098,-21600,iPhone
com.tencent.xin,141,1735690950,1735691091,1735691092,-21600,iPhone
com.tencent.xin,6,1735687597,1735687603,1735687604,-21600,iPhone
com.tencent.xin,3,1735687531,1735687534,1735687535,-21600,iPhone
com.tencent.xin,5,1735687523,1735687528,1735687528,-21600,iPhone
com.tencent.xin,45,1735686087,1735686132,1735686133,-21600,iPhone
com.apple.finder,84,1735685989,1735686073,1735686074,-21600,MacBook
com.apple.Notes,3,1735685986,1735685989,1735685989,-21600,MacBook
com.google.Chrome,99,1735685887,1735685986,1735685987,-21600,MacBook
com.apple.Notes,2,1735685885,1735685887,1735685888,-21600,MacBook
com.google.Chrome,77,1735685808,1735685885,1735685886,-21600,MacBook
com.apple.Notes,10,1735685798,1735685808,1735685809,-21600,MacBook
com.google.Chrome,24,1735685774,1735685798,1735685798,-21600,MacBook
com.apple.Notes,18,1735685756,1735685774,1735685774,-21600,MacBook
com.google.Chrome,2,1735685754,1735685756,1735685757,-21600,MacBook
com.apple.Notes,8,1735685746,1735685754,1735685755,-21600,MacBook
com.google.Chrome,2,1735685744,1735685746,1735685747,-21600,MacBook
com.apple.Notes,31,1735685713,1735685744,1735685744,-21600,MacBook
com.microsoft.Outlook,5,1735685708,1735685713,1735685714,-21600,MacBook
com.apple.Notes,2,1735685706,1735685708,1735685709,-21600,MacBook
com.apple.finder,0,1735685706,1735685706,1735685707,-21600,MacBook
com.google.Chrome,26,1735685680,1735685706,1735685706,-21600,MacBook
com.google.Chrome,301,1735684281,1735684582,1735684583,-21600,MacBook
com.google.Chrome,304,1735683355,1735683659,1735683660,-21600,MacBook
com.google.Chrome,491,1735682816,1735683307,1735683308,-21600,MacBook
com.apple.finder,2,1735682814,1735682816,1735682816,-21600,MacBook
com.google.Chrome,17,1735682797,1735682814,1735682814,-21600,MacBook
com.microsoft.Outlook,9,1735682788,1735682797,1735682798,-21600,MacBook
com.google.Chrome,106,1735682682,1735682788,1735682789,-21600,MacBook
com.microsoft.Outlook,7,1735682675,1735682682,1735682683,-21600,MacBook
com.google.Chrome,10,1735682665,1735682675,1735682676,-21600,MacBook
com.microsoft.Outlook,7,1735682658,1735682665,1735682665,-21600,MacBook
com.google.Chrome,47,1735682611,1735682658,1735682658,-21600,MacBook
com.microsoft.Outlook,23,1735682588,1735682611,1735682611,-21600,MacBook
com.google.Chrome,4,1735682584,1735682588,1735682588,-21600,MacBook
com.microsoft.Outlook,4,1735682580,1735682584,1735682585,-21600,MacBook
com.google.Chrome,4,1735682576,1735682580,1735682580,-21600,MacBook
com.microsoft.Outlook,20,1735682556,1735682576,1735682576,-21600,MacBook
com.google.Chrome,22,1735682534,1735682556,1735682556,-21600,MacBook
com.microsoft.Outlook,14,1735682520,1735682534,1735682535,-21600,MacBook
com.google.Chrome,10,1735682510,1735682520,1735682521,-21600,MacBook
com.apple.finder,13,1735682497,1735682510,1735682511,-21600,MacBook
com.google.Chrome,5,1735682492,1735682497,1735682498,-21600,MacBook
com.apple.finder,3,1735682489,1735682492,1735682493,-21600,MacBook
com.google.Chrome,61,1735682428,1735682489,1735682490,-21600,MacBook
com.apple.mobiletimer,8,1735682446,1735682454,1735682454,-21600,iPhone
com.apple.sidecar,4,1735682446,1735682450,1735682451,-21600,iPhone
com.sunsama.native-app,7,1735682421,1735682428,1735682428,-21600,MacBook
com.apple.finder,2,1735682365,1735682367,1735682367,-21600,MacBook
com.google.Chrome,15,1735682350,1735682365,1735682365,-21600,MacBook
com.apple.finder,3,1735682347,1735682350,1735682351,-21600,MacBook
com.apple.mobiletimer,2,1735682278,1735682280,1735682280,-21600,iPhone
com.apple.mobiletimer,4,1735682274,1735682278,1735682278,-21600,iPhone
com.apple.mobiletimer,1,1735682234,1735682235,1735682236,-21600,iPhone
com.apple.mobiletimer,1,1735682063,1735682064,1735682065,-21600,iPhone
com.apple.mobiletimer,6,1735681668,1735681674,1735681675,-21600,iPhone
com.tencent.xin,3,1735681622,1735681625,1735681625,-21600,iPhone
com.tencent.xin,19,1735681233,1735681252,1735681252,-21600,iPhone
com.tencent.xin,45,1735681074,1735681119,1735681120,-21600,iPhone
com.tencent.xin,7,1735681066,1735681073,1735681074,-21600,iPhone
com.tencent.xin,5,1735681060,1735681065,1735681065,-21600,iPhone
com.microsoft.Office.Outlook,9,1735681051,1735681060,1735681060,-21600,iPhone
com.apple.mobiletimer,3,1735681048,1735681051,1735681052,-21600,iPhone
com.apple.mobiletimer,0,1735681047,1735681047,1735681048,-21600,iPhone
com.apple.mobiletimer,10,1735680600,1735680610,1735680611,-21600,iPhone
com.apple.mobiletimer,5,1735679429,1735679434,1735679436,-21600,iPhone
com.microsoft.Office.Outlook,3,1735679423,1735679426,1735679430,-21600,iPhone
com.microsoft.Office.Outlook,1,1735679420,1735679421,1735679422,-21600,iPhone
com.microsoft.Office.Outlook,6,1735678851,1735678857,1735678858,-21600,iPhone
com.apple.camera,0,1735678851,1735678851,1735678852,-21600,iPhone
com.microsoft.Office.Outlook,9,1735678835,1735678844,1735678845,-21600,iPhone
com.microsoft.Office.Outlook,2,1735678833,1735678835,1735678835,-21600,iPhone
com.tencent.xin,105,1735678728,1735678833,1735678833,-21600,iPhone
com.apple.MobileSMS,7,1735678721,1735678728,1735678728,-21600,iPhone
com.google.chrome.ios,15,1735678701,1735678716,1735678717,-21600,iPhone
com.apple.camera,1,1735678705,1735678706,1735678706,-21600,iPhone
com.google.chrome.ios,1128,1735655184,1735656312,1735656313,-21600,iPhone
com.xingin.discover,126,1735655058,1735655184,1735655184,-21600,iPhone
com.xingin.discover,756,1735654267,1735655023,1735655023,-21600,iPhone
com.xingin.discover,815,1735653452,1735654267,1735654267,-21600,iPhone
com.google.chrome.ios,27,1735653418,1735653445,1735653446,-21600,iPhone
com.xingin.discover,1375,1735652040,1735653415,1735653416,-21600,iPhone
com.google.chrome.ios,3,1735652035,1735652038,1735652039,-21600,iPhone
com.tencent.xin,22,1735652013,1735652035,1735652035,-21600,iPhone
com.google.chrome.ios,1,1735652012,1735652013,1735652014,-21600,iPhone
com.tencent.xin,1,1735652011,1735652012,1735652012,-21600,iPhone
com.google.chrome.ios,4,1735652005,1735652009,1735652010,-21600,iPhone
com.tencent.xin,438,1735651566,1735652004,1735652005,-21600,iPhone
com.google.chrome.ios,1,1735651563,1735651564,1735651565,-21600,iPhone
com.apple.camera,3,1735650738,1735650741,1735650742,-21600,iPhone
com.tencent.xin,44,1735649984,1735650028,1735650029,-21600,iPhone
com.tencent.xin,572,1735649409,1735649981,1735649981,-21600,iPhone
com.tencent.xin,2,1735649405,1735649407,1735649407,-21600,iPhone
com.tencent.xin,454,1735648951,1735649405,1735649405,-21600,iPhone
com.tencent.xin,65,1735648885,1735648950,1735648950,-21600,iPhone
com.tencent.xin,66,1735648817,1735648883,1735648883,-21600,iPhone
com.apple.mobiletimer,12,1735648800,1735648812,1735648812,-21600,iPhone
com.apple.Preferences,3,1735648796,1735648799,1735648800,-21600,iPhone
tv.danmaku.bilianime,3,1735648785,1735648788,1735648789,-21600,iPhone
com.bilibili.bilicomic,27,1735648757,1735648784,1735648785,-21600,iPhone
com.bilibili.bilicomic,10,1735648747,1735648757,1735648757,-21600,iPhone
com.bilibili.bilicomic,47,1735648697,1735648744,1735648745,-21600,iPhone
tv.danmaku.bilianime,2,1735648695,1735648697,1735648698,-21600,iPhone
com.bilibili.bilicomic,1,1735648692,1735648693,1735648694,-21600,iPhone
com.apple.CoreAuthUI,3,1735648687,1735648690,1735648690,-21600,iPhone
tv.danmaku.bilianime,2,1735648685,1735648687,1735648688,-21600,iPhone
com.apple.CoreAuthUI,2,1735648579,1735648581,1735648582,-21600,iPhone
com.apple.CoreAuthUI,3,1735648565,1735648568,1735648568,-21600,iPhone
com.tencent.xin,1,1735648489,1735648490,1735648491,-21600,iPhone
com.xingin.discover,31,1735648415,1735648446,1735648447,-21600,iPhone
com.microsoft.Office.Outlook,5,1735648410,1735648415,1735648415,-21600,iPhone
com.apple.Preferences,8,1735648398,1735648406,1735648407,-21600,iPhone
com.apple.mobiletimer,8,1735648388,1735648396,1735648397,-21600,iPhone
com.microsoft.Office.Outlook,8,1735648378,1735648386,1735648387,-21600,iPhone
com.xingin.discover,9,1735648367,1735648376,1735648377,-21600,iPhone
com.xingin.discover,55,1735645327,1735645382,1735645383,-21600,iPhone
com.xingin.discover,1692,1735643630,1735645322,1735645323,-21600,iPhone
tv.danmaku.bilianime,4079,1735636759,1735640838,1735640839,-21600,iPhone
tv.danmaku.bilianime,2,1735636757,1735636759,1735636759,-21600,iPhone
com.xingin.discover,1,1735636752,1735636753,1735636754,-21600,iPhone
tv.danmaku.bilianime,2,1735636711,1735636713,1735636713,-21600,iPhone
com.bilibili.bilicomic,2,1735636693,1735636695,1735636696,-21600,iPhone
tv.danmaku.bilianime,1,1735636690,1735636691,1735636692,-21600,iPhone
com.google.chrome.ios,3,1735636682,1735636685,1735636685,-21600,iPhone
com.tencent.xin,106,1735636576,1735636682,1735636683,-21600,iPhone
com.google.chrome.ios,33,1735636539,1735636572,1735636573,-21600,iPhone
com.microsoft.Office.Outlook,9,1735636529,1735636538,1735636539,-21600,iPhone
com.duosecurity.DuoMobile,6,1735636522,1735636528,1735636529,-21600,iPhone
com.google.chrome.ios,6,1735636515,1735636521,1735636521,-21600,iPhone
com.google.chrome.ios,16,1735636498,1735636514,1735636514,-21600,iPhone
com.apple.CoreAuthUI,2,1735636510,1735636512,1735636512,-21600,iPhone
com.apple.CoreAuthUI,2,1735636504,1735636506,1735636507,-21600,iPhone
com.tencent.xin,13,1735636485,1735636498,1735636499,-21600,iPhone
com.tencent.xin,10,1735636437,1735636447,1735636448,-21600,iPhone
com.google.chrome.ios,18,1735636419,1735636437,1735636439,-21600,iPhone
com.tencent.xin,1,1735636417,1735636418,1735636419,-21600,iPhone
com.google.calendar,13,1735636400,1735636413,1735636414,-21600,iPhone
com.microsoft.Office.Outlook,3,1735636397,1735636400,1735636400,-21600,iPhone
com.tencent.xin,1,1735636396,1735636397,1735636397,-21600,iPhone
com.microsoft.Office.Outlook,2,1735636394,1735636396,1735636396,-21600,iPhone
com.xingin.discover,2,1735636391,1735636393,1735636394,-21600,iPhone
com.xingin.discover,6,1735635037,1735635043,1735635044,-21600,iPhone
com.xingin.discover,4679,1735630306,1735634985,1735634986,-21600,iPhone
com.xingin.discover,32,1735630132,1735630164,1735630164,-21600,iPhone
com.tencent.xin,45,1735630087,1735630132,1735630133,-21600,iPhone
com.xingin.discover,36,1735630051,1735630087,1735630087,-21600,iPhone
com.tencent.xin,28,1735630023,1735630051,1735630051,-21600,iPhone
com.xingin.discover,61,1735629962,1735630023,1735630024,-21600,iPhone
com.tencent.xin,65,1735629897,1735629962,1735629963,-21600,iPhone
com.tencent.xin,626,1735629271,1735629897,1735629898,-21600,iPhone
com.xingin.discover,5,1735629266,1735629271,1735629271,-21600,iPhone
com.tencent.xin,129,1735629137,1735629266,1735629267,-21600,iPhone
com.xingin.discover,6,1735629131,1735629137,1735629138,-21600,iPhone
com.tencent.xin,25,1735629106,1735629131,1735629132,-21600,iPhone
com.xingin.discover,8,1735629098,1735629106,1735629106,-21600,iPhone
com.tencent.xin,80,1735629018,1735629098,1735629099,-21600,iPhone
com.xingin.discover,146,1735628872,1735629018,1735629019,-21600,iPhone
com.tencent.xin,194,1735628678,1735628872,1735628872,-21600,iPhone
com.xingin.discover,120,1735628558,1735628678,1735628678,-21600,iPhone
com.xingin.discover,15,1735628542,1735628557,1735628558,-21600,iPhone
com.tencent.xin,223,1735628319,1735628542,1735628543,-21600,iPhone
com.xingin.discover,9,1735628310,1735628319,1735628319,-21600,iPhone
com.tencent.xin,5,1735628305,1735628310,1735628311,-21600,iPhone
com.xingin.discover,19,1735628286,1735628305,1735628306,-21600,iPhone
com.tencent.xin,254,1735628032,1735628286,1735628287,-21600,iPhone
com.tencent.xin,1,1735628030,1735628031,1735628031,-21600,iPhone
com.tencent.xin,1,1735628027,1735628028,1735628029,-21600,iPhone
com.tencent.xin,4,1735628022,1735628026,1735628026,-21600,iPhone
com.tencent.xin,1,1735628020,1735628021,1735628022,-21600,iPhone
tv.danmaku.bilianime,2,1735628013,1735628015,1735628015,-21600,iPhone
com.xingin.discover,16,1735627997,1735628013,1735628014,-21600,iPhone
com.tencent.xin,196,1735627801,1735627997,1735627997,-21600,iPhone
com.xingin.discover,19,1735627782,1735627801,1735627802,-21600,iPhone
com.tencent.xin,2,1735627780,1735627782,1735627782,-21600,iPhone
com.xingin.discover,82,1735627698,1735627780,1735627780,-21600,iPhone
com.tencent.xin,18,1735627680,1735627698,1735627699,-21600,iPhone
com.apple.Preferences,9,1735627669,1735627678,1735627679,-21600,iPhone
com.tencent.xin,39,1735627628,1735627667,1735627668,-21600,iPhone
com.apple.MobileSMS,3,1735627625,1735627628,1735627629,-21600,iPhone
com.microsoft.Office.Outlook,6,1735627616,1735627622,1735627623,-21600,iPhone
com.tencent.xin,1,1735627615,1735627616,1735627617,-21600,iPhone
com.xingin.discover,5,1735627609,1735627614,1735627615,-21600,iPhone
com.xingin.discover,10,1735627556,1735627566,1735627566,-21600,iPhone
com.xingin.discover,80,1735627179,1735627259,1735627260,-21600,iPhone
com.xingin.discover,0,1735627178,1735627178,1735627179,-21600,iPhone
com.xingin.discover,46,1735627080,1735627126,1735627127,-21600,iPhone
com.xingin.discover,129,1735626385,1735626514,1735626515,-21600,iPhone
com.xingin.discover,63,1735626124,1735626187,1735626187,-21600,iPhone
com.xingin.discover,61,1735625373,1735625434,1735625435,-21600,iPhone
com.xingin.discover,75,1735624916,1735624991,1735624992,-21600,iPhone
com.xingin.discover,1,1735624754,1735624755,1735624756,-21600,iPhone
com.xingin.discover,1,1735624752,1735624753,1735624754,-21600,iPhone
com.xingin.discover,4,1735624711,1735624715,1735624716,-21600,iPhone
com.xingin.discover,117,1735624492,1735624609,1735624610,-21600,iPhone
com.xingin.discover,11,1735624459,1735624470,1735624470,-21600,iPhone
com.xingin.discover,75,1735624382,1735624457,1735624458,-21600,iPhone
tv.danmaku.bilianime,1,1735624381,1735624382,1735624383,-21600,iPhone
com.xingin.discover,50,1735624325,1735624375,1735624376,-21600,iPhone
com.xingin.discover,259,1735624064,1735624323,1735624324,-21600,iPhone
com.xingin.discover,1004,1735623044,1735624048,1735624049,-21600,iPhone
com.xingin.discover,3421,1735619480,1735622901,1735622903,-21600,iPhone
com.tencent.xin,8,1735619470,1735619478,1735619479,-21600,iPhone
com.tencent.xin,14,1735619088,1735619102,1735619103,-21600,iPhone
com.apple.MobileSMS,3,1735619081,1735619084,1735619085,-21600,iPhone
com.discoverfinancial.mobile,7,1735619074,1735619081,1735619082,-21600,iPhone
com.discoverfinancial.mobile,26,1735618546,1735618572,1735618573,-21600,iPhone
com.apple.CoreAuthUI,2,1735618551,1735618553,1735618554,-21600,iPhone
com.apple.MobileSMS,3,1735618543,1735618546,1735618546,-21600,iPhone
com.apple.MobileSMS,19,1735618517,1735618536,1735618536,-21600,iPhone
com.google.calendar,5,1735618512,1735618517,1735618518,-21600,iPhone
com.apple.MobileSMS,7,1735618504,1735618511,1735618512,-21600,iPhone
com.tencent.xin,6,1735616428,1735616434,1735616434,-21600,iPhone
com.tencent.xin,3,1735615467,1735615470,1735615471,-21600,iPhone
com.tencent.xin,5,1735615460,1735615465,1735615466,-21600,iPhone
com.tencent.xin,12,1735612332,1735612344,1735612345,-21600,iPhone
com.xingin.discover,5,1735612327,1735612332,1735612333,-21600,iPhone
com.xingin.discover,55,1735612067,1735612122,1735612123,-21600,iPhone
com.tencent.xin,27,1735612038,1735612065,1735612066,-21600,iPhone
com.tencent.xin,28,1735611561,1735611589,1735611589,-21600,iPhone
com.tencent.xin,61,1735611338,1735611399,1735611400,-21600,iPhone
com.tencent.xin,3,1735611248,1735611251,1735611251,-21600,iPhone
com.tencent.xin,6,1735611241,1735611247,1735611248,-21600,iPhone
com.google.chrome.ios,12,1735611229,1735611241,1735611243,-21600,iPhone
com.tencent.xin,8,1735611221,1735611229,1735611229,-21600,iPhone
com.google.chrome.ios,27,1735611194,1735611221,1735611222,-21600,iPhone
com.tencent.xin,22,1735611171,1735611193,1735611194,-21600,iPhone
com.tencent.xin,29,1735611132,1735611161,1735611161,-21600,iPhone
com.microsoft.Office.Outlook,20,1735611112,1735611132,1735611132,-21600,iPhone
com.tencent.xin,63,1735611047,1735611110,1735611111,-21600,iPhone
com.xingin.discover,4,1735611041,1735611045,1735611046,-21600,iPhone
com.xingin.discover,566,1735610367,1735610933,1735610934,-21600,iPhone
com.xingin.discover,1179,1735609187,1735610366,1735610367,-21600,iPhone
com.xingin.discover,1117,1735607964,1735609081,1735609082,-21600,iPhone
com.apple.MobileSMS,3,1735607947,1735607950,1735607950,-21600,iPhone
com.apple.MobileSMS,3,1735607643,1735607646,1735607646,-21600,iPhone
com.apple.finder,8,1735606318,1735606326,1735606326,-21600,MacBook
com.apple.systempreferences,16,1735606302,1735606318,1735606318,-21600,MacBook
com.apple.finder,4,1735606298,1735606302,1735606302,-21600,MacBook
com.apple.finder,5,1735606275,1735606280,1735606281,-21600,MacBook
com.google.Chrome,4,1735606271,1735606275,1735606276,-21600,MacBook
com.apple.systempreferences,68,1735606203,1735606271,1735606272,-21600,MacBook
com.google.Chrome,55,1735606107,1735606162,1735606163,-21600,MacBook
com.apple.findmy,2,1735606105,1735606107,1735606108,-21600,MacBook
com.apple.mobiletimer,2,1735605513,1735605515,1735605516,-21600,iPhone
com.google.chrome.ios,5,1735605508,1735605513,1735605513,-21600,iPhone
com.google.chrome.ios,6,1735605490,1735605496,1735605496,-21600,iPhone
com.google.chrome.ios,8,1735605025,1735605033,1735605034,-21600,iPhone
com.google.chrome.ios,110,1735604372,1735604482,1735604482,-21600,iPhone
com.google.chrome.ios,1125,1735603227,1735604352,1735604353,-21600,iPhone
com.apple.mobiletimer,7,1735603220,1735603227,1735603228,-21600,iPhone
com.google.chrome.ios,25,1735603194,1735603219,1735603219,-21600,iPhone
com.apple.MobileSMS,4,1735603190,1735603194,1735603194,-21600,iPhone
com.tencent.xin,6,1735603182,1735603188,1735603188,-21600,iPhone
com.google.chrome.ios,193,1735602988,1735603181,1735603182,-21600,iPhone
com.google.chrome.ios,1,1735602986,1735602987,1735602988,-21600,iPhone
com.xingin.discover,559,1735602426,1735602985,1735602986,-21600,iPhone
com.apple.mobiletimer,1,1735602425,1735602426,1735602427,-21600,iPhone
com.xingin.discover,1214,1735601211,1735602425,1735602426,-21600,iPhone
com.netease.lofter,519,1735600692,1735601211,1735601212,-21600,iPhone
com.xingin.discover,10,1735600678,1735600688,1735600688,-21600,iPhone
com.bestbuy.buyphone,7,1735600671,1735600678,1735600678,-21600,iPhone
com.apple.mobiletimer,3,1735600668,1735600671,1735600671,-21600,iPhone
com.apple.mobiletimer,5,1735600624,1735600629,1735600630,-21600,iPhone
com.bestbuy.buyphone,8,1735600616,1735600624,1735600624,-21600,iPhone
com.microsoft.Office.Outlook,6,1735600610,1735600616,1735600617,-21600,iPhone
com.bestbuy.buyphone,0,1735600610,1735600610,1735600611,-21600,iPhone
com.microsoft.Office.Outlook,2,1735600605,1735600607,1735600608,-21600,iPhone
com.xingin.discover,3405,1735597200,1735600605,1735600605,-21600,iPhone
com.microsoft.Office.Outlook,5,1735597192,1735597197,1735597198,-21600,iPhone
com.microsoft.Office.Outlook,10,1735597182,1735597192,1735597193,-21600,iPhone
com.tencent.xin,5,1735597177,1735597182,1735597183,-21600,iPhone
com.tencent.xin,25,1735596326,1735596351,1735596352,-21600,iPhone
com.apple.mobiletimer,3,1735596321,1735596324,1735596325,-21600,iPhone
com.apple.mobiletimer,4,1735596308,1735596312,1735596313,-21600,iPhone
com.google.calendar,9,1735596295,1735596304,1735596305,-21600,iPhone
com.tencent.xin,14,1735596279,1735596293,1735596293,-21600,iPhone
com.apple.findmy,42,1735596250,1735596292,1735596292,-21600,MacBook
com.google.Chrome,3,1735596247,1735596250,1735596250,-21600,MacBook
com.apple.findmy,3,1735596244,1735596247,1735596248,-21600,MacBook
com.google.Chrome,9,1735596235,1735596244,1735596245,-21600,MacBook
com.apple.finder,2,1735596233,1735596235,1735596236,-21600,MacBook
com.apple.finder,2,1735596033,1735596035,1735596035,-21600,MacBook
com.apple.finder,2,1735596029,1735596031,1735596032,-21600,MacBook
com.google.Chrome,452,1735595577,1735596029,1735596029,-21600,MacBook
com.google.Chrome,2042,1735593349,1735595391,1735595391,-21600,MacBook
com.tencent.xin,9,1735592927,1735592936,1735592937,-21600,iPhone
com.apple.mobilenotes,4,1735592057,1735592061,1735592062,-21600,iPhone
com.apple.mobilenotes,1,1735592056,1735592057,1735592057,-21600,iPhone
com.apple.mobilenotes,72,1735591467,1735591539,1735591540,-21600,iPhone
com.apple.mobilenotes,6,1735591460,1735591466,1735591467,-21600,iPhone
com.apple.mobilenotes,164,1735591132,1735591296,1735591297,-21600,iPhone
com.apple.mobilenotes,6,1735591125,1735591131,1735591132,-21600,iPhone
com.apple.mobilenotes,7,1735590762,1735590769,1735590770,-21600,iPhone
com.apple.mobilenotes,101,1735590648,1735590749,1735590750,-21600,iPhone
com.microsoft.Office.Outlook,3,1735590644,1735590647,1735590648,-21600,iPhone
com.apple.MobileSMS,10,1735590632,1735590642,1735590643,-21600,iPhone
com.tencent.xin,2,1735590628,1735590630,1735590630,-21600,iPhone
com.apple.camera,9,1735590612,1735590621,1735590622,-21600,iPhone
com.tencent.xin,9,1735590610,1735590619,1735590620,-21600,iPhone
com.tencent.xin,143,1735589482,1735589625,1735589626,-21600,iPhone
com.microsoft.Office.Outlook,16,1735589466,1735589482,1735589483,-21600,iPhone
com.tencent.xin,1,1735589464,1735589465,1735589466,-21600,iPhone
com.apple.mobilenotes,12,1735589447,1735589459,1735589459,-21600,iPhone
com.apple.mobilenotes,11,1735582012,1735582023,1735582023,-21600,iPhone
com.apple.mobilenotes,36,1735559094,1735559130,1735559131,-21600,iPhone
com.apple.mobilenotes,138,1735558942,1735559080,1735559080,-21600,iPhone
com.apple.mobilenotes,1,1735558940,1735558941,1735558942,-21600,iPhone
com.apple.mobilenotes,144,1735558795,1735558939,1735558940,-21600,iPhone
com.apple.mobiletimer,13,1735557594,1735557607,1735557607,-21600,iPhone
com.tencent.xin,16,1735557574,1735557590,1735557590,-21600,iPhone
tv.danmaku.bilianime,4,1735554669,1735554673,1735554673,-21600,iPhone
tv.danmaku.bilianime,1,1735554662,1735554663,1735554664,-21600,iPhone
tv.danmaku.bilianime,1785,1735552875,1735554660,1735554661,-21600,iPhone
com.tencent.xin,20,1735552855,1735552875,1735552876,-21600,iPhone
tv.danmaku.bilianime,2812,1735550043,1735552855,1735552856,-21600,iPhone
com.chase,23,1735550019,1735550042,1735550043,-21600,iPhone
com.apple.CoreAuthUI,2,1735550023,1735550025,1735550026,-21600,iPhone
com.tencent.xin,49,1735549963,1735550012,1735550013,-21600,iPhone
com.chase,1,1735549961,1735549962,1735549962,-21600,iPhone
tv.danmaku.bilianime,600,1735549358,1735549958,1735549959,-21600,iPhone
com.google.chrome.ios,7,1735549347,1735549354,1735549355,-21600,iPhone
com.openai.chat,1,1735549346,1735549347,1735549348,-21600,iPhone
com.google.chrome.ios,2,1735549344,1735549346,1735549346,-21600,iPhone
com.openai.chat,14,1735549330,1735549344,1735549344,-21600,iPhone
com.google.chrome.ios,18,1735549312,1735549330,1735549330,-21600,iPhone
com.openai.chat,11,1735549301,1735549312,1735549313,-21600,iPhone
com.google.calendar,4,1735549297,1735549301,1735549301,-21600,iPhone
com.openai.chat,27,1735549270,1735549297,1735549298,-21600,iPhone
com.google.calendar,10,1735549259,1735549269,1735549269,-21600,iPhone
com.google.chrome.ios,10,1735549249,1735549259,1735549260,-21600,iPhone
com.apple.mobilesafari,1,1735549247,1735549248,1735549249,-21600,iPhone
com.google.calendar,32,1735549215,1735549247,1735549247,-21600,iPhone
com.apple.mobilenotes,18,1735549193,1735549211,1735549211,-21600,iPhone
com.tencent.xin,21,1735549164,1735549185,1735549186,-21600,iPhone
com.tencent.xin,3,1735549150,1735549153,1735549153,-21600,iPhone
com.tencent.xin,65,1735549083,1735549148,1735549149,-21600,iPhone
com.tencent.xin,12,1735549021,1735549033,1735549033,-21600,iPhone
com.tencent.xin,47,1735548963,1735549010,1735549011,-21600,iPhone
com.tencent.xin,1,1735548955,1735548956,1735548956,-21600,iPhone
com.tencent.xin,2,1735548258,1735548260,1735548261,-21600,iPhone
com.tencent.xin,16,1735548241,1735548257,1735548257,-21600,iPhone
com.tencent.xin,16,1735548044,1735548060,1735548060,-21600,iPhone
com.tencent.xin,14,1735547959,1735547973,1735547973,-21600,iPhone
com.tencent.xin,3,1735547951,1735547954,1735547955,-21600,iPhone
com.microsoft.Office.Outlook,4,1735547947,1735547951,1735547952,-21600,iPhone
com.microsoft.Office.Outlook,1,1735547945,1735547946,1735547947,-21600,iPhone
com.tencent.xin,25,1735547919,1735547944,1735547945,-21600,iPhone
com.ridewithvia.UCA.UniversityOfChicagoRider,4,1735547913,1735547917,1735547918,-21600,iPhone
com.ridewithvia.UCA.UniversityOfChicagoRider,6,1735547628,1735547634,1735547635,-21600,iPhone
com.ridewithvia.UCA.UniversityOfChicagoRider,24,1735547590,1735547614,1735547615,-21600,iPhone
com.ridewithvia.UCA.UniversityOfChicagoRider,107,1735547441,1735547548,1735547549,-21600,iPhone
com.ridewithvia.UCA.UniversityOfChicagoRider,16,1735547414,1735547430,1735547430,-21600,iPhone
com.ridewithvia.UCA.UniversityOfChicagoRider,4,1735547406,1735547410,1735547411,-21600,iPhone
com.ridewithvia.UCA.UniversityOfChicagoRider,6,1735547399,1735547405,1735547405,-21600,iPhone
com.ridewithvia.UCA.UniversityOfChicagoRider,15,1735547377,1735547392,1735547393,-21600,iPhone
com.ridewithvia.UCA.UniversityOfChicagoRider,11,1735547224,1735547235,1735547236,-21600,iPhone
com.ridewithvia.UCA.UniversityOfChicagoRider,36,1735547138,1735547174,1735547174,-21600,iPhone
com.ridewithvia.UCA.UniversityOfChicagoRider,18,1735547040,1735547058,1735547059,-21600,iPhone
com.apple.PassbookUIService,9,1735547029,1735547038,1735547039,-21600,iPhone
com.ridewithvia.UCA.UniversityOfChicagoRider,10,1735547028,1735547038,1735547039,-21600,iPhone
com.ridewithvia.UCA.UniversityOfChicagoRider,8,1735546988,1735546996,1735546997,-21600,iPhone
com.ridewithvia.UCA.UniversityOfChicagoRider,9,1735546903,1735546912,1735546913,-21600,iPhone
com.apple.camera,0,1735546906,1735546906,1735546906,-21600,iPhone
com.apple.camera,0,1735546905,1735546905,1735546906,-21600,iPhone
com.ridewithvia.UCA.UniversityOfChicagoRider,38,1735546864,1735546902,1735546902,-21600,iPhone
com.ridewithvia.UCA.UniversityOfChicagoRider,126,1735546726,1735546852,1735546853,-21600,iPhone
com.zimride.instant,1,1735546725,1735546726,1735546726,-21600,iPhone
com.tencent.xin,5,1735546719,1735546724,1735546725,-21600,iPhone
com.apple.mobiletimer,10,1735546708,1735546718,1735546719,-21600,iPhone
com.apple.mobiletimer,14,1735546694,1735546708,1735546708,-21600,iPhone
com.apple.mobiletimer,1,1735546330,1735546331,1735546332,-21600,iPhone
com.apple.mobiletimer,5,1735546321,1735546326,1735546326,-21600,iPhone
com.apple.mobiletimer,9,1735546311,1735546320,1735546320,-21600,iPhone
com.tencent.xin,1,1735546309,1735546310,1735546311,-21600,iPhone
com.tencent.xin,35,1735546209,1735546244,1735546245,-21600,iPhone
com.bilibili.bilicomic,2,1735546205,1735546207,1735546207,-21600,iPhone
com.tencent.xin,100,1735546102,1735546202,1735546203,-21600,iPhone
com.microsoft.Office.Outlook,7,1735546095,1735546102,1735546103,-21600,iPhone
com.apple.camera,1,1735546058,1735546059,1735546060,-21600,iPhone
com.tencent.xin,6,1735540260,1735540266,1735540267,-21600,iPhone
com.tencent.xin,1,1735538759,1735538760,1735538761,-21600,iPhone
com.tencent.xin,10,1735538749,1735538759,1735538759,-21600,iPhone
com.tencent.xin,3,1735537095,1735537098,1735537098,-21600,iPhone
com.tencent.xin,132,1735536855,1735536987,1735536988,-21600,iPhone
com.apple.Preferences,5,1735536847,1735536852,1735536852,-21600,iPhone
com.apple.Preferences,17,1735536822,1735536839,1735536839,-21600,iPhone
com.apple.camera,0,1735536833,1735536833,1735536833,-21600,iPhone
com.apple.Preferences,33,1735532478,1735532511,1735532511,-21600,iPhone
com.xingin.discover,42,1735532435,1735532477,1735532478,-21600,iPhone
com.google.chrome.ios,2,1735532430,1735532432,1735532433,-21600,iPhone
com.google.chrome.ios,6,1735529299,1735529305,1735529306,-21600,iPhone
com.apple.camera,5,1735529300,1735529305,1735529306,-21600,iPhone
com.google.chrome.ios,1,1735527393,1735527394,1735527395,-21600,iPhone
com.google.chrome.ios,10,1735526666,1735526676,1735526676,-21600,iPhone
com.apple.camera,0,1735526669,1735526669,1735526670,-21600,iPhone
com.google.chrome.ios,33,1735526593,1735526626,1735526627,-21600,iPhone
com.tencent.xin,2,1735526590,1735526592,1735526592,-21600,iPhone
com.apple.PassbookUIService,30,1735525679,1735525709,1735525710,-21600,iPhone
com.apple.camera,7,1735525671,1735525678,1735525678,-21600,iPhone
com.apple.camera,6,1735524045,1735524051,1735524053,-21600,iPhone
com.apple.camera,32,1735523999,1735524031,1735524034,-21600,iPhone
com.tencent.xin,26,1735523968,1735523994,1735523995,-21600,iPhone
com.tencent.xin,26,1735523484,1735523510,1735523510,-21600,iPhone
com.tencent.xin,4,1735523479,1735523483,1735523483,-21600,iPhone
com.apple.PassbookUIService,2,1735523481,1735523483,1735523483,-21600,iPhone
com.apple.camera,1,1735523481,1735523482,1735523482,-21600,iPhone
com.tencent.xin,70,1735523407,1735523477,1735523477,-21600,iPhone
com.tencent.xin,16,1735522851,1735522867,1735522867,-21600,iPhone
com.tencent.xin,42,1735522784,1735522826,1735522827,-21600,iPhone
com.tencent.xin,121,1735522659,1735522780,1735522780,-21600,iPhone
com.tencent.xin,17,1735522604,1735522621,1735522622,-21600,iPhone
com.apple.camera,1,1735522007,1735522008,1735522008,-21600,iPhone
com.apple.camera,1,1735522006,1735522007,1735522007,-21600,iPhone
com.apple.camera,0,1735522006,1735522006,1735522006,-21600,iPhone
com.tencent.xin,7,1735521845,1735521852,1735521852,-21600,iPhone
com.microsoft.Office.Outlook,2,1735521840,1735521842,1735521843,-21600,iPhone
com.microsoft.Office.Outlook,8,1735521513,1735521521,1735521521,-21600,iPhone
com.ridewithvia.UCA.UniversityOfChicagoRider,5,1735521508,1735521513,1735521514,-21600,iPhone
com.apple.camera,0,1735521511,1735521511,1735521511,-21600,iPhone
com.ridewithvia.UCA.UniversityOfChicagoRider,6,1735520217,1735520223,1735520224,-21600,iPhone
com.ridewithvia.UCA.UniversityOfChicagoRider,2,1735520212,1735520214,1735520215,-21600,iPhone
com.ridewithvia.UCA.UniversityOfChicagoRider,6,1735520203,1735520209,1735520209,-21600,iPhone
com.ridewithvia.UCA.UniversityOfChicagoRider,6,1735520196,1735520202,1735520203,-21600,iPhone
com.ridewithvia.UCA.UniversityOfChicagoRider,27,1735520169,1735520196,1735520196,-21600,iPhone
com.apple.PassbookUIService,11,1735520127,1735520138,1735520139,-21600,iPhone
com.ridewithvia.UCA.UniversityOfChicagoRider,28,1735520110,1735520138,1735520139,-21600,iPhone
com.ridewithvia.UCA.UniversityOfChicagoRider,72,1735520029,1735520101,1735520101,-21600,iPhone
com.ridewithvia.UCA.UniversityOfChicagoRider,10,1735519833,1735519843,1735519844,-21600,iPhone
com.ridewithvia.UCA.UniversityOfChicagoRider,1,1735519447,1735519448,1735519448,-21600,iPhone
com.ridewithvia.UCA.UniversityOfChicagoRider,1,1735519440,1735519441,1735519442,-21600,iPhone
com.ridewithvia.UCA.UniversityOfChicagoRider,1,1735519426,1735519427,1735519427,-21600,iPhone
com.ridewithvia.UCA.UniversityOfChicagoRider,6,1735519298,1735519304,1735519305,-21600,iPhone
com.apple.camera,1,1735519298,1735519299,1735519299,-21600,iPhone
com.ridewithvia.UCA.UniversityOfChicagoRider,2,1735519289,1735519291,1735519292,-21600,iPhone
com.ridewithvia.UCA.UniversityOfChicagoRider,11,1735519196,1735519207,1735519208,-21600,iPhone
com.ridewithvia.UCA.UniversityOfChicagoRider,8,1735519075,1735519083,1735519084,-21600,iPhone
com.ridewithvia.UCA.UniversityOfChicagoRider,33,1735519036,1735519069,1735519070,-21600,iPhone
com.ridewithvia.UCA.UniversityOfChicagoRider,8,1735518941,1735518949,1735518950,-21600,iPhone
com.ridewithvia.UCA.UniversityOfChicagoRider,30,1735518880,1735518910,1735518910,-21600,iPhone
com.ridewithvia.UCA.UniversityOfChicagoRider,12,1735518796,1735518808,1735518809,-21600,iPhone
com.ridewithvia.UCA.UniversityOfChicagoRider,11,1735518753,1735518764,1735518765,-21600,iPhone
com.ridewithvia.UCA.UniversityOfChicagoRider,5,1735518737,1735518742,1735518743,-21600,iPhone
com.google.chrome.ios,6,1735518731,1735518737,1735518739,-21600,iPhone
com.google.chrome.ios,21,1735518701,1735518722,1735518723,-21600,iPhone
com.google.chrome.ios,29,1735518610,1735518639,1735518640,-21600,iPhone
com.tencent.xin,1,1735518608,1735518609,1735518610,-21600,iPhone
com.ridewithvia.UCA.UniversityOfChicagoRider,3,1735518605,1735518608,1735518609,-21600,iPhone
com.ridewithvia.UCA.UniversityOfChicagoRider,1,1735518603,1735518604,1735518604,-21600,iPhone
com.ridewithvia.UCA.UniversityOfChicagoRider,36,1735518529,1735518565,1735518565,-21600,iPhone
com.ridewithvia.UCA.UniversityOfChicagoRider,50,1735518252,1735518302,1735518303,-21600,iPhone
com.microsoft.Office.Outlook,7,1735518020,1735518027,1735518028,-21600,iPhone
com.microsoft.Office.Outlook,4,1735517901,1735517905,1735517906,-21600,iPhone
com.xingin.discover,3,1735517893,1735517896,1735517897,-21600,iPhone
com.xingin.discover,6,1735517764,1735517770,1735517771,-21600,iPhone
com.xingin.discover,17,1735517403,1735517420,1735517420,-21600,iPhone
com.tencent.xin,11,1735517392,1735517403,1735517404,-21600,iPhone
com.xingin.discover,60,1735517332,1735517392,1735517392,-21600,iPhone
com.tencent.xin,21,1735517311,1735517332,1735517333,-21600,iPhone
com.apple.camera,17,1735517290,1735517307,1735517308,-21600,iPhone
com.google.Maps,8,1735517281,1735517289,1735517290,-21600,iPhone
com.tencent.xin,20,1735517261,1735517281,1735517282,-21600,iPhone
com.tencent.xin,16,1735517245,1735517261,1735517262,-21600,iPhone
com.apple.camera,0,1735517241,1735517241,1735517255,-21600,iPhone
com.apple.camera,25,1735517209,1735517234,1735517253,-21600,iPhone
com.tencent.xin,15,1735517193,1735517208,1735517209,-21600,iPhone
com.google.Maps,17,1735517176,1735517193,1735517194,-21600,iPhone
com.tencent.xin,2,1735517172,1735517174,1735517175,-21600,iPhone
com.xingin.discover,28,1735517144,1735517172,1735517172,-21600,iPhone
com.xingin.discover,38,1735517102,1735517140,1735517141,-21600,iPhone
com.tencent.xin,2,1735517100,1735517102,1735517103,-21600,iPhone
com.google.Maps,6,1735517094,1735517100,1735517101,-21600,iPhone
com.tencent.xin,15,1735517079,1735517094,1735517095,-21600,iPhone
com.tencent.xin,10,1735517055,1735517065,1735517065,-21600,iPhone
com.google.Maps,12,1735517043,1735517055,1735517055,-21600,iPhone
com.tencent.xin,11,1735517032,1735517043,1735517043,-21600,iPhone
com.xingin.discover,2,1735517030,1735517032,1735517033,-21600,iPhone
com.xingin.discover,68,1735516935,1735517003,1735517004,-21600,iPhone
com.tencent.xin,12,1735516923,1735516935,1735516935,-21600,iPhone
com.xingin.discover,1,1735516922,1735516923,1735516924,-21600,iPhone
com.tencent.xin,59,1735516861,1735516920,1735516920,-21600,iPhone
com.microsoft.Office.Outlook,7,1735516854,1735516861,1735516861,-21600,iPhone
com.tencent.xin,1,1735516853,1735516854,1735516855,-21600,iPhone
com.ridewithvia.UCA.UniversityOfChicagoRider,6,1735516847,1735516853,1735516854,-21600,iPhone
com.tencent.xin,34,1735516813,1735516847,1735516848,-21600,iPhone
com.tencent.xin,8,1735516802,1735516810,1735516811,-21600,iPhone
com.ridewithvia.UCA.UniversityOfChicagoRider,13,1735516788,1735516801,1735516801,-21600,iPhone
com.ridewithvia.UCA.UniversityOfChicagoRider,13,1735516701,1735516714,1735516715,-21600,iPhone
com.ridewithvia.UCA.UniversityOfChicagoRider,5,1735516548,1735516553,1735516554,-21600,iPhone
com.tencent.xin,14,1735516534,1735516548,1735516549,-21600,iPhone
com.tencent.xin,6,1735516517,1735516523,1735516524,-21600,iPhone
com.ridewithvia.UCA.UniversityOfChicagoRider,12,1735516505,1735516517,1735516518,-21600,iPhone
com.ridewithvia.UCA.UniversityOfChicagoRider,8,1735516492,1735516500,1735516501,-21600,iPhone
com.ridewithvia.UCA.UniversityOfChicagoRider,20,1735516471,1735516491,1735516491,-21600,iPhone
com.apple.PassbookUIService,32,1735516424,1735516456,1735516457,-21600,iPhone
com.ridewithvia.UCA.UniversityOfChicagoRider,32,1735516424,1735516456,1735516457,-21600,iPhone
com.ridewithvia.UCA.UniversityOfChicagoRider,6,1735516413,1735516419,1735516419,-21600,iPhone
com.ridewithvia.UCA.UniversityOfChicagoRider,10,1735516339,1735516349,1735516350,-21600,iPhone
com.ridewithvia.UCA.UniversityOfChicagoRider,2,1735516337,1735516339,1735516339,-21600,iPhone
com.ridewithvia.UCA.UniversityOfChicagoRider,7,1735516308,1735516315,1735516315,-21600,iPhone
com.microsoft.Office.Outlook,15,1735516293,1735516308,1735516308,-21600,iPhone
com.tencent.xin,2,1735516291,1735516293,1735516293,-21600,iPhone
com.ridewithvia.UCA.UniversityOfChicagoRider,12,1735516277,1735516289,1735516290,-21600,iPhone
com.ubercab.UberClient,2,1735516274,1735516276,1735516277,-21600,iPhone
com.ridewithvia.UCA.UniversityOfChicagoRider,46,1735516228,1735516274,1735516275,-21600,iPhone
com.ridewithvia.UCA.UniversityOfChicagoRider,1,1735516226,1735516227,1735516228,-21600,iPhone
com.ridewithvia.UCA.UniversityOfChicagoRider,14,1735516208,1735516222,1735516223,-21600,iPhone
com.zimride.instant,5,1735516203,1735516208,1735516209,-21600,iPhone
com.tencent.xin,47,1735516155,1735516202,1735516203,-21600,iPhone
com.zimride.instant,8,1735516147,1735516155,1735516156,-21600,iPhone
com.ridewithvia.UCA.UniversityOfChicagoRider,22,1735516125,1735516147,1735516148,-21600,iPhone
com.fobwifi.fobwifi,11,1735516114,1735516125,1735516125,-21600,iPhone
com.ridewithvia.UCA.UniversityOfChicagoRider,14,1735516099,1735516113,1735516113,-21600,iPhone
com.zimride.instant,2,1735516097,1735516099,1735516100,-21600,iPhone
com.tencent.xin,1,1735516096,1735516097,1735516098,-21600,iPhone
com.zimride.instant,47,1735516049,1735516096,1735516096,-21600,iPhone
com.tencent.xin,33,1735516016,1735516049,1735516050,-21600,iPhone
com.zimride.instant,2,1735516013,1735516015,1735516016,-21600,iPhone
com.ridewithvia.UCA.UniversityOfChicagoRider,15,1735515998,1735516013,1735516014,-21600,iPhone
com.zimride.instant,8,1735515990,1735515998,1735515999,-21600,iPhone
com.ubercab.UberClient,12,1735515978,1735515990,1735515991,-21600,iPhone
com.zimride.instant,2,1735515976,1735515978,1735515978,-21600,iPhone
com.ubercab.UberClient,3,1735515973,1735515976,1735515977,-21600,iPhone
com.ridewithvia.UCA.UniversityOfChicagoRider,4,1735515968,1735515972,1735515973,-21600,iPhone
com.ridewithvia.UCA.UniversityOfChicagoRider,87,1735515881,1735515968,1735515969,-21600,iPhone
com.ridewithvia.UCA.UniversityOfChicagoRider,5,1735515873,1735515878,1735515878,-21600,iPhone
com.google.Maps,2,1735515739,1735515741,1735515741,-21600,iPhone
com.ridewithvia.UCA.UniversityOfChicagoRider,2,1735515737,1735515739,1735515740,-21600,iPhone
com.ridewithvia.UCA.UniversityOfChicagoRider,4,1735515650,1735515654,1735515655,-21600,iPhone
com.apple.PassbookUIService,1,1735515648,1735515649,1735515650,-21600,iPhone
com.ridewithvia.UCA.UniversityOfChicagoRider,2,1735515647,1735515649,1735515650,-21600,iPhone
com.ridewithvia.UCA.UniversityOfChicagoRider,6,1735515612,1735515618,1735515618,-21600,iPhone
com.ridewithvia.UCA.UniversityOfChicagoRider,3,1735515394,1735515397,1735515398,-21600,iPhone
com.tencent.xin,5,1735515388,1735515393,1735515394,-21600,iPhone
com.tencent.xin,10,1735515203,1735515213,1735515214,-21600,iPhone
com.ridewithvia.UCA.UniversityOfChicagoRider,25,1735515178,1735515203,1735515204,-21600,iPhone
com.google.Maps,11,1735515167,1735515178,1735515179,-21600,iPhone
com.ridewithvia.UCA.UniversityOfChicagoRider,11,1735515155,1735515166,1735515166,-21600,iPhone
com.tencent.xin,22,1735515133,1735515155,1735515155,-21600,iPhone
com.tencent.xin,36,1735514915,1735514951,1735514952,-21600,iPhone
com.ridewithvia.UCA.UniversityOfChicagoRider,4,1735514910,1735514914,1735514915,-21600,iPhone
com.netease.cloudmusic,2,1735514906,1735514908,1735514909,-21600,iPhone
com.netease.cloudmusic,4,1735514489,1735514493,1735514493,-21600,iPhone
com.netease.cloudmusic,12,1735513804,1735513816,1735513817,-21600,iPhone
com.apple.Preferences,12,1735513792,1735513804,1735513804,-21600,iPhone
com.tencent.xin,1,1735513791,1735513792,1735513793,-21600,iPhone
com.netease.cloudmusic,1,1735513790,1735513791,1735513791,-21600,iPhone
com.tencent.xin,10,1735513778,1735513788,1735513788,-21600,iPhone
com.apple.Preferences,7,1735513770,1735513777,1735513778,-21600,iPhone
com.apple.mobiletimer,22,1735513748,1735513770,1735513770,-21600,iPhone
com.apple.mobiletimer,37,1735513692,1735513729,1735513729,-21600,iPhone
com.tencent.xin,12,1735513680,1735513692,1735513692,-21600,iPhone
com.tencent.xin,3,1735513585,1735513588,1735513589,-21600,iPhone
com.xingin.discover,243,1735513342,1735513585,1735513585,-21600,iPhone
com.tencent.xin,10,1735513332,1735513342,1735513342,-21600,iPhone
com.xingin.discover,19,1735513312,1735513331,1735513331,-21600,iPhone
com.xingin.discover,580,1735512732,1735513312,1735513312,-21600,iPhone
com.apple.CoreAuthUI,2,1735512726,1735512728,1735512729,-21600,iPhone
com.apple.mobiletimer,5,1735512108,1735512113,1735512114,-21600,iPhone
com.xingin.discover,3,1735512104,1735512107,1735512108,-21600,iPhone
com.apple.mobilecal,3,1735512100,1735512103,1735512104,-21600,iPhone
com.tencent.xin,2,1735512097,1735512099,1735512100,-21600,iPhone
com.tencent.xin,18,1735512068,1735512086,1735512087,-21600,iPhone
com.tencent.xin,10,1735512052,1735512062,1735512062,-21600,iPhone
com.tencent.xin,67,1735511948,1735512015,1735512016,-21600,iPhone
com.tencent.xin,13,1735511648,1735511661,1735511662,-21600,iPhone
com.apple.mobiletimer,4,1735511644,1735511648,1735511649,-21600,iPhone
com.tencent.xin,45,1735511598,1735511643,1735511644,-21600,iPhone
com.tencent.xin,93,1735511331,1735511424,1735511424,-21600,iPhone
com.apple.mobiletimer,26,1735510080,1735510106,1735510106,-21600,iPhone
com.apple.mobiletimer,1,1735508417,1735508418,1735508418,-21600,iPhone
com.apple.mobiletimer,10,1735507619,1735507629,1735507629,-21600,iPhone
com.apple.mobilecal,1,1735507618,1735507619,1735507620,-21600,iPhone
com.apple.weather,5,1735507612,1735507617,1735507618,-21600,iPhone
com.xingin.discover,9,1735507601,1735507610,1735507610,-21600,iPhone
com.xingin.discover,6,1735507289,1735507295,1735507296,-21600,iPhone
com.xingin.discover,3,1735507285,1735507288,1735507289,-21600,iPhone
com.xingin.discover,14,1735506481,1735506495,1735506496,-21600,iPhone
com.xingin.discover,2,1735505027,1735505029,1735505029,-21600,iPhone
com.xingin.discover,22,1735504174,1735504196,1735504196,-21600,iPhone
com.xingin.discover,21,1735504138,1735504159,1735504160,-21600,iPhone
com.xingin.discover,4,1735504132,1735504136,1735504136,-21600,iPhone
com.xingin.discover,1,1735504131,1735504132,1735504132,-21600,iPhone
com.xingin.discover,677,1735503184,1735503861,1735503862,-21600,iPhone
com.xingin.discover,70,1735503113,1735503183,1735503184,-21600,iPhone
com.apple.mobiletimer,11,1735503101,1735503112,1735503113,-21600,iPhone
com.apple.mobiletimer,4,1735503071,1735503075,1735503076,-21600,iPhone
com.microsoft.Office.Outlook,8,1735503061,1735503069,1735503070,-21600,iPhone
com.google.chrome.ios,2,1735503058,1735503060,1735503060,-21600,iPhone
com.xingin.discover,4,1735503054,1735503058,1735503058,-21600,iPhone
com.xingin.discover,29,1735502421,1735502450,1735502451,-21600,iPhone
com.google.chrome.ios,15,1735502406,1735502421,1735502422,-21600,iPhone
com.xingin.discover,17,1735502389,1735502406,1735502406,-21600,iPhone
com.google.chrome.ios,20,1735502368,1735502388,1735502389,-21600,iPhone
com.tencent.xin,4,1735502364,1735502368,1735502368,-21600,iPhone
com.microsoft.Office.Outlook,11,1735502351,1735502362,1735502363,-21600,iPhone
com.google.chrome.ios,2,1735502349,1735502351,1735502352,-21600,iPhone
com.google.chrome.ios,33,1735502234,1735502267,1735502268,-21600,iPhone
com.microsoft.Office.Outlook,17,1735502217,1735502234,1735502235,-21600,iPhone
com.google.chrome.ios,56,1735502161,1735502217,1735502217,-21600,iPhone
com.apple.CoreAuthUI,2,1735502205,1735502207,1735502207,-21600,iPhone
com.apple.mobilenotes,23,1735502138,1735502161,1735502161,-21600,iPhone
com.google.chrome.ios,24,1735502111,1735502135,1735502136,-21600,iPhone
com.google.chrome.ios,24,1735502086,1735502110,1735502111,-21600,iPhone
com.tencent.xin,2,1735502084,1735502086,1735502087,-21600,iPhone
com.microsoft.Office.Outlook,8,1735502076,1735502084,1735502085,-21600,iPhone
com.tencent.xin,1,1735502075,1735502076,1735502077,-21600,iPhone
com.microsoft.Office.Outlook,1,1735502074,1735502075,1735502076,-21600,iPhone
com.google.chrome.ios,94,1735501979,1735502073,1735502074,-21600,iPhone
com.apple.AuthKitUIService,4,1735502004,1735502008,1735502009,-21600,iPhone
com.apple.PassbookUIService,2,1735502001,1735502003,1735502003,-21600,iPhone
com.apple.AuthKitUIService,6,1735501994,1735502000,1735502001,-21600,iPhone
com.xingin.discover,30,1735501949,1735501979,1735501979,-21600,iPhone
com.xingin.discover,62,1735501854,1735501916,1735501917,-21600,iPhone
com.google.chrome.ios,10,1735501844,1735501854,1735501854,-21600,iPhone
com.xingin.discover,62,1735501782,1735501844,1735501844,-21600,iPhone
com.tencent.xin,175,1735501607,1735501782,1735501783,-21600,iPhone
com.microsoft.Office.Outlook,10,1735501597,1735501607,1735501607,-21600,iPhone
com.tencent.xin,1,1735501596,1735501597,1735501597,-21600,iPhone
com.microsoft.Office.Outlook,2,1735501594,1735501596,1735501596,-21600,iPhone
com.microsoft.Office.Outlook,4,1735501586,1735501590,1735501590,-21600,iPhone
com.tencent.xin,22,1735501530,1735501552,1735501552,-21600,iPhone
com.tencent.xin,39,1735501472,1735501511,1735501511,-21600,iPhone
com.tencent.xin,24,1735501445,1735501469,1735501470,-21600,iPhone
com.tencent.xin,298,1735501139,1735501437,1735501438,-21600,iPhone
com.tencent.xin,42,1735501053,1735501095,1735501096,-21600,iPhone
com.google.chrome.ios,6,1735501047,1735501053,1735501054,-21600,iPhone
com.tencent.xin,12,1735501035,1735501047,1735501047,-21600,iPhone
com.google.chrome.ios,5,1735501030,1735501035,1735501035,-21600,iPhone
com.tencent.xin,30,1735501000,1735501030,1735501030,-21600,iPhone
com.google.chrome.ios,3,1735500997,1735501000,1735501001,-21600,iPhone
com.apple.mobilesafari,1,1735500996,1735500997,1735500998,-21600,iPhone
com.tencent.xin,23,1735500972,1735500995,1735500996,-21600,iPhone
com.tencent.xin,290,1735500675,1735500965,1735500966,-21600,iPhone
com.tencent.xin,292,1735500381,1735500673,1735500674,-21600,iPhone
com.google.chrome.ios,8,1735500373,1735500381,1735500381,-21600,iPhone
com.tencent.xin,3,1735500369,1735500372,1735500373,-21600,iPhone
com.tencent.xin,235,1735500134,1735500369,1735500370,-21600,iPhone
com.google.chrome.ios,25,1735500109,1735500134,1735500135,-21600,iPhone
com.tencent.xin,9,1735500100,1735500109,1735500109,-21600,iPhone
com.google.chrome.ios,10,1735500090,1735500100,1735500101,-21600,iPhone
com.tencent.xin,59,1735500030,1735500089,1735500090,-21600,iPhone
com.tencent.xin,287,1735499734,1735500021,1735500023,-21600,iPhone
com.tencent.xin,171,1735499562,1735499733,1735499733,-21600,iPhone
com.google.chrome.ios,12,1735499550,1735499562,1735499563,-21600,iPhone
com.tencent.xin,2,1735499546,1735499548,1735499548,-21600,iPhone
com.microsoft.Office.Outlook,2,1735499544,1735499546,1735499546,-21600,iPhone
com.tencent.xin,1,1735499543,1735499544,1735499545,-21600,iPhone
com.apple.mobilesafari,10,1735499531,1735499541,1735499542,-21600,iPhone
com.apple.mobilesafari,2205,1735470533,1735472738,1735472739,-21600,iPhone
com.apple.mobilesafari,10,1735470522,1735470532,1735470533,-21600,iPhone
com.bilibili.bilicomic,1,1735470519,1735470520,1735470521,-21600,iPhone
com.tencent.xin,6,1735470510,1735470516,1735470516,-21600,iPhone
com.apple.mobiletimer,17,1735470493,1735470510,1735470510,-21600,iPhone
com.apple.Preferences,8,1735470478,1735470486,1735470486,-21600,iPhone
com.xingin.discover,6,1735470468,1735470474,1735470475,-21600,iPhone
com.xingin.discover,46,1735469477,1735469523,1735469524,-21600,iPhone
com.xingin.discover,49,1735469025,1735469074,1735469074,-21600,iPhone
com.tencent.xin,5,1735469020,1735469025,1735469025,-21600,iPhone
com.chase,33,1735468987,1735469020,1735469020,-21600,iPhone
com.apple.CoreAuthUI,23,1735468989,1735469012,1735469012,-21600,iPhone
com.tencent.xin,14,1735468972,1735468986,1735468986,-21600,iPhone
com.apple.AppStore,1,1735468968,1735468969,1735468970,-21600,iPhone
com.xingin.discover,8,1735468959,1735468967,1735468968,-21600,iPhone
com.xingin.discover,2,1735468954,1735468956,1735468957,-21600,iPhone
com.xingin.discover,34,1735466584,1735466618,1735466619,-21600,iPhone
com.xingin.discover,13,1735466445,1735466458,1735466459,-21600,iPhone
com.xingin.discover,16,1735466364,1735466380,1735466380,-21600,iPhone
com.xingin.discover,15,1735466333,1735466348,1735466348,-21600,iPhone
com.xingin.discover,25,1735466139,1735466164,1735466164,-21600,iPhone
com.xingin.discover,0,1735466138,1735466138,1735466139,-21600,iPhone
com.xingin.discover,18,1735464482,1735464500,1735464501,-21600,iPhone
com.xingin.discover,11,1735464448,1735464459,1735464460,-21600,iPhone
com.xingin.discover,71,1735464323,1735464394,1735464394,-21600,iPhone
com.xingin.discover,154,1735463278,1735463432,1735463433,-21600,iPhone
com.tencent.xin,33,1735463245,1735463278,1735463279,-21600,iPhone
com.xingin.discover,2,1735463241,1735463243,1735463244,-21600,iPhone
com.tencent.xin,6,1735463235,1735463241,1735463241,-21600,iPhone
com.xingin.discover,469,1735462766,1735463235,1735463235,-21600,iPhone
com.xingin.discover,104,1735461365,1735461469,1735461470,-21600,iPhone
com.xingin.discover,36,1735460210,1735460246,1735460246,-21600,iPhone
com.xingin.discover,5,1735459638,1735459643,1735459643,-21600,iPhone
com.xingin.discover,11,1735459588,1735459599,1735459599,-21600,iPhone
com.xingin.discover,445,1735458722,1735459167,1735459167,-21600,iPhone
com.xingin.discover,6,1735458290,1735458296,1735458297,-21600,iPhone
com.xingin.discover,11,1735456028,1735456039,1735456040,-21600,iPhone
com.xingin.discover,8,1735456011,1735456019,1735456020,-21600,iPhone
com.xingin.discover,116,1735455894,1735456010,1735456011,-21600,iPhone
com.xingin.discover,1,1735454831,1735454832,1735454833,-21600,iPhone
com.xingin.discover,1,1735454781,1735454782,1735454783,-21600,iPhone
com.xingin.discover,336,1735454396,1735454732,1735454732,-21600,iPhone
com.xingin.discover,401,1735453972,1735454373,1735454374,-21600,iPhone
com.xingin.discover,326,1735452090,1735452416,1735452417,-21600,iPhone
com.xingin.discover,1,1735451680,1735451681,1735451682,-21600,iPhone
com.xingin.discover,674,1735450853,1735451527,1735451528,-21600,iPhone
com.xingin.discover,68,1735450331,1735450399,1735450400,-21600,iPhone
com.xingin.discover,158,1735449180,1735449338,1735449339,-21600,iPhone
com.tencent.xin,45,1735449133,1735449178,1735449178,-21600,iPhone
com.xingin.discover,5,1735449128,1735449133,1735449134,-21600,iPhone
com.xingin.discover,113,1735446256,1735446369,1735446370,-21600,iPhone
com.xingin.discover,654,1735445222,1735445876,1735445877,-21600,iPhone
com.xingin.discover,44,1735445011,1735445055,1735445055,-21600,iPhone
com.xingin.discover,3,1735444161,1735444164,1735444165,-21600,iPhone
com.xingin.discover,19,1735444141,1735444160,1735444161,-21600,iPhone
com.xingin.discover,41,1735444094,1735444135,1735444135,-21600,iPhone
com.xingin.discover,4,1735442694,1735442698,1735442698,-21600,iPhone
com.xingin.discover,9,1735442682,1735442691,1735442692,-21600,iPhone
com.xingin.discover,11,1735442670,1735442681,1735442682,-21600,iPhone
com.xingin.discover,5,1735442636,1735442641,1735442642,-21600,iPhone
com.xingin.discover,189,1735442446,1735442635,1735442636,-21600,iPhone
com.xingin.discover,1,1735442374,1735442375,1735442375,-21600,iPhone
com.xingin.discover,2,1735442348,1735442350,1735442350,-21600,iPhone
com.xingin.discover,132,1735442160,1735442292,1735442293,-21600,iPhone
com.xingin.discover,28,1735441984,1735442012,1735442013,-21600,iPhone
com.xingin.discover,241,1735440886,1735441127,1735441128,-21600,iPhone
com.xingin.discover,67,1735440760,1735440827,1735440828,-21600,iPhone
com.xingin.discover,15,1735440743,1735440758,1735440759,-21600,iPhone
com.xingin.discover,159,1735440280,1735440439,1735440440,-21600,iPhone
com.xingin.discover,10,1735439911,1735439921,1735439922,-21600,iPhone
com.xingin.discover,10,1735439900,1735439910,1735439910,-21600,iPhone
com.xingin.discover,25,1735439848,1735439873,1735439874,-21600,iPhone
com.xingin.discover,30,1735439814,1735439844,1735439845,-21600,iPhone
com.xingin.discover,6,1735439539,1735439545,1735439546,-21600,iPhone
com.xingin.discover,83,1735439452,1735439535,1735439535,-21600,iPhone
com.xingin.discover,29,1735439158,1735439187,1735439188,-21600,iPhone
com.xingin.discover,10,1735438909,1735438919,1735438920,-21600,iPhone
com.xingin.discover,134,1735438172,1735438306,1735438307,-21600,iPhone
com.discoverfinancial.mobile,2,1735438169,1735438171,1735438172,-21600,iPhone
com.tencent.xin,2,1735438167,1735438169,1735438170,-21600,iPhone
com.apple.camera,0,1735438167,1735438167,1735438168,-21600,iPhone
com.tencent.xin,8,1735437899,1735437907,1735437908,-21600,iPhone
com.tencent.xin,8,1735437890,1735437898,1735437898,-21600,iPhone
com.tencent.xin,30,1735437858,1735437888,1735437889,-21600,iPhone
com.discoverfinancial.mobile,20,1735437838,1735437858,1735437859,-21600,iPhone
com.apple.CoreAuthUI,3,1735437841,1735437844,1735437845,-21600,iPhone
com.tencent.xin,8,1735437830,1735437838,1735437838,-21600,iPhone
com.discoverfinancial.mobile,2,1735437828,1735437830,1735437832,-21600,iPhone
com.tencent.xin,2,1735437824,1735437826,1735437826,-21600,iPhone
com.google.chrome.ios,4,1735437819,1735437823,1735437824,-21600,iPhone
com.microsoft.Office.Outlook,5,1735437814,1735437819,1735437820,-21600,iPhone
com.xingin.discover,4,1735437810,1735437814,1735437815,-21600,iPhone
com.xingin.discover,35,1735437249,1735437284,1735437284,-21600,iPhone
com.xingin.discover,8,1735436860,1735436868,1735436869,-21600,iPhone
com.apple.camera,1,1735436861,1735436862,1735436862,-21600,iPhone
com.xingin.discover,23,1735436618,1735436641,1735436642,-21600,iPhone
com.tencent.xin,2,1735436616,1735436618,1735436618,-21600,iPhone
tv.danmaku.bilianime,3,1735436613,1735436616,1735436616,-21600,iPhone
com.tencent.xin,28,1735436583,1735436611,1735436611,-21600,iPhone
com.xingin.discover,4,1735436579,1735436583,1735436584,-21600,iPhone
com.xingin.discover,10,1735436394,1735436404,1735436405,-21600,iPhone
com.xingin.discover,143,1735435633,1735435776,1735435777,-21600,iPhone
com.microsoft.Office.Outlook,6,1735435279,1735435285,1735435286,-21600,iPhone
com.xingin.discover,5,1735435274,1735435279,1735435280,-21600,iPhone
com.xingin.discover,173,1735435081,1735435254,1735435255,-21600,iPhone
com.apple.camera,0,1735435084,1735435084,1735435084,-21600,iPhone
com.apple.camera,0,1735435083,1735435083,1735435084,-21600,iPhone
com.apple.camera,0,1735435082,1735435082,1735435082,-21600,iPhone
com.xingin.discover,32,1735434164,1735434196,1735434196,-21600,iPhone
com.xingin.discover,1545,1735432594,1735434139,1735434140,-21600,iPhone
com.tencent.xin,48,1735432545,1735432593,1735432593,-21600,iPhone
com.microsoft.Office.Outlook,6,1735432539,1735432545,1735432545,-21600,iPhone
com.tencent.xin,0,1735432539,1735432539,1735432540,-21600,iPhone
com.tencent.xin,15,1735432522,1735432537,1735432538,-21600,iPhone
com.openai.chat,22,1735432498,1735432520,1735432520,-21600,iPhone
com.apple.mobiletimer,2,1735432494,1735432496,1735432497,-21600,iPhone
com.tencent.xin,2,1735432492,1735432494,1735432494,-21600,iPhone
com.apple.mobiletimer,9,1735432483,1735432492,1735432493,-21600,iPhone
com.tencent.xin,10,1735432472,1735432482,1735432483,-21600,iPhone
com.tencent.xin,18,1735432424,1735432442,1735432442,-21600,iPhone
com.tencent.xin,10,1735431860,1735431870,1735431871,-21600,iPhone
com.tencent.xin,10,1735431848,1735431858,1735431859,-21600,iPhone
com.tencent.xin,10,1735431833,1735431843,1735431844,-21600,iPhone
com.tencent.xin,10,1735431819,1735431829,1735431830,-21600,iPhone
com.tencent.xin,9,1735431796,1735431805,1735431806,-21600,iPhone
com.tencent.xin,6,1735430410,1735430416,1735430416,-21600,iPhone
com.tencent.xin,10,1735429650,1735429660,1735429661,-21600,iPhone
com.tencent.xin,10,1735429280,1735429290,1735429291,-21600,iPhone
com.tencent.xin,1,1735429153,1735429154,1735429154,-21600,iPhone
com.tencent.xin,2,1735429145,1735429147,1735429147,-21600,iPhone
com.tencent.xin,1,1735429143,1735429144,1735429145,-21600,iPhone
com.tencent.xin,28,1735429108,1735429136,1735429137,-21600,iPhone
com.xingin.discover,4,1735429104,1735429108,1735429109,-21600,iPhone
com.xingin.discover,65,1735424398,1735424463,1735424463,-21600,iPhone
com.apple.camera,1,1735424398,1735424399,1735424399,-21600,iPhone
com.xingin.discover,90,1735424255,1735424345,1735424345,-21600,iPhone
com.xingin.discover,5,1735422517,1735422522,1735422522,-21600,iPhone
com.xingin.discover,133,1735422375,1735422508,1735422508,-21600,iPhone
com.xingin.discover,507,1735421794,1735422301,1735422302,-21600,iPhone
com.apple.mobiletimer,2,1735421792,1735421794,1735421794,-21600,iPhone
com.xingin.discover,489,1735421303,1735421792,1735421792,-21600,iPhone
com.xingin.discover,4,1735421295,1735421299,1735421299,-21600,iPhone
com.xingin.discover,3,1735421107,1735421110,1735421110,-21600,iPhone
com.xingin.discover,228,1735420180,1735420408,1735420408,-21600,iPhone
com.tencent.xin,31,1735420147,1735420178,1735420179,-21600,iPhone
com.tencent.xin,31,1735419614,1735419645,1735419645,-21600,iPhone
com.apple.camera,2,1735419606,1735419608,1735419608,-21600,iPhone
com.tencent.xin,6,1735418688,1735418694,1735418694,-21600,iPhone
com.tencent.xin,15,1735418227,1735418242,1735418243,-21600,iPhone
com.apple.mobiletimer,2,1735418225,1735418227,1735418227,-21600,iPhone
com.apple.mobiletimer,10,1735418182,1735418192,1735418192,-21600,iPhone
com.tencent.xin,4,1735418177,1735418181,1735418182,-21600,iPhone
com.tencent.xin,270,1735417906,1735418176,1735418177,-21600,iPhone
com.microsoft.Office.Outlook,9,1735417896,1735417905,1735417906,-21600,iPhone
com.tencent.xin,208,1735417687,1735417895,1735417896,-21600,iPhone
com.google.calendar,4,1735417683,1735417687,1735417688,-21600,iPhone
com.tencent.xin,137,1735417546,1735417683,1735417684,-21600,iPhone
com.chase,28,1735417518,1735417546,1735417546,-21600,iPhone
com.apple.CoreAuthUI,3,1735417523,1735417526,1735417527,-21600,iPhone
com.tencent.xin,24,1735417491,1735417515,1735417516,-21600,iPhone
com.tencent.xin,3,1735417487,1735417490,1735417490,-21600,iPhone
com.tencent.xin,119,1735417327,1735417446,1735417447,-21600,iPhone
com.google.calendar,62,1735417265,1735417327,1735417328,-21600,iPhone
com.tencent.xin,25,1735417240,1735417265,1735417266,-21600,iPhone
com.google.calendar,3,1735417237,1735417240,1735417240,-21600,iPhone
com.tencent.xin,1,1735417236,1735417237,1735417238,-21600,iPhone
com.tencent.xin,7,1735417227,1735417234,1735417235,-21600,iPhone
com.google.calendar,7,1735417220,1735417227,1735417227,-21600,iPhone
com.tencent.xin,66,1735417153,1735417219,1735417219,-21600,iPhone
com.zimride.instant,15,1735417138,1735417153,1735417153,-21600,iPhone
com.ubercab.UberClient,5,1735417133,1735417138,1735417139,-21600,iPhone
com.zimride.instant,1,1735417132,1735417133,1735417134,-21600,iPhone
com.ubercab.UberClient,3,1735417129,1735417132,1735417132,-21600,iPhone
com.zimride.instant,3,1735417126,1735417129,1735417129,-21600,iPhone
com.ubercab.UberClient,4,1735417119,1735417123,1735417123,-21600,iPhone
com.tencent.xin,5,1735417114,1735417119,1735417120,-21600,iPhone
com.ubercab.UberClient,21,1735417093,1735417114,1735417114,-21600,iPhone
com.tencent.xin,9,1735417084,1735417093,1735417093,-21600,iPhone
com.ubercab.UberClient,3,1735417081,1735417084,1735417085,-21600,iPhone
com.tencent.xin,24,1735417057,1735417081,1735417082,-21600,iPhone
com.ubercab.UberClient,2,1735417053,1735417055,1735417056,-21600,iPhone
com.tencent.xin,223,1735416827,1735417050,1735417051,-21600,iPhone
com.google.chrome.ios,5,1735416822,1735416827,1735416828,-21600,iPhone
com.apple.Preferences,9,1735416813,1735416822,1735416823,-21600,iPhone
com.google.chrome.ios,21,1735416791,1735416812,1735416813,-21600,iPhone
com.tencent.xin,26,1735416763,1735416789,1735416790,-21600,iPhone
com.discoverfinancial.mobile,12,1735416751,1735416763,1735416764,-21600,iPhone
com.apple.CoreAuthUI,2,1735416754,1735416756,1735416757,-21600,iPhone
com.tencent.xin,14,1735416737,1735416751,1735416752,-21600,iPhone
com.discoverfinancial.mobile,1,1735416736,1735416737,1735416738,-21600,iPhone
com.tencent.xin,13,1735416723,1735416736,1735416737,-21600,iPhone
com.xingin.discover,5,1735416718,1735416723,1735416725,-21600,iPhone
com.xingin.discover,22,1735412624,1735412646,1735412647,-21600,iPhone
com.xingin.discover,1,1735412622,1735412623,1735412624,-21600,iPhone
com.xingin.discover,427,1735388365,1735388792,1735388793,-21600,iPhone
com.tencent.xin,64,1735388297,1735388361,1735388361,-21600,iPhone
com.microsoft.Office.Outlook,3,1735388292,1735388295,1735388296,-21600,iPhone
com.xingin.discover,17,1735388275,1735388292,1735388293,-21600,iPhone
com.tencent.xin,123,1735388152,1735388275,1735388275,-21600,iPhone
com.discoverfinancial.mobile,28,1735388123,1735388151,1735388152,-21600,iPhone
com.discoverfinancial.mobile,15,1735388107,1735388122,1735388123,-21600,iPhone
com.apple.CoreAuthUI,4,1735388112,1735388116,1735388117,-21600,iPhone
com.apple.MobileSMS,5,1735388101,1735388106,1735388106,-21600,iPhone
com.tencent.xin,13,1735381634,1735381647,1735381648,-21600,iPhone
com.xingin.discover,6,1735381628,1735381634,1735381635,-21600,iPhone
com.xingin.discover,10,1735380687,1735380697,1735380698,-21600,iPhone
com.xingin.discover,1,1735378480,1735378481,1735378482,-21600,iPhone
com.xingin.discover,13,1735378426,1735378439,1735378439,-21600,iPhone
com.xingin.discover,26,1735377719,1735377745,1735377745,-21600,iPhone
com.xingin.discover,87,1735377504,1735377591,1735377592,-21600,iPhone
com.xingin.discover,80,1735377340,1735377420,1735377420,-21600,iPhone
com.xingin.discover,86,1735377218,1735377304,1735377305,-21600,iPhone
com.google.Chrome,5,1735376912,1735376917,1735376918,-21600,MacBook
com.google.Chrome,988,1735375853,1735376841,1735376841,-21600,MacBook
com.google.Chrome,374,1735375365,1735375739,1735375739,-21600,MacBook
com.google.Chrome,358,1735374825,1735375183,1735375184,-21600,MacBook
com.xingin.discover,791,1735373836,1735374627,1735374628,-21600,iPhone
com.xingin.discover,1219,1735372581,1735373800,1735373801,-21600,iPhone
com.apple.mobiletimer,1,1735372580,1735372581,1735372582,-21600,iPhone
com.xingin.discover,1554,1735371026,1735372580,1735372580,-21600,iPhone
com.microsoft.Office.Outlook,4,1735371021,1735371025,1735371026,-21600,iPhone
com.microsoft.Office.Outlook,9,1735371012,1735371021,1735371022,-21600,iPhone
com.xingin.discover,1,1735371010,1735371011,1735371012,-21600,iPhone
com.tencent.xin,3,1735371006,1735371009,1735371010,-21600,iPhone
com.tencent.xin,2,1735370999,1735371001,1735371002,-21600,iPhone
com.tencent.xin,100,1735370756,1735370856,1735370857,-21600,iPhone
com.tencent.xin,62,1735369628,1735369690,1735369690,-21600,iPhone
com.tencent.xin,62,1735369550,1735369612,1735369613,-21600,iPhone
com.xingin.discover,3,1735369545,1735369548,1735369548,-21600,iPhone
com.xingin.discover,1,1735369517,1735369518,1735369519,-21600,iPhone
com.xingin.discover,80,1735368898,1735368978,1735368978,-21600,iPhone
com.xingin.discover,9,1735368839,1735368848,1735368848,-21600,iPhone
com.xingin.discover,4,1735368526,1735368530,1735368530,-21600,iPhone
com.xingin.discover,2,1735368523,1735368525,1735368526,-21600,iPhone
com.xingin.discover,27,1735367767,1735367794,1735367794,-21600,iPhone
com.xingin.discover,1,1735367207,1735367208,1735367209,-21600,iPhone
com.xingin.discover,0,1735367206,1735367206,1735367207,-21600,iPhone
com.xingin.discover,311,1735365258,1735365569,1735365570,-21600,iPhone
com.apple.mobiletimer,9,1735365249,1735365258,1735365259,-21600,iPhone
com.xingin.discover,6,1735365242,1735365248,1735365249,-21600,iPhone
com.xingin.discover,7,1735364595,1735364602,1735364603,-21600,iPhone
com.xingin.discover,6,1735361391,1735361397,1735361397,-21600,iPhone
com.xingin.discover,10,1735360713,1735360723,1735360723,-21600,iPhone
com.google.Chrome,142,1735355824,1735355966,1735355967,-21600,MacBook
com.google.Chrome,1222,1735353438,1735354660,1735354661,-21600,MacBook
com.google.Chrome,572,1735352767,1735353339,1735353340,-21600,MacBook
com.google.Chrome,475,1735351921,1735352396,1735352396,-21600,MacBook
com.google.Chrome,146,1735351738,1735351884,1735351885,-21600,MacBook
com.google.Chrome,374,1735350966,1735351340,1735351341,-21600,MacBook
com.xingin.discover,100,1735349817,1735349917,1735349918,-21600,iPhone
com.tencent.xin,2,1735349815,1735349817,1735349817,-21600,iPhone
com.tencent.xin,32,1735349770,1735349802,1735349803,-21600,iPhone
com.xingin.discover,53,1735349717,1735349770,1735349770,-21600,iPhone
com.tencent.xin,40,1735349677,1735349717,1735349718,-21600,iPhone
com.tencent.xin,10,1735349553,1735349563,1735349563,-21600,iPhone
com.tencent.xin,10,1735349518,1735349528,1735349528,-21600,iPhone
com.tencent.xin,2,1735349496,1735349498,1735349499,-21600,iPhone
com.apple.mobilephone,2,1735349493,1735349495,1735349496,-21600,iPhone
com.apple.Preferences,4,1735349489,1735349493,1735349494,-21600,iPhone
com.tencent.xin,8,1735349481,1735349489,1735349489,-21600,iPhone
com.tencent.xin,21,1735349454,1735349475,1735349476,-21600,iPhone
com.xingin.discover,4,1735349450,1735349454,1735349454,-21600,iPhone
com.xingin.discover,10,1735349132,1735349142,1735349143,-21600,iPhone
com.xingin.discover,10,1735348843,1735348853,1735348854,-21600,iPhone
com.xingin.discover,54,1735348524,1735348578,1735348578,-21600,iPhone
com.tencent.xin,4,1735348520,1735348524,1735348525,-21600,iPhone
com.tencent.xin,10,1735348177,1735348187,1735348188,-21600,iPhone
com.tencent.xin,17,1735348108,1735348125,1735348126,-21600,iPhone
com.tencent.xin,31,1735348074,1735348105,1735348106,-21600,iPhone
com.xingin.discover,589,1735347485,1735348074,1735348074,-21600,iPhone
com.xingin.discover,6,1735347476,1735347482,1735347483,-21600,iPhone
com.xingin.discover,1,1735347473,1735347474,1735347474,-21600,iPhone
com.xingin.discover,492,1735346906,1735347398,1735347400,-21600,iPhone
com.tencent.xin,26,1735346879,1735346905,1735346905,-21600,iPhone
com.discoverfinancial.mobile,28,1735346851,1735346879,1735346880,-21600,iPhone
com.apple.CoreAuthUI,5,1735346853,1735346858,1735346858,-21600,iPhone
com.tencent.xin,17,1735346834,1735346851,1735346852,-21600,iPhone
com.united.UnitedCustomerFacingIPhone,1,1735346833,1735346834,1735346836,-21600,iPhone
com.tencent.xin,136,1735346697,1735346833,1735346834,-21600,iPhone
com.tencent.xin,1,1735346695,1735346696,1735346697,-21600,iPhone
com.tencent.xin,1,1735346693,1735346694,1735346695,-21600,iPhone
com.tencent.xin,21,1735346670,1735346691,1735346691,-21600,iPhone
com.tencent.xin,33,1735346589,1735346622,1735346624,-21600,iPhone
com.google.Maps,15,1735346574,1735346589,1735346590,-21600,iPhone
com.tencent.xin,48,1735346525,1735346573,1735346574,-21600,iPhone
com.united.UnitedCustomerFacingIPhone,5,1735346520,1735346525,1735346526,-21600,iPhone
com.tencent.xin,26,1735346494,1735346520,1735346521,-21600,iPhone
com.united.UnitedCustomerFacingIPhone,11,1735346483,1735346494,1735346495,-21600,iPhone
com.tencent.xin,5,1735346478,1735346483,1735346484,-21600,iPhone
com.united.UnitedCustomerFacingIPhone,86,1735346392,1735346478,1735346479,-21600,iPhone
com.apple.PassbookUIService,8,1735346450,1735346458,1735346459,-21600,iPhone
com.united.UnitedCustomerFacingIPhone,19,1735346370,1735346389,1735346390,-21600,iPhone
com.tencent.xin,15,1735346355,1735346370,1735346370,-21600,iPhone
com.united.UnitedCustomerFacingIPhone,15,1735346340,1735346355,1735346356,-21600,iPhone
com.tencent.xin,51,1735346289,1735346340,1735346341,-21600,iPhone
com.united.UnitedCustomerFacingIPhone,17,1735346272,1735346289,1735346290,-21600,iPhone
com.tencent.xin,41,1735346231,1735346272,1735346273,-21600,iPhone
com.united.UnitedCustomerFacingIPhone,40,1735346191,1735346231,1735346231,-21600,iPhone
com.tencent.xin,6,1735346185,1735346191,1735346191,-21600,iPhone
com.discoverfinancial.mobile,14,1735346171,1735346185,1735346186,-21600,iPhone
com.united.UnitedCustomerFacingIPhone,9,1735346162,1735346171,1735346172,-21600,iPhone
com.tencent.xin,37,1735346125,1735346162,1735346163,-21600,iPhone
com.united.UnitedCustomerFacingIPhone,29,1735346096,1735346125,1735346125,-21600,iPhone
com.apple.CoreAuthUI,2,1735346106,1735346108,1735346108,-21600,iPhone
com.tencent.xin,16,1735346080,1735346096,1735346097,-21600,iPhone
com.discoverfinancial.mobile,1,1735346079,1735346080,1735346081,-21600,iPhone
com.united.UnitedCustomerFacingIPhone,17,1735346062,1735346079,1735346079,-21600,iPhone
com.discoverfinancial.mobile,3,1735346059,1735346062,1735346062,-21600,iPhone
com.tencent.xin,28,1735346031,1735346059,1735346060,-21600,iPhone
com.discoverfinancial.mobile,3,1735346028,1735346031,1735346034,-21600,iPhone
com.united.UnitedCustomerFacingIPhone,20,1735346006,1735346026,1735346027,-21600,iPhone
com.tencent.xin,9,1735345997,1735346006,1735346007,-21600,iPhone
com.united.UnitedCustomerFacingIPhone,10,1735345987,1735345997,1735345998,-21600,iPhone
com.tencent.xin,9,1735345978,1735345987,1735345988,-21600,iPhone
com.united.UnitedCustomerFacingIPhone,5,1735345973,1735345978,1735345979,-21600,iPhone
com.tencent.xin,10,1735345963,1735345973,1735345974,-21600,iPhone
com.united.UnitedCustomerFacingIPhone,13,1735345950,1735345963,1735345963,-21600,iPhone
com.tencent.xin,1,1735345949,1735345950,1735345950,-21600,iPhone
com.tencent.xin,8,1735345940,1735345948,1735345949,-21600,iPhone
com.united.UnitedCustomerFacingIPhone,2,1735345937,1735345939,1735345939,-21600,iPhone
com.united.UnitedCustomerFacingIPhone,3,1735345931,1735345934,1735345934,-21600,iPhone
com.tencent.xin,6,1735345925,1735345931,1735345932,-21600,iPhone
com.united.UnitedCustomerFacingIPhone,5,1735345920,1735345925,1735345926,-21600,iPhone
com.united.UnitedCustomerFacingIPhone,15,1735345904,1735345919,1735345920,-21600,iPhone
com.united.UnitedCustomerFacingIPhone,18,1735345885,1735345903,1735345904,-21600,iPhone
com.tencent.xin,74,1735345811,1735345885,1735345886,-21600,iPhone
com.united.UnitedCustomerFacingIPhone,2,1735345806,1735345808,1735345808,-21600,iPhone
com.tencent.xin,15,1735345791,1735345806,1735345807,-21600,iPhone
com.united.UnitedCustomerFacingIPhone,29,1735345762,1735345791,1735345792,-21600,iPhone
com.google.chrome.ios,7,1735345753,1735345760,1735345761,-21600,iPhone
com.tencent.xin,12,1735345741,1735345753,1735345754,-21600,iPhone
com.google.chrome.ios,17,1735345724,1735345741,1735345742,-21600,iPhone
com.microsoft.Office.Outlook,5,1735345719,1735345724,1735345725,-21600,iPhone
com.google.chrome.ios,1,1735345718,1735345719,1735345722,-21600,iPhone
com.microsoft.Office.Outlook,1,1735345717,1735345718,1735345719,-21600,iPhone
com.google.chrome.ios,1,1735345716,1735345717,1735345718,-21600,iPhone
com.microsoft.Office.Outlook,5,1735345711,1735345716,1735345717,-21600,iPhone
com.apple.InCallService,18,1735345691,1735345709,1735345710,-21600,iPhone
com.google.chrome.ios,2,1735345689,1735345691,1735345692,-21600,iPhone
com.microsoft.Office.Outlook,25,1735345664,1735345689,1735345689,-21600,iPhone
com.apple.InCallService,1,1735345663,1735345664,1735345665,-21600,iPhone
com.microsoft.Office.Outlook,2,1735345661,1735345663,1735345663,-21600,iPhone
com.apple.InCallService,33,1735345628,1735345661,1735345661,-21600,iPhone
com.tencent.xin,106,1735345522,1735345628,1735345629,-21600,iPhone
com.xingin.discover,5,1735345517,1735345522,1735345523,-21600,iPhone
com.xingin.discover,2,1735345515,1735345517,1735345517,-21600,iPhone
com.xingin.discover,10,1735345247,1735345257,1735345257,-21600,iPhone
com.xingin.discover,14,1735344100,1735344114,1735344115,-21600,iPhone
com.xingin.discover,325,1735343753,1735344078,1735344079,-21600,iPhone
com.tencent.xin,18,1735343735,1735343753,1735343754,-21600,iPhone
com.microsoft.Office.Outlook,26,1735343708,1735343734,1735343735,-21600,iPhone
com.apple.MobileSMS,6,1735343702,1735343708,1735343708,-21600,iPhone
com.microsoft.Office.Outlook,2,1735343700,1735343702,1735343702,-21600,iPhone
com.tencent.xin,1,1735343699,1735343700,1735343701,-21600,iPhone
com.xingin.discover,11,1735343686,1735343697,1735343698,-21600,iPhone
com.xingin.discover,24,1735340879,1735340903,1735340904,-21600,iPhone
com.xingin.discover,188,1735340514,1735340702,1735340702,-21600,iPhone
com.xingin.discover,19,1735337990,1735338009,1735338009,-21600,iPhone
com.xingin.discover,45,1735337802,1735337847,1735337847,-21600,iPhone
com.xingin.discover,62,1735337550,1735337612,1735337613,-21600,iPhone
com.xingin.discover,2263,1735335286,1735337549,1735337550,-21600,iPhone
com.apple.Preferences,1,1735335275,1735335276,1735335277,-21600,iPhone
com.apple.MobileSMS,20,1735331056,1735331076,1735331077,-21600,iPhone
com.tencent.xin,23,1735331032,1735331055,1735331055,-21600,iPhone
com.tencent.xin,1,1735321650,1735321651,1735321652,-21600,iPhone
com.tencent.xin,8,1735293558,1735293566,1735293567,-21600,iPhone
com.tencent.xin,15,1735293210,1735293225,1735293226,-21600,iPhone
com.tencent.xin,68,1735293132,1735293200,1735293201,-21600,iPhone
com.tencent.xin,1,1735292554,1735292555,1735292555,-21600,iPhone
com.tencent.xin,5,1735290673,1735290678,1735290679,-21600,iPhone
com.tencent.xin,62,1735290336,1735290398,1735290398,-21600,iPhone
com.tencent.xin,10,1735289752,1735289762,1735289763,-21600,iPhone
com.tencent.xin,83,1735289657,1735289740,1735289741,-21600,iPhone
com.apple.camera,12,1735289658,1735289670,1735289675,-21600,iPhone
com.tencent.xin,10,1735289647,1735289657,1735289657,-21600,iPhone
com.apple.camera,9,1735289648,1735289657,1735289657,-21600,iPhone
com.tencent.xin,45,1735289586,1735289631,1735289632,-21600,iPhone
com.xingin.discover,152,1735289434,1735289586,1735289587,-21600,iPhone
com.tencent.xin,52,1735289378,1735289430,1735289431,-21600,iPhone
com.tencent.xin,48,1735289011,1735289059,1735289059,-21600,iPhone
com.xingin.discover,2,1735289009,1735289011,1735289012,-21600,iPhone
com.xingin.discover,19,1735288473,1735288492,1735288493,-21600,iPhone
com.xingin.discover,32,1735287334,1735287366,1735287367,-21600,iPhone
com.xingin.discover,130,1735283927,1735284057,1735284057,-21600,iPhone
com.xingin.discover,10,1735283522,1735283532,1735283532,-21600,iPhone
com.xingin.discover,37,1735282873,1735282910,1735282911,-21600,iPhone
com.xingin.discover,7,1735282850,1735282857,1735282857,-21600,iPhone
com.xingin.discover,17,1735282209,1735282226,1735282227,-21600,iPhone
com.xingin.discover,3,1735281656,1735281659,1735281659,-21600,iPhone
com.xingin.discover,21,1735281598,1735281619,1735281620,-21600,iPhone
com.xingin.discover,72,1735281525,1735281597,1735281598,-21600,iPhone
com.microsoft.Office.Outlook,9,1735281512,1735281521,1735281521,-21600,iPhone
com.microsoft.Office.Outlook,2,1735281510,1735281512,1735281512,-21600,iPhone
com.tencent.xin,21,1735281489,1735281510,1735281510,-21600,iPhone
com.apple.MobileSMS,11,1735281478,1735281489,1735281489,-21600,iPhone
com.tencent.xin,1,1735281474,1735281475,1735281476,-21600,iPhone
com.xingin.discover,5,1735281467,1735281472,1735281473,-21600,iPhone
com.xingin.discover,479,1735270922,1735271401,1735271402,-21600,iPhone
com.xingin.discover,3556,1735266818,1735270374,1735270375,-21600,iPhone
com.apple.Preferences,3,1735266814,1735266817,1735266818,-21600,iPhone
com.apple.Preferences,5,1735266642,1735266647,1735266648,-21600,iPhone
com.apple.Preferences,7,1735266634,1735266641,1735266642,-21600,iPhone
com.tencent.xin,3,1735266626,1735266629,1735266629,-21600,iPhone
com.google.chrome.ios,87,1735266536,1735266623,1735266623,-21600,iPhone
com.microsoft.Office.Outlook,12,1735266524,1735266536,1735266537,-21600,iPhone
com.tinyspeck.chatlyio,2,1735266522,1735266524,1735266524,-21600,iPhone
com.microsoft.Office.Outlook,9,1735266505,1735266514,1735266515,-21600,iPhone
com.tencent.xin,7,1735266498,1735266505,1735266506,-21600,iPhone
com.tencent.xin,47,1735265870,1735265917,1735265917,-21600,iPhone
com.xingin.discover,12,1735265856,1735265868,1735265868,-21600,iPhone
com.xingin.discover,110,1735253666,1735253776,1735253777,-21600,iPhone
com.ubercab.UberEats,12,1735253652,1735253664,1735253665,-21600,iPhone
com.apple.mobiletimer,3,1735252756,1735252759,1735252759,-21600,iPhone
com.ubercab.UberEats,3,1735252752,1735252755,1735252756,-21600,iPhone
com.ubercab.UberEats,18,1735252702,1735252720,1735252721,-21600,iPhone
com.tencent.xin,2,1735252700,1735252702,1735252702,-21600,iPhone
com.tencent.xin,63,1735252593,1735252656,1735252657,-21600,iPhone
com.ubercab.UberEats,2,1735252590,1735252592,1735252593,-21600,iPhone
com.ubercab.UberEats,17,1735252513,1735252530,1735252532,-21600,iPhone
com.ubercab.UberEats,4,1735252448,1735252452,1735252453,-21600,iPhone
com.xingin.discover,3,1735252445,1735252448,1735252448,-21600,iPhone
com.xingin.discover,253,1735252156,1735252409,1735252410,-21600,iPhone
com.tencent.xin,2,1735252154,1735252156,1735252156,-21600,iPhone
com.ubercab.UberEats,16,1735252136,1735252152,1735252153,-21600,iPhone
com.xingin.discover,3,1735252133,1735252136,1735252136,-21600,iPhone
com.xingin.discover,42,1735252088,1735252130,1735252131,-21600,iPhone
com.apple.MobileSMS,6,1735252082,1735252088,1735252088,-21600,iPhone
com.apple.MobileSMS,5,1735251818,1735251823,1735251823,-21600,iPhone
com.ubercab.UberEats,3,1735251814,1735251817,1735251818,-21600,iPhone
com.ubercab.UberEats,4,1735251493,1735251497,1735251498,-21600,iPhone
com.apple.mobiletimer,6,1735251487,1735251493,1735251494,-21600,iPhone
com.ubercab.UberEats,4,1735251482,1735251486,1735251487,-21600,iPhone
com.xingin.discover,4,1735251478,1735251482,1735251483,-21600,iPhone
com.xingin.discover,16,1735250226,1735250242,1735250243,-21600,iPhone
com.xingin.discover,100,1735250019,1735250119,1735250120,-21600,iPhone
com.ubercab.UberEats,8,1735250010,1735250018,1735250018,-21600,iPhone
com.ubercab.UberEats,10,1735249368,1735249378,1735249378,-21600,iPhone
com.ubercab.UberEats,9,1735247801,1735247810,1735247811,-21600,iPhone
com.discoverfinancial.mobile,3,1735247796,1735247799,1735247800,-21600,iPhone
com.discoverfinancial.mobile,32,1735247438,1735247470,1735247471,-21600,iPhone
com.apple.CoreAuthUI,2,1735247442,1735247444,1735247445,-21600,iPhone
com.apple.PassbookUIService,7,1735247429,1735247436,1735247437,-21600,iPhone
com.ubercab.UberEats,184,1735247252,1735247436,1735247437,-21600,iPhone
com.xingin.discover,2,1735247248,1735247250,1735247250,-21600,iPhone
com.xingin.discover,1,1735246867,1735246868,1735246869,-21600,iPhone
com.xingin.discover,644,1735246221,1735246865,1735246865,-21600,iPhone
com.microsoft.Office.Outlook,1,1735246218,1735246219,1735246220,-21600,iPhone
com.tencent.xin,16,1735246199,1735246215,1735246215,-21600,iPhone
com.tencent.xin,37,1735245908,1735245945,1735245946,-21600,iPhone
com.microsoft.Office.Outlook,6,1735245902,1735245908,1735245909,-21600,iPhone
com.microsoft.Office.Outlook,2,1735241735,1735241737,1735241738,-21600,iPhone
com.tencent.xin,1,1735241734,1735241735,1735241735,-21600,iPhone
com.xingin.discover,4,1735241728,1735241732,1735241732,-21600,iPhone
com.xingin.discover,10,1735241718,1735241728,1735241728,-21600,iPhone
com.xingin.discover,335,1735241022,1735241357,1735241357,-21600,iPhone
tv.danmaku.bilianime,10,1735241012,1735241022,1735241022,-21600,iPhone
tv.danmaku.bilianime,97,1735240805,1735240902,1735240903,-21600,iPhone
tv.danmaku.bilianime,126,1735240661,1735240787,1735240788,-21600,iPhone
tv.danmaku.bilianime,170,1735240454,1735240624,1735240625,-21600,iPhone
com.apple.MobileSMS,3,1735240450,1735240453,1735240454,-21600,iPhone
tv.danmaku.bilianime,9,1735240441,1735240450,1735240450,-21600,iPhone
tv.danmaku.bilianime,1,1735240230,1735240231,1735240232,-21600,iPhone
tv.danmaku.bilianime,204,1735232902,1735233106,1735233106,-21600,iPhone
com.xingin.discover,49,1735232853,1735232902,1735232903,-21600,iPhone
tv.danmaku.bilianime,1,1735232852,1735232853,1735232853,-21600,iPhone
com.xingin.discover,357,1735232494,1735232851,1735232852,-21600,iPhone
com.microsoft.Office.Outlook,19,1735232470,1735232489,1735232489,-21600,iPhone
com.tencent.xin,1,1735232469,1735232470,1735232470,-21600,iPhone
tv.danmaku.bilianime,5,1735232462,1735232467,1735232467,-21600,iPhone
tv.danmaku.bilianime,695,1735219190,1735219885,1735219885,-21600,iPhone
com.bilibili.bilicomic,1,1735219189,1735219190,1735219190,-21600,iPhone
tv.danmaku.bilianime,3,1735219185,1735219188,1735219188,-21600,iPhone
tv.danmaku.bilianime,1,1735219184,1735219185,1735219186,-21600,iPhone
com.bilibili.bilicomic,1,1735219183,1735219184,1735219185,-21600,iPhone
tv.danmaku.bilianime,2,1735219181,1735219183,1735219183,-21600,iPhone
com.xingin.discover,3,1735219160,1735219163,1735219163,-21600,iPhone
com.xingin.discover,22,1735219058,1735219080,1735219081,-21600,iPhone
com.xingin.discover,7,1735218847,1735218854,1735218855,-21600,iPhone
com.xingin.discover,54,1735218687,1735218741,1735218742,-21600,iPhone
com.xingin.discover,2,1735217954,1735217956,1735217956,-21600,iPhone
com.xingin.discover,1,1735217953,1735217954,1735217954,-21600,iPhone
com.xingin.discover,23,1735215432,1735215455,1735215456,-21600,iPhone
com.xingin.discover,72,1735212641,1735212713,1735212713,-21600,iPhone
com.xingin.discover,7,1735212634,1735212641,1735212641,-21600,iPhone
com.xingin.discover,82,1735209490,1735209572,1735209573,-21600,iPhone
com.xingin.discover,2,1735209487,1735209489,1735209490,-21600,iPhone
com.xingin.discover,118,1735205258,1735205376,1735205377,-21600,iPhone
com.xingin.discover,6,1735205208,1735205214,1735205215,-21600,iPhone
com.xingin.discover,290,1735204795,1735205085,1735205086,-21600,iPhone
tv.danmaku.bilianime,9,1735204786,1735204795,1735204795,-21600,iPhone
tv.danmaku.bilianime,85,1735204458,1735204543,1735204544,-21600,iPhone
tv.danmaku.bilianime,4,1735204451,1735204455,1735204456,-21600,iPhone
tv.danmaku.bilianime,572,1735197215,1735197787,1735197788,-21600,iPhone
com.bilibili.bilicomic,20,1735197194,1735197214,1735197214,-21600,iPhone
tv.danmaku.bilianime,1,1735197193,1735197194,1735197194,-21600,iPhone
com.bilibili.bilicomic,2,1735197191,1735197193,1735197193,-21600,iPhone
com.xingin.discover,4,1735197171,1735197175,1735197175,-21600,iPhone
com.apple.camera,2,1735195428,1735195430,1735195431,-21600,iPhone
com.xingin.discover,3,1735195427,1735195430,1735195431,-21600,iPhone
com.xingin.discover,117,1735195136,1735195253,1735195254,-21600,iPhone
com.tencent.xin,4,1735195131,1735195135,1735195135,-21600,iPhone
com.tencent.xin,3,1735195128,1735195131,1735195131,-21600,iPhone
com.tencent.xin,12,1735193740,1735193752,1735193752,-21600,iPhone
com.tencent.xin,11,1735193712,1735193723,1735193723,-21600,iPhone
com.tencent.xin,10,1735193702,1735193712,1735193712,-21600,iPhone
com.tencent.xin,24,1735193655,1735193679,1735193679,-21600,iPhone
com.tencent.xin,66,1735193589,1735193655,1735193655,-21600,iPhone
com.apple.camera,7,1735193590,1735193597,1735193598,-21600,iPhone
com.tencent.xin,13,1735193261,1735193274,1735193274,-21600,iPhone
com.tencent.xin,87,1735193171,1735193258,1735193259,-21600,iPhone
com.openai.chat,2,1735193166,1735193168,1735193168,-21600,iPhone
com.xingin.discover,6,1735193160,1735193166,1735193167,-21600,iPhone
com.xingin.discover,3,1735193153,1735193156,1735193157,-21600,iPhone
com.tencent.xin,19,1735193134,1735193153,1735193153,-21600,iPhone
com.xingin.discover,4,1735193130,1735193134,1735193134,-21600,iPhone
com.xingin.discover,10,1735192426,1735192436,1735192437,-21600,iPhone
com.xingin.discover,10,1735190041,1735190051,1735190052,-21600,iPhone
com.xingin.discover,24,1735189213,1735189237,1735189238,-21600,iPhone
com.xingin.discover,21,1735189138,1735189159,1735189160,-21600,iPhone
com.xingin.discover,31,1735189102,1735189133,1735189133,-21600,iPhone
com.tencent.xin,1,1735189101,1735189102,1735189102,-21600,iPhone
com.xingin.discover,1,1735189099,1735189100,1735189101,-21600,iPhone
com.xingin.discover,3,1735189095,1735189098,1735189099,-21600,iPhone
com.xingin.discover,1,1735188622,1735188623,1735188624,-21600,iPhone
com.xingin.discover,2,1735188127,1735188129,1735188129,-21600,iPhone
com.xingin.discover,2,1735188011,1735188013,1735188014,-21600,iPhone
com.xingin.discover,229,1735187650,1735187879,1735187880,-21600,iPhone
com.openai.chat,153,1735187497,1735187650,1735187651,-21600,iPhone
com.openai.chat,119,1735187366,1735187485,1735187487,-21600,iPhone
com.xingin.discover,1,1735187364,1735187365,1735187367,-21600,iPhone
com.openai.chat,1,1735187360,1735187361,1735187362,-21600,iPhone
com.netease.cloudmusic,5,1735187355,1735187360,1735187361,-21600,iPhone
com.netease.cloudmusic,21,1735187329,1735187350,1735187351,-21600,iPhone
com.google.chrome.ios,3,1735187324,1735187327,1735187328,-21600,iPhone
com.google.chrome.ios,11,1735186935,1735186946,1735186947,-21600,iPhone
com.apple.podcasts,7,1735186928,1735186935,1735186936,-21600,iPhone
com.google.chrome.ios,2,1735186926,1735186928,1735186928,-21600,iPhone
com.apple.podcasts,14,1735186912,1735186926,1735186927,-21600,iPhone
com.bilibili.bilicomic,3,1735186909,1735186912,1735186913,-21600,iPhone
com.apple.MobileSMS,4,1735186902,1735186906,1735186907,-21600,iPhone
com.apple.podcasts,3,1735186897,1735186900,1735186901,-21600,iPhone
com.apple.podcasts,2,1735186803,1735186805,1735186805,-21600,iPhone
com.apple.podcasts,2,1735186735,1735186737,1735186737,-21600,iPhone
com.apple.podcasts,93,1735185321,1735185414,1735185415,-21600,iPhone
com.apple.Preferences,14,1735185306,1735185320,1735185321,-21600,iPhone
com.apple.podcasts,8,1735185296,1735185304,1735185305,-21600,iPhone
com.tencent.xin,5,1735185283,1735185288,1735185288,-21600,iPhone
com.tencent.xin,99,1735185171,1735185270,1735185271,-21600,iPhone
com.apple.finder,5,1735184997,1735185002,1735185002,-21600,MacBook
com.google.Chrome,20,1735184977,1735184997,1735184997,-21600,MacBook
com.tencent.xin,32,1735184840,1735184872,1735184873,-21600,iPhone
com.tencent.xin,11,1735184828,1735184839,1735184839,-21600,iPhone
com.tencent.xin,11,1735184811,1735184822,1735184822,-21600,iPhone
com.tencent.xin,450,1735184341,1735184791,1735184792,-21600,iPhone
com.apple.Preferences,6,1735184335,1735184341,1735184342,-21600,iPhone
com.apple.Preferences,10,1735183217,1735183227,1735183227,-21600,iPhone
com.google.Chrome,319,1735182088,1735182407,1735182408,-21600,MacBook
com.sunsama.native-app,59,1735182029,1735182088,1735182089,-21600,MacBook
com.apple.finder,4,1735182025,1735182029,1735182030,-21600,MacBook
com.apple.finder,1,1735181362,1735181363,1735181364,-21600,MacBook
com.google.Chrome,51,1735181311,1735181362,1735181363,-21600,MacBook
com.adobe.Photoshop,1,1735181310,1735181311,1735181326,-21600,MacBook
com.google.Chrome,0,1735181310,1735181310,1735181322,-21600,MacBook
com.apple.finder,4,1735181306,1735181310,1735181318,-21600,MacBook
com.google.Chrome,4,1735181302,1735181306,1735181307,-21600,MacBook
com.apple.finder,2,1735181300,1735181302,1735181302,-21600,MacBook
com.apple.Preferences,10,1735178690,1735178700,1735178701,-21600,iPhone
com.apple.Preferences,10,1735177120,1735177130,1735177131,-21600,iPhone
com.apple.Preferences,10,1735176060,1735176070,1735176071,-21600,iPhone
com.apple.Preferences,10,1735175420,1735175430,1735175430,-21600,iPhone
com.apple.Preferences,7,1735175265,1735175272,1735175272,-21600,iPhone
com.microsoft.Office.Outlook,3,1735175260,1735175263,1735175264,-21600,iPhone
com.tencent.xin,4,1735175256,1735175260,1735175260,-21600,iPhone
com.tencent.xin,40,1735175197,1735175237,1735175238,-21600,iPhone
com.microsoft.Office.Outlook,0,1735175197,1735175197,1735175198,-21600,iPhone
com.tencent.xin,1,1735175196,1735175197,1735175197,-21600,iPhone
com.tencent.xin,29,1735175166,1735175195,1735175195,-21600,iPhone
com.tencent.xin,39,1735175121,1735175160,1735175160,-21600,iPhone
com.microsoft.Office.Outlook,2,1735175119,1735175121,1735175121,-21600,iPhone
com.tencent.xin,2,1735175117,1735175119,1735175120,-21600,iPhone
com.google.chrome.ios,3,1735175112,1735175115,1735175116,-21600,iPhone
com.google.chrome.ios,7483,1735161110,1735168593,1735168594,-21600,iPhone
com.xingin.discover,1623,1735159486,1735161109,1735161109,-21600,iPhone
com.tencent.xin,22,1735159464,1735159486,1735159487,-21600,iPhone
com.xingin.discover,3,1735159458,1735159461,1735159462,-21600,iPhone
com.tencent.xin,45,1735159411,1735159456,1735159457,-21600,iPhone
com.google.chrome.ios,1,1735159410,1735159411,1735159412,-21600,iPhone
com.microsoft.Office.Outlook,1,1735159409,1735159410,1735159411,-21600,iPhone
com.microsoft.Office.Outlook,5,1735159390,1735159395,1735159395,-21600,iPhone
com.microsoft.Office.Outlook,28,1735159359,1735159387,1735159387,-21600,iPhone
com.tencent.xin,103,1735159254,1735159357,1735159358,-21600,iPhone
com.microsoft.Office.Outlook,0,1735159254,1735159254,1735159255,-21600,iPhone
com.tencent.xin,205,1735159048,1735159253,1735159254,-21600,iPhone
com.tencent.xin,24,1735158777,1735158801,1735158802,-21600,iPhone
com.tencent.xin,41,1735158729,1735158770,1735158771,-21600,iPhone
com.google.chrome.ios,14,1735158715,1735158729,1735158730,-21600,iPhone
com.google.calendar,8,1735158707,1735158715,1735158715,-21600,iPhone
com.tencent.xin,15,1735158692,1735158707,1735158708,-21600,iPhone
com.tencent.xin,27,1735158663,1735158690,1735158691,-21600,iPhone
com.tencent.xin,7,1735158655,1735158662,1735158663,-21600,iPhone
com.tencent.xin,5,1735158650,1735158655,1735158655,-21600,iPhone
com.microsoft.Office.Outlook,3,1735158647,1735158650,1735158650,-21600,iPhone
com.microsoft.Office.Outlook,92,1735158554,1735158646,1735158647,-21600,iPhone
com.google.chrome.ios,21,1735158532,1735158553,1735158553,-21600,iPhone
com.google.calendar,33,1735158499,1735158532,1735158533,-21600,iPhone
com.google.chrome.ios,14,1735158484,1735158498,1735158499,-21600,iPhone
com.tencent.xin,24,1735158460,1735158484,1735158485,-21600,iPhone
com.google.chrome.ios,5,1735158455,1735158460,1735158461,-21600,iPhone
com.tencent.xin,97,1735158358,1735158455,1735158457,-21600,iPhone
com.chase,22,1735158335,1735158357,1735158358,-21600,iPhone
com.tencent.xin,10,1735158325,1735158335,1735158336,-21600,iPhone
com.chase,27,1735158298,1735158325,1735158326,-21600,iPhone
com.apple.CoreAuthUI,2,1735158302,1735158304,1735158305,-21600,iPhone
com.tencent.xin,26,1735158270,1735158296,1735158297,-21600,iPhone
com.google.chrome.ios,34,1735158234,1735158268,1735158269,-21600,iPhone
com.tencent.xin,6,1735158228,1735158234,1735158234,-21600,iPhone
com.microsoft.Office.Outlook,17,1735158211,1735158228,1735158229,-21600,iPhone
com.tencent.xin,47,1735158164,1735158211,1735158212,-21600,iPhone
com.tencent.xin,11,1735158152,1735158163,1735158164,-21600,iPhone
com.google.chrome.ios,17,1735158134,1735158151,1735158151,-21600,iPhone
com.microsoft.Office.Outlook,7,1735158127,1735158134,1735158135,-21600,iPhone
com.google.chrome.ios,1,1735158126,1735158127,1735158128,-21600,iPhone
com.microsoft.Office.Outlook,25,1735158101,1735158126,1735158126,-21600,iPhone
com.tinyspeck.chatlyio,61,1735158040,1735158101,1735158101,-21600,iPhone
com.microsoft.Office.Outlook,1,1735158039,1735158040,1735158040,-21600,iPhone
com.tencent.xin,252,1735157786,1735158038,1735158039,-21600,iPhone
com.tencent.xin,6,1735157735,1735157741,1735157742,-21600,iPhone
com.apple.mobilesafari,3,1735157731,1735157734,1735157735,-21600,iPhone
com.apple.mobilesafari,9,1735156933,1735156942,1735156943,-21600,iPhone
com.apple.mobilesafari,13,1735154123,1735154136,1735154136,-21600,iPhone
com.apple.mobilesafari,8,1735154111,1735154119,1735154120,-21600,iPhone
com.apple.mobilesafari,8,1735125343,1735125351,1735125351,-21600,iPhone
com.apple.mobilesafari,1193,1735124002,1735125195,1735125195,-21600,iPhone
com.apple.mobilesafari,1016,1735122836,1735123852,1735123853,-21600,iPhone
com.apple.mobilesafari,2883,1735119335,1735122218,1735122219,-21600,iPhone
com.apple.mobilesafari,602,1735118715,1735119317,1735119317,-21600,iPhone
com.apple.mobilesafari,3,1735118711,1735118714,1735118714,-21600,iPhone
com.apple.mobilesafari,74,1735118637,1735118711,1735118711,-21600,iPhone
com.bilibili.bilicomic,60,1735118576,1735118636,1735118636,-21600,iPhone
com.bilibili.bilicomic,53,1735118406,1735118459,1735118460,-21600,iPhone
com.bilibili.bilicomic,60,1735118276,1735118336,1735118337,-21600,iPhone
com.apple.camera,3,1735118272,1735118275,1735118276,-21600,iPhone
com.apple.finder,23,1735118102,1735118125,1735118126,-21600,MacBook
com.sunsama.native-app,92,1735118010,1735118102,1735118103,-21600,MacBook
com.apple.finder,2,1735118008,1735118010,1735118010,-21600,MacBook
com.google.Chrome,159,1735117849,1735118008,1735118009,-21600,MacBook
com.apple.finder,1,1735117848,1735117849,1735117850,-21600,MacBook
com.apple.Notes,12,1735117836,1735117848,1735117849,-21600,MacBook
com.apple.finder,1,1735117835,1735117836,1735117837,-21600,MacBook
com.google.Chrome,9,1735117826,1735117835,1735117836,-21600,MacBook
notion.id,3,1735117823,1735117826,1735117827,-21600,MacBook
com.apple.finder,3,1735117820,1735117823,1735117823,-21600,MacBook
org.krita,126,1735117694,1735117820,1735117821,-21600,MacBook
com.apple.camera,29,1735117773,1735117802,1735117803,-21600,iPhone
com.apple.camera,2,1735117771,1735117773,1735117774,-21600,iPhone
com.microsoft.Office.Outlook,2,1735117767,1735117769,1735117770,-21600,iPhone
com.apple.finder,47,1735117647,1735117694,1735117695,-21600,MacBook
org.krita,551,1735117096,1735117647,1735117648,-21600,MacBook
com.apple.finder,3,1735117093,1735117096,1735117096,-21600,MacBook
com.google.Chrome,23,1735117070,1735117093,1735117094,-21600,MacBook
notion.id,2,1735117068,1735117070,1735117071,-21600,MacBook
com.apple.finder,232,1735116836,1735117068,1735117069,-21600,MacBook
com.bilibili.bilicomic,19,1735117047,1735117066,1735117067,-21600,iPhone
com.apple.mobileslideshow,176,1735116870,1735117046,1735117047,-21600,iPhone
com.tencent.xin,3,1735116865,1735116868,1735116870,-21600,iPhone
org.krita,1,1735116835,1735116836,1735116837,-21600,MacBook
com.apple.finder,1,1735116834,1735116835,1735116835,-21600,MacBook
org.krita,2,1735116832,1735116834,1735116835,-21600,MacBook
com.apple.finder,3,1735116829,1735116832,1735116832,-21600,MacBook
com.adobe.Photoshop,18,1735116811,1735116829,1735116830,-21600,MacBook
com.apple.finder,11,1735116800,1735116811,1735116811,-21600,MacBook
com.apple.Preview,7,1735116793,1735116800,1735116801,-21600,MacBook
com.apple.finder,2,1735116791,1735116793,1735116793,-21600,MacBook
com.apple.Preview,13,1735116778,1735116791,1735116792,-21600,MacBook
com.apple.finder,15,1735116763,1735116778,1735116778,-21600,MacBook
com.apple.Preview,4,1735116759,1735116763,1735116763,-21600,MacBook
com.apple.finder,0,1735116759,1735116759,1735116760,-21600,MacBook
com.apple.Preview,7,1735116752,1735116759,1735116759,-21600,MacBook
com.apple.finder,1,1735116751,1735116752,1735116753,-21600,MacBook
com.apple.Preview,5,1735116746,1735116751,1735116752,-21600,MacBook
com.apple.finder,3,1735116743,1735116746,1735116746,-21600,MacBook
com.apple.Preview,9,1735116734,1735116743,1735116744,-21600,MacBook
com.apple.finder,6,1735116728,1735116734,1735116735,-21600,MacBook
com.apple.Preview,6,1735116722,1735116728,1735116729,-21600,MacBook
com.apple.finder,0,1735116722,1735116722,1735116723,-21600,MacBook
com.apple.Preview,5,1735116717,1735116722,1735116722,-21600,MacBook
com.apple.finder,23,1735116694,1735116717,1735116718,-21600,MacBook
com.apple.Preview,3,1735116691,1735116694,1735116695,-21600,MacBook
com.apple.finder,8,1735116683,1735116691,1735116692,-21600,MacBook
com.apple.Preview,2,1735116681,1735116683,1735116683,-21600,MacBook
com.apple.finder,1,1735116680,1735116681,1735116682,-21600,MacBook
com.apple.Preview,2,1735116678,1735116680,1735116681,-21600,MacBook
com.apple.finder,4,1735116674,1735116678,1735116678,-21600,MacBook
com.apple.Preview,7,1735116667,1735116674,1735116674,-21600,MacBook
com.apple.finder,12,1735116655,1735116667,1735116667,-21600,MacBook
com.apple.Preview,5,1735116650,1735116655,1735116656,-21600,MacBook
com.apple.finder,3,1735116647,1735116650,1735116650,-21600,MacBook
com.apple.Preview,3,1735116644,1735116647,1735116648,-21600,MacBook
com.apple.finder,2,1735116642,1735116644,1735116644,-21600,MacBook
com.apple.Preview,1,1735116641,1735116642,1735116643,-21600,MacBook
com.apple.finder,3,1735116638,1735116641,1735116641,-21600,MacBook
com.apple.Preview,7,1735116631,1735116638,1735116638,-21600,MacBook
com.apple.finder,1,1735116630,1735116631,1735116632,-21600,MacBook
com.apple.Preview,6,1735116624,1735116630,1735116631,-21600,MacBook
com.apple.finder,1,1735116623,1735116624,1735116625,-21600,MacBook
com.apple.Preview,7,1735116616,1735116623,1735116623,-21600,MacBook
com.apple.finder,2,1735116614,1735116616,1735116617,-21600,MacBook
com.apple.Preview,11,1735116603,1735116614,1735116615,-21600,MacBook
com.apple.finder,27,1735116576,1735116603,1735116604,-21600,MacBook
notion.id,7,1735116569,1735116576,1735116577,-21600,MacBook
com.google.Chrome,82,1735116487,1735116569,1735116570,-21600,MacBook
notion.id,1,1735116486,1735116487,1735116487,-21600,MacBook
com.google.Chrome,18,1735116468,1735116486,1735116486,-21600,MacBook
notion.id,1,1735116467,1735116468,1735116469,-21600,MacBook
com.apple.finder,5,1735116462,1735116467,1735116467,-21600,MacBook
notion.id,106,1735116356,1735116462,1735116463,-21600,MacBook
com.google.Chrome,16,1735116340,1735116356,1735116357,-21600,MacBook
notion.id,122,1735116218,1735116340,1735116341,-21600,MacBook
com.google.Chrome,16,1735116202,1735116218,1735116219,-21600,MacBook
notion.id,1,1735116201,1735116202,1735116203,-21600,MacBook
com.google.Chrome,12,1735116189,1735116201,1735116202,-21600,MacBook
notion.id,49,1735116140,1735116189,1735116190,-21600,MacBook
com.google.Chrome,2,1735116138,1735116140,1735116140,-21600,MacBook
notion.id,2,1735116136,1735116138,1735116138,-21600,MacBook
com.google.Chrome,14,1735116122,1735116136,1735116137,-21600,MacBook
notion.id,2,1735116120,1735116122,1735116123,-21600,MacBook
com.google.Chrome,28,1735116092,1735116120,1735116121,-21600,MacBook
notion.id,2,1735116090,1735116092,1735116093,-21600,MacBook
com.google.Chrome,1,1735116089,1735116090,1735116090,-21600,MacBook
notion.id,1,1735116088,1735116089,1735116089,-21600,MacBook
com.google.Chrome,55,1735116033,1735116088,1735116089,-21600,MacBook
notion.id,5,1735116028,1735116033,1735116034,-21600,MacBook
com.google.Chrome,6,1735116022,1735116028,1735116028,-21600,MacBook
notion.id,5,1735116017,1735116022,1735116022,-21600,MacBook
com.google.Chrome,7,1735116010,1735116017,1735116018,-21600,MacBook
notion.id,1,1735116009,1735116010,1735116011,-21600,MacBook
com.google.Chrome,43,1735115966,1735116009,1735116010,-21600,MacBook
notion.id,3,1735115963,1735115966,1735115966,-21600,MacBook
com.google.Chrome,5,1735115958,1735115963,1735115964,-21600,MacBook
notion.id,7,1735115951,1735115958,1735115958,-21600,MacBook
com.google.Chrome,1,1735115950,1735115951,1735115951,-21600,MacBook
notion.id,6,1735115944,1735115950,1735115951,-21600,MacBook
com.google.Chrome,12,1735115932,1735115944,1735115945,-21600,MacBook
notion.id,4,1735115928,1735115932,1735115933,-21600,MacBook
com.google.Chrome,1,1735115927,1735115928,1735115929,-21600,MacBook
notion.id,19,1735115908,1735115927,1735115928,-21600,MacBook
com.google.Chrome,71,1735115837,1735115908,1735115909,-21600,MacBook
com.apple.finder,2,1735115835,1735115837,1735115837,-21600,MacBook
com.google.Chrome,6,1735115829,1735115835,1735115836,-21600,MacBook
notion.id,4,1735115825,1735115829,1735115830,-21600,MacBook
com.google.Chrome,17,1735115808,1735115825,1735115826,-21600,MacBook
notion.id,2,1735115806,1735115808,1735115808,-21600,MacBook
com.google.Chrome,6,1735115800,1735115806,1735115806,-21600,MacBook
notion.id,53,1735115747,1735115800,1735115801,-21600,MacBook
com.google.Chrome,24,1735115723,1735115747,1735115748,-21600,MacBook
notion.id,26,1735115697,1735115723,1735115724,-21600,MacBook
com.google.Chrome,12,1735115685,1735115697,1735115697,-21600,MacBook
notion.id,1,1735115684,1735115685,1735115686,-21600,MacBook
com.google.Chrome,2,1735115682,1735115684,1735115686,-21600,MacBook
com.apple.finder,2,1735115680,1735115682,1735115685,-21600,MacBook
com.google.Chrome,6,1735115674,1735115680,1735115681,-21600,MacBook
notion.id,288,1735115386,1735115674,1735115675,-21600,MacBook
com.apple.finder,14,1735115372,1735115386,1735115386,-21600,MacBook
notion.id,275,1735115097,1735115372,1735115372,-21600,MacBook
com.google.Chrome,6,1735115091,1735115097,1735115098,-21600,MacBook
notion.id,240,1735114851,1735115091,1735115091,-21600,MacBook
com.apple.finder,2,1735114849,1735114851,1735114852,-21600,MacBook
com.apple.Preview,20,1735114829,1735114849,1735114850,-21600,MacBook
com.apple.finder,2,1735114827,1735114829,1735114830,-21600,MacBook
com.apple.Preview,6,1735114821,1735114827,1735114828,-21600,MacBook
com.apple.finder,2,1735114819,1735114821,1735114822,-21600,MacBook
com.adobe.Photoshop,5,1735114814,1735114819,1735114820,-21600,MacBook
com.apple.finder,2,1735114812,1735114814,1735114814,-21600,MacBook
com.adobe.Photoshop,718,1735114094,1735114812,1735114812,-21600,MacBook
com.apple.finder,2,1735114092,1735114094,1735114095,-21600,MacBook
com.adobe.Photoshop,261,1735113831,1735114092,1735114092,-21600,MacBook
com.google.Chrome,24,1735113807,1735113831,1735113832,-21600,MacBook
com.adobe.Photoshop,9,1735113798,1735113807,1735113808,-21600,MacBook
com.google.Chrome,20,1735113778,1735113798,1735113799,-21600,MacBook
com.adobe.Photoshop,89,1735113689,1735113778,1735113779,-21600,MacBook
com.google.Chrome,26,1735113663,1735113689,1735113690,-21600,MacBook
com.adobe.Photoshop,151,1735113512,1735113663,1735113664,-21600,MacBook
com.google.Chrome,5,1735113507,1735113512,1735113513,-21600,MacBook
com.adobe.Photoshop,10,1735113497,1735113507,1735113508,-21600,MacBook
com.google.Chrome,21,1735113476,1735113497,1735113498,-21600,MacBook
com.adobe.Photoshop,33,1735113443,1735113476,1735113476,-21600,MacBook
com.google.Chrome,5,1735113438,1735113443,1735113444,-21600,MacBook
com.adobe.Photoshop,80,1735113358,1735113438,1735113439,-21600,MacBook
com.google.Chrome,22,1735113336,1735113358,1735113358,-21600,MacBook
com.adobe.Photoshop,8,1735113328,1735113336,1735113337,-21600,MacBook
com.google.Chrome,7,1735113321,1735113328,1735113328,-21600,MacBook
notion.id,0,1735113321,1735113321,1735113322,-21600,MacBook
com.adobe.Photoshop,22,1735113299,1735113321,1735113321,-21600,MacBook
com.apple.finder,4,1735113295,1735113299,1735113300,-21600,MacBook
com.google.Chrome,6,1735113289,1735113295,1735113295,-21600,MacBook
notion.id,32,1735113257,1735113289,1735113289,-21600,MacBook
com.adobe.Photoshop,11,1735113246,1735113257,1735113257,-21600,MacBook
notion.id,13,1735113233,1735113246,1735113247,-21600,MacBook
com.adobe.Photoshop,3,1735113230,1735113233,1735113234,-21600,MacBook
notion.id,29,1735113201,1735113230,1735113231,-21600,MacBook
com.adobe.Photoshop,76,1735113125,1735113201,1735113201,-21600,MacBook
com.apple.finder,0,1735113125,1735113125,1735113126,-21600,MacBook
com.google.Chrome,23,1735113102,1735113125,1735113126,-21600,MacBook
notion.id,166,1735112936,1735113102,1735113103,-21600,MacBook
com.adobe.Photoshop,0,1735112936,1735112936,1735112937,-21600,MacBook
notion.id,2,1735112934,1735112936,1735112937,-21600,MacBook
com.apple.finder,1,1735112933,1735112934,1735112935,-21600,MacBook
com.google.Chrome,5,1735112928,1735112933,1735112934,-21600,MacBook
com.adobe.Photoshop,1,1735112927,1735112928,1735112929,-21600,MacBook
com.google.Chrome,6,1735112921,1735112927,1735112928,-21600,MacBook
com.apple.finder,7,1735112914,1735112921,1735112922,-21600,MacBook
com.apple.Preview,17,1735112897,1735112914,1735112914,-21600,MacBook
com.apple.finder,1,1735112896,1735112897,1735112898,-21600,MacBook
com.apple.Preview,3,1735112893,1735112896,1735112897,-21600,MacBook
com.apple.finder,9,1735112884,1735112893,1735112894,-21600,MacBook
com.apple.Preview,11,1735112873,1735112884,1735112885,-21600,MacBook
com.apple.finder,0,1735112873,1735112873,1735112874,-21600,MacBook
com.apple.Preview,2,1735112871,1735112873,1735112874,-21600,MacBook
com.apple.finder,16,1735112855,1735112871,1735112872,-21600,MacBook
com.apple.Preview,5,1735112850,1735112855,1735112856,-21600,MacBook
com.apple.finder,9,1735112841,1735112850,1735112851,-21600,MacBook
notion.id,539,1735112302,1735112841,1735112841,-21600,MacBook
com.apple.finder,0,1735112302,1735112302,1735112303,-21600,MacBook
notion.id,2,1735112300,1735112302,1735112302,-21600,MacBook
com.google.Chrome,93,1735112207,1735112300,1735112300,-21600,MacBook
notion.id,2,1735112205,1735112207,1735112208,-21600,MacBook
com.google.Chrome,148,1735112057,1735112205,1735112206,-21600,MacBook
notion.id,1,1735112056,1735112057,1735112058,-21600,MacBook
com.google.Chrome,23,1735112033,1735112056,1735112057,-21600,MacBook
com.apple.finder,2,1735112031,1735112033,1735112034,-21600,MacBook
com.google.Chrome,5,1735112026,1735112031,1735112031,-21600,MacBook
notion.id,75,1735111951,1735112026,1735112027,-21600,MacBook
com.apple.finder,1,1735111950,1735111951,1735111952,-21600,MacBook
com.google.Chrome,10,1735111940,1735111950,1735111951,-21600,MacBook
com.apple.finder,2,1735111938,1735111940,1735111941,-21600,MacBook
com.adobe.Photoshop,3,1735111935,1735111938,1735111938,-21600,MacBook
com.apple.finder,3,1735111932,1735111935,1735111936,-21600,MacBook
com.adobe.Photoshop,3,1735111929,1735111932,1735111932,-21600,MacBook
com.apple.finder,5,1735111924,1735111929,1735111930,-21600,MacBook
com.google.Chrome,1,1735111923,1735111924,1735111925,-21600,MacBook
notion.id,361,1735111562,1735111923,1735111924,-21600,MacBook
com.apple.finder,5,1735111557,1735111562,1735111562,-21600,MacBook
com.google.Chrome,0,1735111557,1735111557,1735111558,-21600,MacBook
notion.id,18,1735111539,1735111557,1735111557,-21600,MacBook
com.google.Chrome,2,1735111537,1735111539,1735111540,-21600,MacBook
com.apple.finder,9,1735111528,1735111537,1735111537,-21600,MacBook
com.adobe.Photoshop,34,1735111494,1735111528,1735111529,-21600,MacBook
com.apple.finder,1,1735111493,1735111494,1735111495,-21600,MacBook
com.adobe.Photoshop,4,1735111489,1735111493,1735111493,-21600,MacBook
com.apple.finder,13,1735111476,1735111489,1735111490,-21600,MacBook
com.apple.Preview,5,1735111471,1735111476,1735111477,-21600,MacBook
com.apple.finder,33,1735111438,1735111471,1735111472,-21600,MacBook
com.apple.QuickTimePlayerX,3,1735111435,1735111438,1735111439,-21600,MacBook
com.google.Chrome,26,1735111409,1735111435,1735111436,-21600,MacBook
com.apple.QuickTimePlayerX,9,1735111400,1735111409,1735111410,-21600,MacBook
com.google.Chrome,74,1735111326,1735111400,1735111400,-21600,MacBook
notion.id,2,1735111324,1735111326,1735111326,-21600,MacBook
com.google.Chrome,2,1735111322,1735111324,1735111325,-21600,MacBook
com.apple.finder,18,1735111304,1735111322,1735111323,-21600,MacBook
com.adobe.Photoshop,34,1735111270,1735111304,1735111305,-21600,MacBook
com.apple.finder,8,1735111262,1735111270,1735111271,-21600,MacBook
com.google.Chrome,32,1735111230,1735111262,1735111262,-21600,MacBook
com.apple.QuickTimePlayerX,7,1735111223,1735111230,1735111231,-21600,MacBook
com.apple.finder,6,1735111217,1735111223,1735111223,-21600,MacBook
com.google.Chrome,36,1735111181,1735111217,1735111218,-21600,MacBook
com.apple.finder,1,1735111180,1735111181,1735111181,-21600,MacBook
com.google.Chrome,17,1735111163,1735111180,1735111181,-21600,MacBook
com.apple.finder,5,1735111158,1735111163,1735111163,-21600,MacBook
com.adobe.Photoshop,81,1735111077,1735111158,1735111158,-21600,MacBook
com.google.Chrome,4,1735111073,1735111077,1735111078,-21600,MacBook
com.adobe.Photoshop,25,1735111048,1735111073,1735111073,-21600,MacBook
com.google.Chrome,2,1735111046,1735111048,1735111049,-21600,MacBook
com.adobe.Photoshop,5,1735111041,1735111046,1735111047,-21600,MacBook
com.google.Chrome,9,1735111032,1735111041,1735111042,-21600,MacBook
com.adobe.Photoshop,16,1735111016,1735111032,1735111032,-21600,MacBook
com.google.Chrome,4,1735111012,1735111016,1735111017,-21600,MacBook
com.adobe.Photoshop,32,1735110980,1735111012,1735111012,-21600,MacBook
com.google.Chrome,4,1735110976,1735110980,1735110980,-21600,MacBook
com.adobe.Photoshop,15,1735110961,1735110976,1735110977,-21600,MacBook
com.google.Chrome,35,1735110926,1735110961,1735110962,-21600,MacBook
com.adobe.Photoshop,1,1735110925,1735110926,1735110927,-21600,MacBook
com.google.Chrome,8,1735110917,1735110925,1735110926,-21600,MacBook
com.adobe.Photoshop,70,1735110847,1735110917,1735110918,-21600,MacBook
com.google.Chrome,18,1735110829,1735110847,1735110847,-21600,MacBook
notion.id,5,1735110824,1735110829,1735110830,-21600,MacBook
com.adobe.Photoshop,3,1735110821,1735110824,1735110824,-21600,MacBook
notion.id,1,1735110820,1735110821,1735110822,-21600,MacBook
com.adobe.Photoshop,115,1735110705,1735110820,1735110821,-21600,MacBook
com.google.Chrome,37,1735110668,1735110705,1735110706,-21600,MacBook
com.adobe.Photoshop,2,1735110666,1735110668,1735110669,-21600,MacBook
com.google.Chrome,11,1735110655,1735110666,1735110666,-21600,MacBook
com.adobe.Photoshop,2,1735110653,1735110655,1735110656,-21600,MacBook
com.google.Chrome,45,1735110608,1735110653,1735110655,-21600,MacBook
com.apple.finder,46,1735110562,1735110608,1735110609,-21600,MacBook
com.google.Chrome,158,1735110404,1735110562,1735110562,-21600,MacBook
notion.id,23,1735110381,1735110404,1735110404,-21600,MacBook
com.google.Chrome,2,1735110379,1735110381,1735110382,-21600,MacBook
notion.id,15,1735110364,1735110379,1735110379,-21600,MacBook
com.google.Chrome,45,1735110319,1735110364,1735110364,-21600,MacBook
notion.id,1,1735110318,1735110319,1735110320,-21600,MacBook
com.apple.finder,15,1735110303,1735110318,1735110319,-21600,MacBook
com.apple.Preview,7,1735110296,1735110303,1735110303,-21600,MacBook
com.apple.finder,12,1735110284,1735110296,1735110297,-21600,MacBook
com.sunsama.native-app,2,1735110282,1735110284,1735110284,-21600,MacBook
notion.id,67,1735110215,1735110282,1735110283,-21600,MacBook
com.google.Chrome,15,1735110200,1735110215,1735110216,-21600,MacBook
notion.id,3,1735110197,1735110200,1735110201,-21600,MacBook
com.google.Chrome,5,1735110192,1735110197,1735110197,-21600,MacBook
notion.id,233,1735109959,1735110192,1735110193,-21600,MacBook
com.google.Chrome,8,1735109951,1735109959,1735109960,-21600,MacBook
notion.id,3,1735109948,1735109951,1735109952,-21600,MacBook
com.google.Chrome,1775,1735108173,1735109948,1735109948,-21600,MacBook
com.tencent.xin,37,1735109830,1735109867,1735109867,-21600,iPhone
com.tencent.xin,166,1735109651,1735109817,1735109818,-21600,iPhone
com.xingin.discover,10,1735109639,1735109649,1735109649,-21600,iPhone
com.xingin.discover,6,1735109449,1735109455,1735109456,-21600,iPhone
com.xingin.discover,22,1735109426,1735109448,1735109449,-21600,iPhone
com.xingin.discover,131,1735109287,1735109418,1735109419,-21600,iPhone
com.xingin.discover,28,1735109257,1735109285,1735109285,-21600,iPhone
com.xingin.discover,109,1735109121,1735109230,1735109230,-21600,iPhone
com.tencent.xin,7,1735109114,1735109121,1735109122,-21600,iPhone
com.tencent.xin,5,1735109109,1735109114,1735109114,-21600,iPhone
com.tencent.xin,61,1735109041,1735109102,1735109103,-21600,iPhone
com.tencent.xin,90,1735108949,1735109039,1735109040,-21600,iPhone
com.xingin.discover,23,1735108926,1735108949,1735108950,-21600,iPhone
com.tencent.xin,33,1735108893,1735108926,1735108926,-21600,iPhone
com.xingin.discover,132,1735108761,1735108893,1735108893,-21600,iPhone
com.xingin.discover,303,1735108445,1735108748,1735108749,-21600,iPhone
com.tencent.xin,2,1735108439,1735108441,1735108441,-21600,iPhone
com.tencent.xin,10,1735108244,1735108254,1735108255,-21600,iPhone
com.microsoft.Office.Outlook,7,1735108237,1735108244,1735108245,-21600,iPhone
com.microsoft.Office.Outlook,5,1735108203,1735108208,1735108209,-21600,iPhone
com.microsoft.Office.Outlook,17,1735108180,1735108197,1735108198,-21600,iPhone
com.tencent.xin,4,1735108176,1735108180,1735108181,-21600,iPhone
com.tencent.xin,9,1735108132,1735108141,1735108141,-21600,iPhone
com.tencent.xin,211,1735107916,1735108127,1735108128,-21600,iPhone
com.tencent.xin,31,1735107856,1735107887,1735107888,-21600,iPhone
notion.id,1,1735107846,1735107847,1735107848,-21600,MacBook
com.sunsama.native-app,1,1735107845,1735107846,1735107847,-21600,MacBook
notion.id,129,1735107716,1735107845,1735107846,-21600,MacBook
com.google.Chrome,131,1735107585,1735107716,1735107717,-21600,MacBook
com.tencent.xin,96,1735107596,1735107692,1735107693,-21600,iPhone
notion.id,6,1735107579,1735107585,1735107585,-21600,MacBook
com.google.Chrome,15,1735107564,1735107579,1735107580,-21600,MacBook
notion.id,7,1735107557,1735107564,1735107565,-21600,MacBook
com.google.Chrome,3,1735107554,1735107557,1735107557,-21600,MacBook
notion.id,56,1735107498,1735107554,1735107554,-21600,MacBook
com.google.Chrome,4,1735107494,1735107498,1735107499,-21600,MacBook
notion.id,27,1735107467,1735107494,1735107494,-21600,MacBook
com.sunsama.native-app,2,1735107465,1735107467,1735107468,-21600,MacBook
com.google.Chrome,34,1735107431,1735107465,1735107466,-21600,MacBook
com.sunsama.native-app,5,1735107426,1735107431,1735107432,-21600,MacBook
com.tencent.xin,62,1735107364,1735107426,1735107426,-21600,iPhone
com.tencent.xin,265,1735107096,1735107361,1735107362,-21600,iPhone
com.sunsama.native-app,338,1735106749,1735107087,1735107087,-21600,MacBook
com.tencent.xin,77,1735106915,1735106992,1735106993,-21600,iPhone
com.tencent.xin,2,1735106911,1735106913,1735106913,-21600,iPhone
com.bilibili.bilicomic,31,1735106880,1735106911,1735106911,-21600,iPhone
com.bilibili.bilicomic,2,1735106876,1735106878,1735106878,-21600,iPhone
com.apple.Preferences,9,1735106867,1735106876,1735106876,-21600,iPhone
com.tencent.xin,65,1735106800,1735106865,1735106866,-21600,iPhone
com.apple.mobileslideshow,7,1735106790,1735106797,1735106798,-21600,iPhone
notion.id,18,1735106731,1735106749,1735106750,-21600,MacBook
com.google.Chrome,2,1735106729,1735106731,1735106731,-21600,MacBook
notion.id,2,1735106727,1735106729,1735106730,-21600,MacBook
com.google.Chrome,58,1735106669,1735106727,1735106728,-21600,MacBook
notion.id,9,1735106660,1735106669,1735106669,-21600,MacBook
com.google.Chrome,3,1735106657,1735106660,1735106660,-21600,MacBook
notion.id,18,1735106639,1735106657,1735106658,-21600,MacBook
com.google.Chrome,1,1735106638,1735106639,1735106640,-21600,MacBook
notion.id,1,1735106637,1735106638,1735106639,-21600,MacBook
com.google.Chrome,11,1735106626,1735106637,1735106638,-21600,MacBook
notion.id,5,1735106621,1735106626,1735106627,-21600,MacBook
com.google.Chrome,11,1735106610,1735106621,1735106622,-21600,MacBook
notion.id,11,1735106599,1735106610,1735106611,-21600,MacBook
com.google.Chrome,11,1735106588,1735106599,1735106600,-21600,MacBook
notion.id,10,1735106578,1735106588,1735106589,-21600,MacBook
com.google.Chrome,13,1735106565,1735106578,1735106578,-21600,MacBook
notion.id,42,1735106523,1735106565,1735106566,-21600,MacBook
com.google.Chrome,3,1735106520,1735106523,1735106524,-21600,MacBook
notion.id,16,1735106504,1735106520,1735106521,-21600,MacBook
com.google.Chrome,1,1735106503,1735106504,1735106505,-21600,MacBook
notion.id,6,1735106497,1735106503,1735106504,-21600,MacBook
com.google.Chrome,16,1735106481,1735106497,1735106497,-21600,MacBook
notion.id,9,1735106472,1735106481,1735106482,-21600,MacBook
com.google.Chrome,13,1735106459,1735106472,1735106473,-21600,MacBook
notion.id,49,1735106410,1735106459,1735106459,-21600,MacBook
com.google.Chrome,2,1735106408,1735106410,1735106411,-21600,MacBook
notion.id,1,1735106407,1735106408,1735106409,-21600,MacBook
com.google.Chrome,24,1735106383,1735106407,1735106407,-21600,MacBook
notion.id,16,1735106367,1735106383,1735106384,-21600,MacBook
com.google.Chrome,14,1735106353,1735106367,1735106368,-21600,MacBook
notion.id,50,1735106303,1735106353,1735106354,-21600,MacBook
com.google.Chrome,2,1735106301,1735106303,1735106304,-21600,MacBook
notion.id,4,1735106297,1735106301,1735106302,-21600,MacBook
com.google.Chrome,96,1735106201,1735106297,1735106297,-21600,MacBook
notion.id,452,1735105749,1735106201,1735106202,-21600,MacBook
com.apple.mail,6,1735105743,1735105749,1735105750,-21600,MacBook
notion.id,1,1735105742,1735105743,1735105744,-21600,MacBook
com.apple.mail,1,1735105741,1735105742,1735105743,-21600,MacBook
notion.id,494,1735105247,1735105741,1735105741,-21600,MacBook
com.sunsama.native-app,2,1735105245,1735105247,1735105247,-21600,MacBook
com.google.Chrome,1,1735105244,1735105245,1735105245,-21600,MacBook
notion.id,230,1735105014,1735105244,1735105245,-21600,MacBook
com.google.Chrome,2,1735105012,1735105014,1735105014,-21600,MacBook
notion.id,229,1735104783,1735105012,1735105012,-21600,MacBook
com.google.Chrome,13,1735104770,1735104783,1735104784,-21600,MacBook
notion.id,1,1735104769,1735104770,1735104771,-21600,MacBook
com.google.Chrome,6,1735104763,1735104769,1735104770,-21600,MacBook
notion.id,3,1735104760,1735104763,1735104764,-21600,MacBook
com.google.Chrome,12,1735104748,1735104760,1735104760,-21600,MacBook
notion.id,2,1735104746,1735104748,1735104749,-21600,MacBook
com.google.Chrome,2,1735104744,1735104746,1735104747,-21600,MacBook
notion.id,17,1735104727,1735104744,1735104744,-21600,MacBook
com.google.Chrome,3,1735104724,1735104727,1735104728,-21600,MacBook
notion.id,3,1735104721,1735104724,1735104724,-21600,MacBook
com.google.Chrome,7,1735104714,1735104721,1735104721,-21600,MacBook
notion.id,4,1735104710,1735104714,1735104714,-21600,MacBook
com.google.Chrome,9,1735104701,1735104710,1735104711,-21600,MacBook
notion.id,30,1735104671,1735104701,1735104701,-21600,MacBook
com.google.Chrome,8,1735104663,1735104671,1735104671,-21600,MacBook
notion.id,1,1735104662,1735104663,1735104664,-21600,MacBook
com.google.Chrome,22,1735104640,1735104662,1735104663,-21600,MacBook
com.sunsama.native-app,0,1735104640,1735104640,1735104642,-21600,MacBook
com.google.Chrome,9,1735104631,1735104640,1735104641,-21600,MacBook
com.sunsama.native-app,2,1735104629,1735104631,1735104632,-21600,MacBook
com.apple.finder,1,1735104628,1735104629,1735104630,-21600,MacBook
notion.id,10,1735104618,1735104628,1735104628,-21600,MacBook
com.google.Chrome,3,1735104615,1735104618,1735104618,-21600,MacBook
notion.id,49,1735104566,1735104615,1735104616,-21600,MacBook
com.google.Chrome,5,1735104561,1735104566,1735104567,-21600,MacBook
notion.id,15,1735104546,1735104561,1735104562,-21600,MacBook
com.google.Chrome,14,1735104532,1735104546,1735104546,-21600,MacBook
notion.id,127,1735104405,1735104532,1735104533,-21600,MacBook
com.google.Chrome,11,1735104394,1735104405,1735104406,-21600,MacBook
notion.id,4,1735104390,1735104394,1735104394,-21600,MacBook
com.google.Chrome,12,1735104378,1735104390,1735104391,-21600,MacBook
notion.id,0,1735104378,1735104378,1735104379,-21600,MacBook
com.google.Chrome,1,1735104377,1735104378,1735104378,-21600,MacBook
notion.id,309,1735104068,1735104377,1735104377,-21600,MacBook
com.google.Chrome,40,1735104028,1735104068,1735104068,-21600,MacBook
notion.id,20,1735104008,1735104028,1735104029,-21600,MacBook
com.google.Chrome,10,1735103998,1735104008,1735104008,-21600,MacBook
notion.id,21,1735103977,1735103998,1735103998,-21600,MacBook
com.google.Chrome,45,1735103932,1735103977,1735103978,-21600,MacBook
notion.id,0,1735103932,1735103932,1735103932,-21600,MacBook
com.google.Chrome,24,1735103908,1735103932,1735103932,-21600,MacBook
notion.id,10,1735103898,1735103908,1735103908,-21600,MacBook
com.google.Chrome,13,1735103885,1735103898,1735103898,-21600,MacBook
notion.id,73,1735103812,1735103885,1735103885,-21600,MacBook
com.google.Chrome,10,1735103802,1735103812,1735103812,-21600,MacBook
notion.id,36,1735103766,1735103802,1735103802,-21600,MacBook
com.google.Chrome,24,1735103742,1735103766,1735103766,-21600,MacBook
notion.id,7,1735103735,1735103742,1735103742,-21600,MacBook
com.google.Chrome,55,1735103680,1735103735,1735103735,-21600,MacBook
notion.id,148,1735103532,1735103680,1735103681,-21600,MacBook
com.apple.mobileslideshow,10,1735103641,1735103651,1735103652,-21600,iPhone
com.apple.mobileslideshow,10,1735103579,1735103589,1735103590,-21600,iPhone
com.google.Chrome,5,1735103527,1735103532,1735103533,-21600,MacBook
notion.id,8,1735103519,1735103527,1735103527,-21600,MacBook
com.google.Chrome,118,1735103401,1735103519,1735103520,-21600,MacBook
com.apple.finder,1,1735103400,1735103401,1735103402,-21600,MacBook
com.google.Chrome,163,1735103237,1735103400,1735103400,-21600,MacBook
com.apple.finder,1,1735103236,1735103237,1735103238,-21600,MacBook
notion.id,1,1735103235,1735103236,1735103237,-21600,MacBook
com.apple.finder,2,1735103233,1735103235,1735103236,-21600,MacBook
com.apple.Preview,11,1735103222,1735103233,1735103233,-21600,MacBook
com.apple.finder,9,1735103213,1735103222,1735103223,-21600,MacBook
com.apple.Preview,4,1735103209,1735103213,1735103214,-21600,MacBook
com.apple.finder,19,1735103190,1735103209,1735103210,-21600,MacBook
com.apple.mobileslideshow,72,1735103121,1735103193,1735103193,-21600,iPhone
com.google.Chrome,5,1735103185,1735103190,1735103191,-21600,MacBook
com.apple.finder,22,1735103163,1735103185,1735103186,-21600,MacBook
com.sunsama.native-app,5,1735103158,1735103163,1735103163,-21600,MacBook
notion.id,1,1735103157,1735103158,1735103158,-21600,MacBook
com.google.Chrome,804,1735102353,1735103157,1735103157,-21600,MacBook
com.apple.camera,16,1735103095,1735103111,1735103112,-21600,iPhone
com.apple.camera,7,1735103075,1735103082,1735103084,-21600,iPhone
com.tencent.xin,171,1735102903,1735103074,1735103075,-21600,iPhone
com.tinyspeck.chatlyio,9,1735102894,1735102903,1735102903,-21600,iPhone
com.tencent.xin,1,1735102893,1735102894,1735102895,-21600,iPhone
com.xingin.discover,2,1735102890,1735102892,1735102893,-21600,iPhone
notion.id,2,1735102351,1735102353,1735102353,-21600,MacBook
com.sunsama.native-app,25,1735102326,1735102351,1735102351,-21600,MacBook
notion.id,1,1735102325,1735102326,1735102327,-21600,MacBook
com.sunsama.native-app,5,1735102320,1735102325,1735102325,-21600,MacBook
com.google.Chrome,35,1735102285,1735102320,1735102321,-21600,MacBook
notion.id,3,1735102117,1735102120,1735102120,-21600,MacBook
com.google.Chrome,2,1735102115,1735102117,1735102118,-21600,MacBook
notion.id,8,1735102107,1735102115,1735102115,-21600,MacBook
com.sunsama.native-app,2,1735102105,1735102107,1735102107,-21600,MacBook
com.google.Chrome,87,1735102018,1735102105,1735102106,-21600,MacBook
com.sunsama.native-app,104,1735101914,1735102018,1735102019,-21600,MacBook
com.xingin.discover,6,1735101924,1735101930,1735101931,-21600,iPhone
com.apple.finder,6,1735101908,1735101914,1735101924,-21600,MacBook
com.apple.finder,6,1735101912,1735101918,1735101919,-21600,MacBook
com.xingin.discover,215,1735100946,1735101161,1735101162,-21600,iPhone
com.xingin.discover,2077,1735098798,1735100875,1735100876,-21600,iPhone
com.apple.MobileSMS,3,1735098795,1735098798,1735098798,-21600,iPhone
com.xingin.discover,1,1735098792,1735098793,1735098793,-21600,iPhone
com.tencent.xin,26,1735098764,1735098790,1735098790,-21600,iPhone
com.tencent.xin,1276,1735097476,1735098752,1735098753,-21600,iPhone
com.apple.mobileslideshow,36,1735097440,1735097476,1735097477,-21600,iPhone
com.tencent.xin,62,1735097377,1735097439,1735097440,-21600,iPhone
com.tencent.xin,10,1735097237,1735097247,1735097247,-21600,iPhone
com.tencent.xin,6,1735097129,1735097135,1735097135,-21600,iPhone
com.tencent.xin,5,1735097107,1735097112,1735097113,-21600,iPhone
com.tencent.xin,4,1735097101,1735097105,1735097105,-21600,iPhone
com.apple.camera,0,1735097102,1735097102,1735097103,-21600,iPhone
com.tencent.xin,28,1735097072,1735097100,1735097100,-21600,iPhone
com.tencent.xin,6,1735095725,1735095731,1735095731,-21600,iPhone
com.tencent.xin,1,1735095689,1735095690,1735095690,-21600,iPhone
com.tencent.xin,1,1735095678,1735095679,1735095679,-21600,iPhone
com.tencent.xin,22,1735095640,1735095662,1735095663,-21600,iPhone
com.tencent.xin,5,1735095623,1735095628,1735095629,-21600,iPhone
com.apple.camera,0,1735095624,1735095624,1735095625,-21600,iPhone
com.tencent.xin,3,1735095617,1735095620,1735095621,-21600,iPhone
com.tencent.xin,6,1735095551,1735095557,1735095557,-21600,iPhone
com.tencent.xin,2,1735095546,1735095548,1735095548,-21600,iPhone
com.tencent.xin,1,1735095542,1735095543,1735095544,-21600,iPhone
com.tencent.xin,146,1735095392,1735095538,1735095539,-21600,iPhone
com.apple.PassbookUIService,1,1735095389,1735095390,1735095391,-21600,iPhone
com.google.chrome.ios,4,1735095032,1735095036,1735095037,-21600,iPhone
com.google.chrome.ios,9,1735093629,1735093638,1735093639,-21600,iPhone
com.apple.MobileSMS,3,1735093624,1735093627,1735093627,-21600,iPhone
com.apple.MobileSMS,4,1735093603,1735093607,1735093607,-21600,iPhone
com.xingin.discover,19,1735093581,1735093600,1735093601,-21600,iPhone
com.apple.PassbookUIService,32,1735092948,1735092980,1735092980,-21600,iPhone
com.xingin.discover,33,1735092947,1735092980,1735092980,-21600,iPhone
com.xingin.discover,2,1735092944,1735092946,1735092946,-21600,iPhone
com.xingin.discover,301,1735092642,1735092943,1735092943,-21600,iPhone
com.xingin.discover,16,1735092610,1735092626,1735092626,-21600,iPhone
com.tencent.xin,1,1735092608,1735092609,1735092610,-21600,iPhone
com.google.chrome.ios,5,1735092599,1735092604,1735092605,-21600,iPhone
com.google.chrome.ios,1,1735092591,1735092592,1735092593,-21600,iPhone
com.google.chrome.ios,72,1735091718,1735091790,1735091791,-21600,iPhone
com.tencent.xin,2,1735091715,1735091717,1735091718,-21600,iPhone
com.tencent.xin,45,1735090857,1735090902,1735090903,-21600,iPhone
com.apple.camera,20,1735089779,1735089799,1735089800,-21600,iPhone
com.apple.camera,3,1735089764,1735089767,1735089768,-21600,iPhone
com.apple.camera,25,1735089730,1735089755,1735089756,-21600,iPhone
com.apple.camera,4,1735088617,1735088621,1735088622,-21600,iPhone
com.xingin.discover,19,1735088576,1735088595,1735088596,-21600,iPhone
com.apple.camera,21,1735088550,1735088571,1735088579,-21600,iPhone
com.google.Maps,18,1735088540,1735088558,1735088559,-21600,iPhone
com.google.Maps,9,1735087400,1735087409,1735087410,-21600,iPhone
com.microsoft.Office.Outlook,2,1735087398,1735087400,1735087401,-21600,iPhone
com.microsoft.Office.Outlook,6,1735087176,1735087182,1735087183,-21600,iPhone
com.microsoft.Office.Outlook,1,1735087154,1735087155,1735087156,-21600,iPhone
com.apple.PassbookUIService,60,1735086858,1735086918,1735086919,-21600,iPhone
com.microsoft.Office.Outlook,70,1735086848,1735086918,1735086919,-21600,iPhone
com.tencent.xin,3,1735086845,1735086848,1735086848,-21600,iPhone
com.tencent.xin,17,1735086419,1735086436,1735086437,-21600,iPhone
com.tencent.xin,33,1735085722,1735085755,1735085756,-21600,iPhone
com.xingin.discover,2,1735085720,1735085722,1735085723,-21600,iPhone
com.apple.finder,2,1735085526,1735085528,1735085529,-21600,MacBook
com.sunsama.native-app,35,1735085491,1735085526,1735085526,-21600,MacBook
notion.id,8,1735085483,1735085491,1735085492,-21600,MacBook
com.google.Chrome,1,1735085482,1735085483,1735085483,-21600,MacBook
notion.id,463,1735085019,1735085482,1735085482,-21600,MacBook
com.google.Chrome,1,1735085018,1735085019,1735085020,-21600,MacBook
com.apple.Preview,1,1735085017,1735085018,1735085019,-21600,MacBook
com.apple.mail,4,1735085013,1735085017,1735085018,-21600,MacBook
notion.id,8,1735085005,1735085013,1735085013,-21600,MacBook
com.google.Chrome,1,1735085004,1735085005,1735085005,-21600,MacBook
notion.id,49,1735084955,1735085004,1735085005,-21600,MacBook
com.google.Chrome,26,1735084929,1735084955,1735084956,-21600,MacBook
notion.id,82,1735084847,1735084929,1735084930,-21600,MacBook
com.apple.mail,8,1735084839,1735084847,1735084848,-21600,MacBook
com.google.Chrome,11,1735084828,1735084839,1735084839,-21600,MacBook
com.apple.Notes,1,1735084827,1735084828,1735084828,-21600,MacBook
notion.id,328,1735084499,1735084827,1735084827,-21600,MacBook
com.apple.Notes,3,1735084496,1735084499,1735084500,-21600,MacBook
com.sunsama.native-app,0,1735084496,1735084496,1735084496,-21600,MacBook
notion.id,233,1735084263,1735084496,1735084496,-21600,MacBook
com.google.Chrome,9,1735084254,1735084263,1735084263,-21600,MacBook
notion.id,185,1735084069,1735084254,1735084255,-21600,MacBook
com.sunsama.native-app,17,1735084052,1735084069,1735084069,-21600,MacBook
com.apple.Preview,1,1735084051,1735084052,1735084053,-21600,MacBook
com.google.Chrome,3,1735084048,1735084051,1735084052,-21600,MacBook
notion.id,1,1735084047,1735084048,1735084049,-21600,MacBook
com.google.Chrome,2,1735084045,1735084047,1735084047,-21600,MacBook
notion.id,4,1735084041,1735084045,1735084046,-21600,MacBook
com.google.Chrome,16,1735084025,1735084041,1735084042,-21600,MacBook
notion.id,2,1735084023,1735084025,1735084025,-21600,MacBook
com.google.Chrome,27,1735083996,1735084023,1735084024,-21600,MacBook
notion.id,11,1735083985,1735083996,1735083996,-21600,MacBook
com.google.Chrome,1,1735083984,1735083985,1735083986,-21600,MacBook
notion.id,10,1735083974,1735083984,1735083984,-21600,MacBook
com.google.Chrome,3,1735083971,1735083974,1735083975,-21600,MacBook
notion.id,9,1735083962,1735083971,1735083971,-21600,MacBook
com.google.Chrome,14,1735083948,1735083962,1735083963,-21600,MacBook
notion.id,3,1735083945,1735083948,1735083949,-21600,MacBook
com.google.Chrome,5,1735083940,1735083945,1735083945,-21600,MacBook
notion.id,3,1735083937,1735083940,1735083941,-21600,MacBook
com.google.Chrome,3,1735083934,1735083937,1735083937,-21600,MacBook
notion.id,1,1735083933,1735083934,1735083935,-21600,MacBook
com.google.Chrome,2,1735083931,1735083933,1735083934,-21600,MacBook
notion.id,1,1735083930,1735083931,1735083932,-21600,MacBook
com.google.Chrome,3,1735083927,1735083930,1735083931,-21600,MacBook
notion.id,28,1735083899,1735083927,1735083928,-21600,MacBook
com.google.Chrome,11,1735083888,1735083899,1735083900,-21600,MacBook
notion.id,5,1735083883,1735083888,1735083889,-21600,MacBook
com.google.Chrome,1,1735083882,1735083883,1735083884,-21600,MacBook
notion.id,29,1735083853,1735083882,1735083883,-21600,MacBook
com.google.Chrome,60,1735083793,1735083853,1735083853,-21600,MacBook
notion.id,13,1735083780,1735083793,1735083793,-21600,MacBook
com.google.Chrome,138,1735083642,1735083780,1735083781,-21600,MacBook
notion.id,3,1735083639,1735083642,1735083642,-21600,MacBook
com.google.Chrome,1,1735083638,1735083639,1735083639,-21600,MacBook
notion.id,8,1735083630,1735083638,1735083638,-21600,MacBook
com.google.Chrome,17,1735083613,1735083630,1735083631,-21600,MacBook
notion.id,7,1735083606,1735083613,1735083614,-21600,MacBook
com.google.Chrome,190,1735083416,1735083606,1735083607,-21600,MacBook
notion.id,1,1735083415,1735083416,1735083417,-21600,MacBook
com.google.Chrome,125,1735083290,1735083415,1735083415,-21600,MacBook
com.xingin.discover,1,1735083285,1735083286,1735083286,-21600,iPhone
com.xingin.discover,6,1735083279,1735083285,1735083285,-21600,iPhone
com.xingin.discover,253,1735083002,1735083255,1735083256,-21600,iPhone
com.microsoft.Office.Outlook,2,1735083000,1735083002,1735083002,-21600,iPhone
com.xingin.discover,306,1735082694,1735083000,1735083001,-21600,iPhone
com.tencent.xin,1,1735082693,1735082694,1735082695,-21600,iPhone
com.xingin.discover,697,1735081996,1735082693,1735082694,-21600,iPhone
com.xingin.discover,1,1735081994,1735081995,1735081996,-21600,iPhone
tv.danmaku.bilianime,1,1735081988,1735081989,1735081990,-21600,iPhone
com.bilibili.bilicomic,2,1735081986,1735081988,1735081988,-21600,iPhone
com.tencent.xin,20,1735081964,1735081984,1735081984,-21600,iPhone
com.tencent.xin,37,1735081886,1735081923,1735081924,-21600,iPhone
com.tencent.xin,13,1735081857,1735081870,1735081871,-21600,iPhone
com.tencent.xin,2,1735081854,1735081856,1735081856,-21600,iPhone
com.facebook.Facebook,15,1735081837,1735081852,1735081852,-21600,iPhone
com.google.Chrome,57,1735081776,1735081833,1735081833,-21600,MacBook
notion.id,41,1735081735,1735081776,1735081777,-21600,MacBook
com.google.Chrome,1,1735081734,1735081735,1735081736,-21600,MacBook
notion.id,1,1735081733,1735081734,1735081735,-21600,MacBook
com.google.Chrome,14,1735081719,1735081733,1735081734,-21600,MacBook
notion.id,2,1735081717,1735081719,1735081719,-21600,MacBook
com.google.Chrome,33,1735081684,1735081717,1735081718,-21600,MacBook
notion.id,1,1735081683,1735081684,1735081685,-21600,MacBook
com.google.Chrome,1,1735081682,1735081683,1735081683,-21600,MacBook
notion.id,50,1735081632,1735081682,1735081683,-21600,MacBook
com.google.Chrome,1,1735081631,1735081632,1735081633,-21600,MacBook
notion.id,2,1735081629,1735081631,1735081632,-21600,MacBook
com.google.Chrome,2,1735081627,1735081629,1735081630,-21600,MacBook
notion.id,4,1735081623,1735081627,1735081628,-21600,MacBook
com.google.Chrome,3,1735081620,1735081623,1735081624,-21600,MacBook
notion.id,47,1735081573,1735081620,1735081620,-21600,MacBook
com.google.Chrome,14,1735081559,1735081573,1735081573,-21600,MacBook
notion.id,16,1735081543,1735081559,1735081560,-21600,MacBook
com.google.Chrome,3,1735081540,1735081543,1735081544,-21600,MacBook
notion.id,14,1735081526,1735081540,1735081541,-21600,MacBook
com.google.Chrome,10,1735081516,1735081526,1735081526,-21600,MacBook
notion.id,1,1735081515,1735081516,1735081517,-21600,MacBook
com.google.Chrome,3,1735081512,1735081515,1735081516,-21600,MacBook
notion.id,3,1735081509,1735081512,1735081513,-21600,MacBook
com.google.Chrome,10,1735081499,1735081509,1735081510,-21600,MacBook
notion.id,55,1735081444,1735081499,1735081500,-21600,MacBook
com.google.Chrome,2,1735081442,1735081444,1735081445,-21600,MacBook
notion.id,10,1735081432,1735081442,1735081443,-21600,MacBook
com.google.Chrome,16,1735081416,1735081432,1735081433,-21600,MacBook
notion.id,96,1735081320,1735081416,1735081417,-21600,MacBook
com.google.Chrome,64,1735081256,1735081320,1735081320,-21600,MacBook
notion.id,56,1735081200,1735081256,1735081256,-21600,MacBook
com.google.Chrome,53,1735081147,1735081200,1735081201,-21600,MacBook
notion.id,157,1735080990,1735081147,1735081148,-21600,MacBook
com.google.Chrome,5,1735080985,1735080990,1735080990,-21600,MacBook
notion.id,12,1735080973,1735080985,1735080986,-21600,MacBook
com.google.Chrome,4,1735080969,1735080973,1735080974,-21600,MacBook
notion.id,22,1735080947,1735080969,1735080970,-21600,MacBook
com.google.Chrome,2,1735080945,1735080947,1735080948,-21600,MacBook
notion.id,83,1735080862,1735080945,1735080946,-21600,MacBook
com.google.Chrome,42,1735080820,1735080862,1735080863,-21600,MacBook
notion.id,179,1735080641,1735080820,1735080821,-21600,MacBook
com.google.Chrome,12,1735080629,1735080641,1735080641,-21600,MacBook
notion.id,69,1735080560,1735080629,1735080630,-21600,MacBook
com.google.Chrome,92,1735080468,1735080560,1735080561,-21600,MacBook
notion.id,2,1735080466,1735080468,1735080468,-21600,MacBook
com.google.Chrome,15,1735080451,1735080466,1735080466,-21600,MacBook
notion.id,3,1735080448,1735080451,1735080452,-21600,MacBook
com.google.Chrome,5,1735080443,1735080448,1735080449,-21600,MacBook
notion.id,5,1735080438,1735080443,1735080443,-21600,MacBook
com.google.Chrome,129,1735080309,1735080438,1735080439,-21600,MacBook
notion.id,3,1735080306,1735080309,1735080310,-21600,MacBook
com.google.Chrome,3,1735080303,1735080306,1735080307,-21600,MacBook
notion.id,53,1735080250,1735080303,1735080303,-21600,MacBook
com.google.Chrome,2,1735080248,1735080250,1735080251,-21600,MacBook
notion.id,3,1735080245,1735080248,1735080249,-21600,MacBook
com.google.Chrome,1,1735080244,1735080245,1735080246,-21600,MacBook
notion.id,2,1735080242,1735080244,1735080245,-21600,MacBook
com.google.Chrome,8,1735080234,1735080242,1735080242,-21600,MacBook
notion.id,30,1735080204,1735080234,1735080235,-21600,MacBook
com.google.Chrome,10,1735080194,1735080204,1735080205,-21600,MacBook
notion.id,22,1735080172,1735080194,1735080195,-21600,MacBook
com.google.Chrome,22,1735080150,1735080172,1735080173,-21600,MacBook
notion.id,4,1735080146,1735080150,1735080150,-21600,MacBook
com.google.Chrome,24,1735080122,1735080146,1735080146,-21600,MacBook
notion.id,1,1735080121,1735080122,1735080122,-21600,MacBook
com.google.Chrome,6,1735080115,1735080121,1735080121,-21600,MacBook
notion.id,6,1735080109,1735080115,1735080116,-21600,MacBook
com.google.Chrome,1,1735080108,1735080109,1735080110,-21600,MacBook
notion.id,26,1735080082,1735080108,1735080108,-21600,MacBook
com.google.Chrome,2,1735080080,1735080082,1735080082,-21600,MacBook
notion.id,16,1735080064,1735080080,1735080081,-21600,MacBook
com.google.Chrome,1,1735080063,1735080064,1735080065,-21600,MacBook
notion.id,1,1735080062,1735080063,1735080063,-21600,MacBook
com.google.Chrome,92,1735079970,1735080062,1735080062,-21600,MacBook
notion.id,77,1735079893,1735079970,1735079970,-21600,MacBook
com.google.Chrome,9,1735079884,1735079893,1735079894,-21600,MacBook
notion.id,17,1735079867,1735079884,1735079884,-21600,MacBook
com.google.Chrome,11,1735079856,1735079867,1735079868,-21600,MacBook
notion.id,36,1735079820,1735079856,1735079856,-21600,MacBook
com.google.Chrome,1,1735079819,1735079820,1735079821,-21600,MacBook
notion.id,4,1735079815,1735079819,1735079820,-21600,MacBook
com.google.Chrome,2,1735079813,1735079815,1735079815,-21600,MacBook
notion.id,8,1735079805,1735079813,1735079813,-21600,MacBook
com.google.Chrome,1,1735079804,1735079805,1735079806,-21600,MacBook
notion.id,7,1735079797,1735079804,1735079804,-21600,MacBook
com.google.Chrome,1,1735079796,1735079797,1735079798,-21600,MacBook
notion.id,10,1735079786,1735079796,1735079797,-21600,MacBook
com.google.Chrome,1,1735079785,1735079786,1735079787,-21600,MacBook
notion.id,2,1735079783,1735079785,1735079785,-21600,MacBook
com.google.Chrome,15,1735079768,1735079783,1735079784,-21600,MacBook
notion.id,13,1735079755,1735079768,1735079768,-21600,MacBook
com.google.Chrome,2,1735079753,1735079755,1735079756,-21600,MacBook
notion.id,3,1735079750,1735079753,1735079753,-21600,MacBook
com.google.Chrome,40,1735079710,1735079750,1735079751,-21600,MacBook
notion.id,10,1735079700,1735079710,1735079711,-21600,MacBook
com.google.Chrome,40,1735079660,1735079700,1735079700,-21600,MacBook
notion.id,4,1735079656,1735079660,1735079661,-21600,MacBook
com.google.Chrome,8,1735079648,1735079656,1735079657,-21600,MacBook
notion.id,19,1735079629,1735079648,1735079649,-21600,MacBook
com.google.Chrome,295,1735079334,1735079629,1735079629,-21600,MacBook
notion.id,8,1735079326,1735079334,1735079334,-21600,MacBook
com.google.Chrome,238,1735079088,1735079326,1735079326,-21600,MacBook
com.apple.Preview,3,1735079085,1735079088,1735079089,-21600,MacBook
notion.id,3,1735079082,1735079085,1735079085,-21600,MacBook
com.apple.Preview,22,1735079060,1735079082,1735079083,-21600,MacBook
notion.id,15,1735079045,1735079060,1735079061,-21600,MacBook
com.apple.Preview,102,1735078943,1735079045,1735079045,-21600,MacBook
com.apple.finder,1,1735078942,1735078943,1735078943,-21600,MacBook
com.apple.Preview,2,1735078940,1735078942,1735078943,-21600,MacBook
com.apple.finder,19,1735078921,1735078940,1735078941,-21600,MacBook
com.google.Chrome,37,1735078884,1735078921,1735078922,-21600,MacBook
notion.id,10,1735078874,1735078884,1735078885,-21600,MacBook
com.google.Chrome,1,1735078873,1735078874,1735078875,-21600,MacBook
notion.id,6,1735078867,1735078873,1735078874,-21600,MacBook
com.google.Chrome,2,1735078865,1735078867,1735078867,-21600,MacBook
notion.id,5,1735078860,1735078865,1735078866,-21600,MacBook
com.google.Chrome,1,1735078859,1735078860,1735078861,-21600,MacBook
notion.id,1,1735078858,1735078859,1735078859,-21600,MacBook
com.google.Chrome,2,1735078856,1735078858,1735078858,-21600,MacBook
notion.id,32,1735078824,1735078856,1735078856,-21600,MacBook
com.google.Chrome,164,1735078660,1735078824,1735078825,-21600,MacBook
com.apple.finder,1,1735078659,1735078660,1735078661,-21600,MacBook
notion.id,1,1735078658,1735078659,1735078660,-21600,MacBook
com.google.Chrome,340,1735078318,1735078658,1735078659,-21600,MacBook
notion.id,1,1735078317,1735078318,1735078319,-21600,MacBook
com.apple.finder,3,1735078314,1735078317,1735078318,-21600,MacBook
com.sunsama.native-app,8,1735078306,1735078314,1735078315,-21600,MacBook
notion.id,1,1735078305,1735078306,1735078306,-21600,MacBook
com.google.Chrome,112,1735078193,1735078305,1735078305,-21600,MacBook
notion.id,82,1735078111,1735078193,1735078193,-21600,MacBook
com.apple.Notes,4,1735078107,1735078111,1735078112,-21600,MacBook
notion.id,4,1735078103,1735078107,1735078108,-21600,MacBook
com.sunsama.native-app,0,1735078103,1735078103,1735078104,-21600,MacBook
com.google.Chrome,5,1735078098,1735078103,1735078103,-21600,MacBook
com.sunsama.native-app,34,1735078064,1735078098,1735078098,-21600,MacBook
com.apple.Notes,3,1735078061,1735078064,1735078064,-21600,MacBook
com.google.Chrome,8,1735078053,1735078061,1735078061,-21600,MacBook
com.facebook.Facebook,392,1735077662,1735078054,1735078054,-21600,iPhone
com.google.Chrome,337,1735077589,1735077926,1735077926,-21600,MacBook
com.facebook.Messenger,29,1735077633,1735077662,1735077662,-21600,iPhone
com.facebook.Facebook,5,1735077628,1735077633,1735077633,-21600,iPhone
com.facebook.Facebook,19,1735077608,1735077627,1735077628,-21600,iPhone
com.facebook.Messenger,1,1735077607,1735077608,1735077609,-21600,iPhone
com.facebook.Facebook,5,1735077602,1735077607,1735077608,-21600,iPhone
com.facebook.Messenger,33,1735077569,1735077602,1735077602,-21600,iPhone
com.sunsama.native-app,140,1735077449,1735077589,1735077590,-21600,MacBook
com.facebook.Facebook,9,1735077560,1735077569,1735077570,-21600,iPhone
com.facebook.Messenger,13,1735077547,1735077560,1735077561,-21600,iPhone
com.tinyspeck.chatlyio,13,1735077529,1735077542,1735077543,-21600,iPhone
com.tinyspeck.chatlyio,2,1735077523,1735077525,1735077525,-21600,iPhone
com.google.Maps,7,1735077516,1735077523,1735077524,-21600,iPhone
com.apple.Notes,2,1735077447,1735077449,1735077449,-21600,MacBook
com.sunsama.native-app,104,1735077343,1735077447,1735077447,-21600,MacBook
com.apple.Notes,5,1735077338,1735077343,1735077344,-21600,MacBook
com.google.Chrome,2056,1735075282,1735077338,1735077338,-21600,MacBook
com.sunsama.native-app,1,1735075281,1735075282,1735075283,-21600,MacBook
com.apple.Notes,1,1735075280,1735075281,1735075282,-21600,MacBook
com.sunsama.native-app,2,1735075278,1735075280,1735075280,-21600,MacBook
com.tinyspeck.slackmacgap,2,1735075276,1735075278,1735075279,-21600,MacBook
com.sunsama.native-app,1,1735075275,1735075276,1735075276,-21600,MacBook
com.tinyspeck.slackmacgap,3,1735075272,1735075275,1735075275,-21600,MacBook
com.apple.Notes,0,1735075272,1735075272,1735075273,-21600,MacBook
com.tinyspeck.slackmacgap,1,1735075271,1735075272,1735075272,-21600,MacBook
com.apple.Notes,2,1735075269,1735075271,1735075272,-21600,MacBook
com.google.Chrome,1,1735075268,1735075269,1735075270,-21600,MacBook
com.tinyspeck.slackmacgap,0,1735075268,1735075268,1735075270,-21600,MacBook
com.google.Chrome,6,1735075262,1735075268,1735075269,-21600,MacBook
com.sunsama.native-app,2,1735075260,1735075262,1735075264,-21600,MacBook
com.google.Chrome,13,1735075247,1735075260,1735075260,-21600,MacBook
com.google.Maps,70,1735074979,1735075049,1735075050,-21600,iPhone
com.apple.AppStore,26,1735074952,1735074978,1735074979,-21600,iPhone
com.google.Maps,42,1735074908,1735074950,1735074951,-21600,iPhone
com.burbn.instagram,112,1735074785,1735074897,1735074898,-21600,iPhone
com.burbn.instagram,49,1735074718,1735074767,1735074768,-21600,iPhone
com.xingin.discover,3,1735074712,1735074715,1735074716,-21600,iPhone
com.apple.PosterBoard,0,1735074713,1735074713,1735074714,-21600,iPhone
com.apple.camera,27,1735073018,1735073045,1735073047,-21600,iPhone
com.xingin.discover,28,1735073017,1735073045,1735073047,-21600,iPhone
com.xingin.discover,6,1735073008,1735073014,1735073014,-21600,iPhone
com.xingin.discover,88,1735072732,1735072820,1735072820,-21600,iPhone
com.sunsama.mobile,2,1735072728,1735072730,1735072731,-21600,iPhone
com.sunsama.mobile,26,1735072698,1735072724,1735072725,-21600,iPhone
com.sunsama.mobile,6,1735072593,1735072599,1735072600,-21600,iPhone
com.sunsama.mobile,6,1735072585,1735072591,1735072592,-21600,iPhone
com.sunsama.mobile,2,1735072582,1735072584,1735072585,-21600,iPhone
com.sunsama.mobile,1,1735072560,1735072561,1735072562,-21600,iPhone
com.sunsama.mobile,4,1735072535,1735072539,1735072539,-21600,iPhone
com.sunsama.mobile,5,1735072503,1735072508,1735072509,-21600,iPhone
com.apple.camera,6,1735072495,1735072501,1735072503,-21600,iPhone
com.apple.camera,6,1735072485,1735072491,1735072494,-21600,iPhone
com.apple.camera,6,1735072477,1735072483,1735072494,-21600,iPhone
com.apple.camera,9,1735072466,1735072475,1735072481,-21600,iPhone
com.apple.camera,39,1735072416,1735072455,1735072479,-21600,iPhone
com.google.Maps,34,1735072382,1735072416,1735072416,-21600,iPhone
com.sunsama.mobile,3,1735072377,1735072380,1735072381,-21600,iPhone
com.sunsama.mobile,11,1735072347,1735072358,1735072358,-21600,iPhone
com.sunsama.mobile,31,1735071531,1735071562,1735071563,-21600,iPhone
com.google.calendar,1,1735071528,1735071529,1735071529,-21600,iPhone
com.sunsama.mobile,2,1735071526,1735071528,1735071529,-21600,iPhone
com.sunsama.mobile,10,1735070827,1735070837,1735070838,-21600,iPhone
com.sunsama.mobile,6,1735070819,1735070825,1735070825,-21600,iPhone
com.ubixinnovations.kiosoft.cleanpaymobile,58,1735070760,1735070818,1735070818,-21600,iPhone
com.tencent.xin,7,1735070752,1735070759,1735070760,-21600,iPhone
com.tencent.xin,12,1735070028,1735070040,1735070041,-21600,iPhone
com.tencent.xin,11,1735069515,1735069526,1735069527,-21600,iPhone
com.amazon.Amazon,13,1735069501,1735069514,1735069514,-21600,iPhone
com.microsoft.Office.Outlook,4,1735069497,1735069501,1735069502,-21600,iPhone
com.amazon.Amazon,2,1735069495,1735069497,1735069498,-21600,iPhone
com.microsoft.Office.Outlook,3,1735069491,1735069494,1735069494,-21600,iPhone
com.tencent.xin,109,1735069381,1735069490,1735069491,-21600,iPhone
com.apple.camera,0,1735069382,1735069382,1735069383,-21600,iPhone
com.apple.mobilesafari,1,1735069317,1735069318,1735069318,-21600,iPad
com.apple.mobilesafari,791,1735068354,1735069145,1735069147,-21600,iPad
com.tencent.xin,94,1735068193,1735068287,1735068288,-21600,iPhone
com.microsoft.Office.Outlook,1,1735068192,1735068193,1735068194,-21600,iPhone
com.tencent.xin,1,1735068191,1735068192,1735068193,-21600,iPhone
com.microsoft.Office.Outlook,2,1735068188,1735068190,1735068190,-21600,iPhone
com.apple.mobilenotes,3,1735068185,1735068188,1735068189,-21600,iPhone
com.apple.mobilesafari,0,1735068124,1735068124,1735068125,-21600,iPad
com.apple.mobilesafari,627,1735067484,1735068111,1735068112,-21600,iPad
com.apple.mobilenotes,37,1735067624,1735067661,1735067662,-21600,iPhone
com.apple.mobilenotes,6,1735067617,1735067623,1735067624,-21600,iPhone
com.apple.podcasts,6,1735067478,1735067484,1735067485,-21600,iPad
com.apple.mobilesafari,33,1735067445,1735067478,1735067479,-21600,iPad
com.apple.podcasts,7,1735067438,1735067445,1735067445,-21600,iPad
com.apple.mobilesafari,346,1735067092,1735067438,1735067439,-21600,iPad
com.apple.podcasts,6,1735067086,1735067092,1735067092,-21600,iPad
com.apple.mobilesafari,105,1735066981,1735067086,1735067086,-21600,iPad
com.apple.podcasts,7,1735066974,1735066981,1735066981,-21600,iPad
com.apple.mobilesafari,7,1735066967,1735066974,1735066975,-21600,iPad
com.apple.podcasts,6,1735066961,1735066967,1735066967,-21600,iPad
com.apple.mobilesafari,786,1735066175,1735066961,1735066962,-21600,iPad
com.ubixinnovations.kiosoft.cleanpaymobile,5,1735066565,1735066570,1735066571,-21600,iPhone
com.sunsama.mobile,6,1735066559,1735066565,1735066566,-21600,iPhone
com.apple.podcasts,10,1735066165,1735066175,1735066176,-21600,iPad
com.apple.mobilesafari,22,1735066143,1735066165,1735066166,-21600,iPad
com.sunsama.mobile,2,1735066131,1735066133,1735066133,-21600,iPhone
com.sunsama.mobile,73,1735065865,1735065938,1735065939,-21600,iPhone
com.tencent.xin,4,1735065835,1735065839,1735065840,-21600,iPhone
com.tencent.xin,10,1735065600,1735065610,1735065611,-21600,iPhone
com.tencent.xin,6,1735065333,1735065339,1735065339,-21600,iPhone
com.tencent.xin,6,1735065325,1735065331,1735065332,-21600,iPhone
com.tencent.xin,9,1735065193,1735065202,1735065203,-21600,iPhone
com.apple.mobiletimer,19,1735065174,1735065193,1735065193,-21600,iPhone
com.microsoft.Office.Outlook,2,1735065171,1735065173,1735065174,-21600,iPhone
com.ubixinnovations.kiosoft.cleanpaymobile,81,1735065089,1735065170,1735065170,-21600,iPhone
com.yardi.rentcafe.resident,2,1735065087,1735065089,1735065089,-21600,iPhone
com.microsoft.Office.Outlook,2,1735065085,1735065087,1735065087,-21600,iPhone
com.tencent.xin,2,1735064524,1735064526,1735064526,-21600,iPhone
com.tencent.xin,10,1735064514,1735064524,1735064524,-21600,iPhone
com.apple.camera,0,1735064522,1735064522,1735064524,-21600,iPhone
com.apple.camera,2,1735064520,1735064522,1735064523,-21600,iPhone
com.tencent.xin,10,1735064250,1735064260,1735064261,-21600,iPhone
com.tencent.xin,10,1735063900,1735063910,1735063911,-21600,iPhone
com.tencent.xin,20,1735063864,1735063884,1735063885,-21600,iPhone
com.apple.mobilesafari,824,1735062413,1735063237,1735063238,-21600,iPad
com.apple.podcasts,13,1735062400,1735062413,1735062414,-21600,iPad
com.apple.mobilesafari,49,1735062351,1735062400,1735062400,-21600,iPad
com.apple.podcasts,15,1735062336,1735062351,1735062351,-21600,iPad
com.apple.mobilesafari,0,1735062336,1735062336,1735062337,-21600,iPad
com.apple.podcasts,93,1735062243,1735062336,1735062337,-21600,iPad
com.apple.podcasts,6,1735060636,1735060642,1735060642,-21600,iPad
com.apple.mobilesafari,722,1735059914,1735060636,1735060637,-21600,iPad
com.apple.podcasts,9,1735059905,1735059914,1735059915,-21600,iPad
com.apple.mobilesafari,133,1735059772,1735059905,1735059906,-21600,iPad
com.apple.Preferences,22,1735059739,1735059761,1735059762,-21600,iPad
com.google.Chrome,20,1735059723,1735059743,1735059743,-21600,MacBook
com.bose.boseconnect,30,1735059709,1735059739,1735059740,-21600,iPad
com.apple.Preferences,14,1735059695,1735059709,1735059710,-21600,iPad
com.bose.boseconnect,12,1735059683,1735059695,1735059696,-21600,iPad
com.google.Chrome,20,1735059674,1735059694,1735059694,-21600,MacBook
com.bose.bosemusic,29,1735059653,1735059682,1735059683,-21600,iPad
com.apple.Preferences,11,1735059641,1735059652,1735059653,-21600,iPad
com.bose.bosemusic,5,1735059636,1735059641,1735059643,-21600,iPad
com.apple.Preferences,13,1735059623,1735059636,1735059636,-21600,iPad
com.bose.bosemusic,79,1735059543,1735059622,1735059626,-21600,iPad
com.bose.bosemusic,0,1735059543,1735059543,1735059567,-21600,iPad
com.apple.Preferences,1,1735059521,1735059522,1735059565,-21600,iPad
com.apple.Preferences,34,1735059487,1735059521,1735059548,-21600,iPad
com.apple.mobilesafari,60,1735059427,1735059487,1735059489,-21600,iPad
com.apple.podcasts,61,1735059366,1735059427,1735059433,-21600,iPad
com.apple.podcasts,27,1735059338,1735059365,1735059375,-21600,iPad
com.apple.mobilesafari,0,1735059338,1735059338,1735059341,-21600,iPad
com.apple.mobilesafari,1,1735059337,1735059338,1735059341,-21600,iPad
com.apple.podcasts,92,1735059245,1735059337,1735059340,-21600,iPad
com.apple.AppStore,41,1735059197,1735059238,1735059239,-21600,iPad
com.apple.AppStore,4,1735059193,1735059197,1735059199,-21600,iPad
com.google.Chrome,16,1735059179,1735059195,1735059196,-21600,MacBook
com.apple.Preferences,38,1735059154,1735059192,1735059193,-21600,iPad
com.apple.podcasts,88,1735059066,1735059154,1735059156,-21600,iPad
com.apple.mobilenotes,13,1735059050,1735059063,1735059064,-21600,iPad
com.apple.Preferences,63,1735058986,1735059049,1735059049,-21600,iPad
com.apple.AppStore,2,1735058983,1735058985,1735058990,-21600,iPad
com.apple.mobilenotes,23,1735058960,1735058983,1735058989,-21600,iPad
com.apple.Preferences,61,1735058898,1735058959,1735058960,-21600,iPad
com.apple.mobilenotes,30,1735058867,1735058897,1735058898,-21600,iPad
com.apple.AppStore,59,1735058804,1735058863,1735058864,-21600,iPad
com.apple.AppStore,27,1735058774,1735058801,1735058801,-21600,iPad
com.tencent.weread,14,1735058760,1735058774,1735058774,-21600,iPad
com.tencent.weread,6,1735058732,1735058738,1735058738,-21600,iPad
com.xingin.discover,396,1735056640,1735057036,1735057036,-21600,iPhone
com.apple.camera,0,1735056646,1735056646,1735056646,-21600,iPhone
com.apple.camera,4,1735056640,1735056644,1735056644,-21600,iPhone
com.xingin.discover,1,1735056637,1735056638,1735056639,-21600,iPhone
com.xingin.discover,902,1735055656,1735056558,1735056559,-21600,iPhone
com.apple.MobileSMS,9,1735055642,1735055651,1735055652,-21600,iPhone
com.microsoft.Office.Outlook,14,1735055625,1735055639,1735055640,-21600,iPhone
com.xingin.discover,3,1735055617,1735055620,1735055620,-21600,iPhone
com.xingin.discover,17,1735055598,1735055615,1735055615,-21600,iPhone
com.xingin.discover,9,1735055329,1735055338,1735055339,-21600,iPhone
com.google.Chrome,301,1735036058,1735036359,1735036359,-21600,MacBook
com.google.Chrome,314,1735035333,1735035647,1735035648,-21600,MacBook
com.google.Chrome,300,1735030439,1735030739,1735030739,-21600,MacBook
com.google.Chrome,2649,1735027064,1735029713,1735029714,-21600,MacBook
com.apple.Notes,1,1735027063,1735027064,1735027064,-21600,MacBook
com.sunsama.native-app,2,1735027061,1735027063,1735027063,-21600,MacBook
com.apple.Notes,1,1735027060,1735027061,1735027062,-21600,MacBook
com.sunsama.native-app,2,1735027058,1735027060,1735027060,-21600,MacBook
com.google.Chrome,80,1735026978,1735027058,1735027059,-21600,MacBook
com.apple.Notes,2,1735026976,1735026978,1735026979,-21600,MacBook
com.google.Chrome,2,1735026974,1735026976,1735026976,-21600,MacBook
com.sunsama.native-app,1,1735026973,1735026974,1735026975,-21600,MacBook
com.google.Chrome,9,1735026964,1735026973,1735026973,-21600,MacBook
com.sunsama.native-app,1,1735026963,1735026964,1735026964,-21600,MacBook
com.google.Chrome,34,1735026929,1735026963,1735026964,-21600,MacBook
com.apple.Notes,54,1735026875,1735026929,1735026929,-21600,MacBook
com.google.Chrome,2,1735026873,1735026875,1735026876,-21600,MacBook
com.sunsama.native-app,1,1735026872,1735026873,1735026874,-21600,MacBook
com.google.Chrome,86,1735026786,1735026872,1735026873,-21600,MacBook
com.apple.Notes,4,1735026782,1735026786,1735026786,-21600,MacBook
com.google.Chrome,3,1735026779,1735026782,1735026782,-21600,MacBook
com.sunsama.native-app,1,1735026778,1735026779,1735026780,-21600,MacBook
com.google.Chrome,111,1735026667,1735026778,1735026778,-21600,MacBook
com.sunsama.native-app,1,1735026666,1735026667,1735026667,-21600,MacBook
com.google.Chrome,45,1735026621,1735026666,1735026666,-21600,MacBook
com.apple.Notes,31,1735026590,1735026621,1735026622,-21600,MacBook
com.google.Chrome,8,1735026582,1735026590,1735026590,-21600,MacBook
com.apple.Notes,30,1735026552,1735026582,1735026583,-21600,MacBook
com.google.Chrome,18,1735026534,1735026552,1735026552,-21600,MacBook
com.apple.Notes,16,1735026518,1735026534,1735026535,-21600,MacBook
com.google.Chrome,4,1735026514,1735026518,1735026518,-21600,MacBook
com.sunsama.native-app,2,1735026512,1735026514,1735026514,-21600,MacBook
com.google.Chrome,35,1735026477,1735026512,1735026513,-21600,MacBook
com.apple.Notes,13,1735026464,1735026477,1735026477,-21600,MacBook
com.google.Chrome,1,1735026463,1735026464,1735026465,-21600,MacBook
com.sunsama.native-app,1,1735026462,1735026463,1735026463,-21600,MacBook
com.google.Chrome,53,1735026409,1735026462,1735026462,-21600,MacBook
com.apple.Notes,12,1735026397,1735026409,1735026409,-21600,MacBook
com.google.Chrome,3,1735026394,1735026397,1735026397,-21600,MacBook
com.sunsama.native-app,0,1735026394,1735026394,1735026395,-21600,MacBook
com.google.Chrome,5,1735026389,1735026394,1735026394,-21600,MacBook
com.apple.Notes,3,1735026386,1735026389,1735026389,-21600,MacBook
com.google.Chrome,1,1735026385,1735026386,1735026387,-21600,MacBook
com.sunsama.native-app,2,1735026383,1735026385,1735026385,-21600,MacBook
com.google.Chrome,33,1735026350,1735026383,1735026384,-21600,MacBook
com.sunsama.native-app,2,1735026348,1735026350,1735026351,-21600,MacBook
com.google.Chrome,182,1735026166,1735026348,1735026349,-21600,MacBook
com.apple.Notes,5,1735026161,1735026166,1735026167,-21600,MacBook
com.google.Chrome,3,1735026158,1735026161,1735026161,-21600,MacBook
com.sunsama.native-app,1,1735026157,1735026158,1735026159,-21600,MacBook
com.google.Chrome,33,1735026124,1735026157,1735026158,-21600,MacBook
com.apple.Notes,7,1735026117,1735026124,1735026125,-21600,MacBook
com.google.Chrome,1,1735026116,1735026117,1735026118,-21600,MacBook
com.sunsama.native-app,1,1735026115,1735026116,1735026117,-21600,MacBook
com.google.Chrome,116,1735025999,1735026115,1735026115,-21600,MacBook
com.sunsama.native-app,2,1735025997,1735025999,1735026000,-21600,MacBook
com.google.Chrome,81,1735025916,1735025997,1735025998,-21600,MacBook
com.sunsama.native-app,2,1735025914,1735025916,1735025917,-21600,MacBook
com.google.Chrome,124,1735025790,1735025914,1735025914,-21600,MacBook
com.apple.Notes,9,1735025781,1735025790,1735025790,-21600,MacBook
com.google.Chrome,9,1735025772,1735025781,1735025781,-21600,MacBook
com.apple.Notes,10,1735025762,1735025772,1735025773,-21600,MacBook
com.google.Chrome,7,1735025755,1735025762,1735025763,-21600,MacBook
com.apple.Notes,53,1735025702,1735025755,1735025756,-21600,MacBook
com.google.Chrome,762,1735024940,1735025702,1735025703,-21600,MacBook
com.sunsama.native-app,20,1735024920,1735024940,1735024941,-21600,MacBook
notion.id,2,1735024918,1735024920,1735024920,-21600,MacBook
com.google.Chrome,2,1735024916,1735024918,1735024918,-21600,MacBook
com.apple.Notes,39,1735024877,1735024916,1735024917,-21600,MacBook
com.google.Chrome,13,1735024864,1735024877,1735024877,-21600,MacBook
com.apple.finder,7,1735024857,1735024864,1735024865,-21600,MacBook
com.sunsama.native-app,36,1735024821,1735024857,1735024857,-21600,MacBook
com.apple.finder,3,1735024818,1735024821,1735024822,-21600,MacBook
com.google.Chrome,128,1735024690,1735024818,1735024819,-21600,MacBook
com.apple.finder,1,1735024689,1735024690,1735024691,-21600,MacBook
com.google.Chrome,3,1735024686,1735024689,1735024689,-21600,MacBook
com.apple.finder,4,1735024682,1735024686,1735024686,-21600,MacBook
com.sunsama.native-app,26,1735024656,1735024682,1735024682,-21600,MacBook
com.apple.finder,3,1735024653,1735024656,1735024656,-21600,MacBook
com.apple.Preview,1,1735024652,1735024653,1735024653,-21600,MacBook
com.sunsama.native-app,2,1735024650,1735024652,1735024652,-21600,MacBook
com.apple.Preview,1,1735024649,1735024650,1735024650,-21600,MacBook
com.apple.finder,1,1735024648,1735024649,1735024649,-21600,MacBook
com.apple.Preview,0,1735024648,1735024648,1735024649,-21600,MacBook
com.apple.finder,3,1735024645,1735024648,1735024648,-21600,MacBook
notion.id,18,1735024627,1735024645,1735024645,-21600,MacBook
com.google.Chrome,7,1735024620,1735024627,1735024627,-21600,MacBook
notion.id,24,1735024596,1735024620,1735024620,-21600,MacBook
com.apple.finder,2,1735024594,1735024596,1735024597,-21600,MacBook
com.sunsama.native-app,0,1735024594,1735024594,1735024595,-21600,MacBook
com.google.Chrome,3,1735024591,1735024594,1735024594,-21600,MacBook
com.sunsama.native-app,1,1735024590,1735024591,1735024591,-21600,MacBook
notion.id,13,1735024577,1735024590,1735024591,-21600,MacBook
com.sunsama.native-app,1,1735024576,1735024577,1735024578,-21600,MacBook
com.google.Chrome,5,1735024571,1735024576,1735024577,-21600,MacBook
com.sunsama.native-app,1,1735024570,1735024571,1735024571,-21600,MacBook
notion.id,7,1735024563,1735024570,1735024570,-21600,MacBook
com.sunsama.native-app,2,1735024561,1735024563,1735024564,-21600,MacBook
com.google.Chrome,30,1735024531,1735024561,1735024562,-21600,MacBook
com.sunsama.native-app,1,1735024530,1735024531,1735024532,-21600,MacBook
notion.id,4,1735024526,1735024530,1735024531,-21600,MacBook
com.sunsama.native-app,0,1735024526,1735024526,1735024526,-21600,MacBook
com.google.Chrome,12,1735024514,1735024526,1735024526,-21600,MacBook
com.sunsama.native-app,317,1735024197,1735024514,1735024514,-21600,MacBook
com.tencent.xinWeChat,9,1735023960,1735023969,1735023969,-21600,MacBook
com.sunsama.native-app,6,1735023954,1735023960,1735023960,-21600,MacBook
com.google.Chrome,4,1735023950,1735023954,1735023954,-21600,MacBook
com.sunsama.native-app,11,1735023939,1735023950,1735023950,-21600,MacBook
com.google.Chrome,11,1735023928,1735023939,1735023940,-21600,MacBook
com.xingin.discover,5,1735022580,1735022585,1735022586,-21600,iPhone
com.xingin.discover,1376,1735020928,1735022304,1735022305,-21600,iPhone
com.google.chrome.ios,11,1735020916,1735020927,1735020927,-21600,iPhone
com.bestbuy.buyphone,514,1735020401,1735020915,1735020916,-21600,iPhone
com.apple.Preferences,10,1735020391,1735020401,1735020402,-21600,iPhone
com.bestbuy.buyphone,235,1735020156,1735020391,1735020392,-21600,iPhone
com.microsoft.Office.Outlook,2,1735020154,1735020156,1735020156,-21600,iPhone
com.tencent.xin,29,1735020124,1735020153,1735020153,-21600,iPhone
com.openai.chat,13,1735020111,1735020124,1735020124,-21600,iPhone
com.google.chrome.ios,33,1735020078,1735020111,1735020112,-21600,iPhone
com.microsoft.Office.Outlook,12,1735020066,1735020078,1735020080,-21600,iPhone
com.bestbuy.buyphone,4,1735020062,1735020066,1735020068,-21600,iPhone
com.microsoft.Office.Outlook,8,1735020054,1735020062,1735020063,-21600,iPhone
com.tencent.xin,1,1735020053,1735020054,1735020055,-21600,iPhone
com.microsoft.Office.Outlook,31,1735020021,1735020052,1735020053,-21600,iPhone
com.google.chrome.ios,3,1735020017,1735020020,1735020021,-21600,iPhone
com.bestbuy.buyphone,51,1735019966,1735020017,1735020017,-21600,iPhone
com.bestbuy.buyphone,209,1735019747,1735019956,1735019957,-21600,iPhone
com.openai.chat,18,1735019729,1735019747,1735019748,-21600,iPhone
com.bestbuy.buyphone,184,1735019544,1735019728,1735019729,-21600,iPhone
com.apple.CoreAuthUI,2,1735019563,1735019565,1735019565,-21600,iPhone
com.apple.MobileSMS,9,1735019535,1735019544,1735019545,-21600,iPhone
com.bestbuy.buyphone,102,1735019430,1735019532,1735019533,-21600,iPhone
com.apple.AuthKitUIService,9,1735019522,1735019531,1735019531,-21600,iPhone
com.amazon.Amazon,11,1735019419,1735019430,1735019431,-21600,iPhone
com.tencent.xin,87,1735019332,1735019419,1735019420,-21600,iPhone
com.amazon.Amazon,4,1735019326,1735019330,1735019331,-21600,iPhone
com.bestbuy.buyphone,27,1735019299,1735019326,1735019326,-21600,iPhone
com.bestbuy.buyphone,91,1735019076,1735019167,1735019169,-21600,iPhone
com.microsoft.Office.Outlook,2,1735019068,1735019070,1735019070,-21600,iPhone
com.google.chrome.ios,43,1735019024,1735019067,1735019068,-21600,iPhone
com.apple.AppStore,1,1735019023,1735019024,1735019025,-21600,iPhone
com.tencent.xin,2,1735019021,1735019023,1735019024,-21600,iPhone
com.apple.AppStore,1,1735019020,1735019021,1735019022,-21600,iPhone
com.google.chrome.ios,78,1735018942,1735019020,1735019021,-21600,iPhone
com.apple.AppStore,24,1735018918,1735018942,1735018944,-21600,iPhone
com.apple.PassbookUIService,4,1735018935,1735018939,1735018940,-21600,iPhone
com.apple.PassbookUIService,1,1735018933,1735018934,1735018934,-21600,iPhone
com.tencent.xin,19,1735018899,1735018918,1735018918,-21600,iPhone
com.google.chrome.ios,28,1735018871,1735018899,1735018900,-21600,iPhone
com.tencent.xin,38,1735018833,1735018871,1735018873,-21600,iPhone
com.openai.chat,3,1735018825,1735018828,1735018835,-21600,iPhone
com.google.chrome.ios,250,1735018575,1735018825,1735018829,-21600,iPhone
com.openai.chat,42,1735018533,1735018575,1735018575,-21600,iPhone
com.google.chrome.ios,16,1735018517,1735018533,1735018534,-21600,iPhone
com.openai.chat,15,1735018502,1735018517,1735018518,-21600,iPhone
com.google.chrome.ios,58,1735018444,1735018502,1735018503,-21600,iPhone
com.openai.chat,74,1735018370,1735018444,1735018445,-21600,iPhone
com.google.chrome.ios,86,1735018284,1735018370,1735018371,-21600,iPhone
com.tencent.xin,11,1735018272,1735018283,1735018284,-21600,iPhone
com.amazon.Amazon,16,1735018256,1735018272,1735018273,-21600,iPhone
com.tencent.xin,31,1735018225,1735018256,1735018257,-21600,iPhone
com.amazon.Amazon,43,1735018182,1735018225,1735018226,-21600,iPhone
com.tencent.xin,20,1735018162,1735018182,1735018183,-21600,iPhone
com.google.chrome.ios,19,1735018143,1735018162,1735018163,-21600,iPhone
com.tencent.xin,13,1735018130,1735018143,1735018144,-21600,iPhone
com.google.chrome.ios,145,1735017985,1735018130,1735018131,-21600,iPhone
com.amazon.Amazon,9,1735017976,1735017985,1735017986,-21600,iPhone
com.google.chrome.ios,4,1735017972,1735017976,1735017976,-21600,iPhone
com.amazon.Amazon,28,1735017944,1735017972,1735017973,-21600,iPhone
com.tencent.xin,4,1735017940,1735017944,1735017945,-21600,iPhone
com.amazon.Amazon,2,1735017938,1735017940,1735017941,-21600,iPhone
com.tencent.xin,38,1735017900,1735017938,1735017939,-21600,iPhone
com.amazon.Amazon,1,1735017899,1735017900,1735017901,-21600,iPhone
com.tencent.xin,2,1735017897,1735017899,1735017900,-21600,iPhone
com.google.chrome.ios,100,1735017797,1735017897,1735017898,-21600,iPhone
com.apple.CoreAuthUI,2,1735017821,1735017823,1735017824,-21600,iPhone
com.facebook.Facebook,186,1735017609,1735017795,1735017795,-21600,iPhone
com.openai.chat,13,1735017596,1735017609,1735017609,-21600,iPhone
com.amazon.Amazon,140,1735017456,1735017596,1735017597,-21600,iPhone
com.openai.chat,20,1735017436,1735017456,1735017456,-21600,iPhone
com.amazon.Amazon,1,1735017435,1735017436,1735017437,-21600,iPhone
com.openai.chat,53,1735017382,1735017435,1735017435,-21600,iPhone
com.amazon.Amazon,7,1735017375,1735017382,1735017383,-21600,iPhone
com.openai.chat,2,1735017373,1735017375,1735017376,-21600,iPhone
com.amazon.Amazon,28,1735017345,1735017373,1735017374,-21600,iPhone
com.amazon.Amazon,128,1735017215,1735017343,1735017344,-21600,iPhone
com.google.chrome.ios,27,1735017188,1735017215,1735017215,-21600,iPhone
com.amazon.Amazon,13,1735017173,1735017186,1735017187,-21600,iPhone
com.openai.chat,7,1735017166,1735017173,1735017174,-21600,iPhone
com.facebook.Facebook,1,1735017165,1735017166,1735017169,-21600,iPhone
com.amazon.Amazon,38,1735017127,1735017165,1735017167,-21600,iPhone
com.facebook.Facebook,4,1735017119,1735017123,1735017124,-21600,iPhone
com.openai.chat,4,1735017115,1735017119,1735017120,-21600,iPhone
com.facebook.Facebook,2,1735017113,1735017115,1735017115,-21600,iPhone
com.openai.chat,4,1735017109,1735017113,1735017114,-21600,iPhone
com.facebook.Facebook,24,1735017085,1735017109,1735017110,-21600,iPhone
com.openai.chat,34,1735017051,1735017085,1735017086,-21600,iPhone
com.facebook.Facebook,358,1735016693,1735017051,1735017052,-21600,iPhone
com.openai.chat,76,1735016617,1735016693,1735016694,-21600,iPhone
com.facebook.Facebook,5,1735016612,1735016617,1735016618,-21600,iPhone
com.facebook.Messenger,11,1735016601,1735016612,1735016612,-21600,iPhone
com.facebook.Facebook,6,1735016594,1735016600,1735016600,-21600,iPhone
com.openai.chat,4,1735016590,1735016594,1735016594,-21600,iPhone
com.tencent.xin,25,1735016565,1735016590,1735016591,-21600,iPhone
com.google.chrome.ios,10,1735016555,1735016565,1735016565,-21600,iPhone
com.google.ios.youtube,4,1735016551,1735016555,1735016556,-21600,iPhone
com.google.chrome.ios,18,1735016533,1735016551,1735016552,-21600,iPhone
com.tencent.xin,16,1735016516,1735016532,1735016533,-21600,iPhone
com.openai.chat,14,1735016502,1735016516,1735016516,-21600,iPhone
com.facebook.Messenger,1,1735016501,1735016502,1735016503,-21600,iPhone
com.tencent.xin,13,1735016488,1735016501,1735016501,-21600,iPhone
com.facebook.Facebook,8,1735016480,1735016488,1735016489,-21600,iPhone
com.facebook.Messenger,8,1735016472,1735016480,1735016481,-21600,iPhone
com.tencent.xin,17,1735016454,1735016471,1735016472,-21600,iPhone
com.facebook.Facebook,85,1735016369,1735016454,1735016454,-21600,iPhone
com.openai.chat,25,1735016344,1735016369,1735016369,-21600,iPhone
com.facebook.Facebook,57,1735016287,1735016344,1735016345,-21600,iPhone
com.tencent.xin,46,1735016241,1735016287,1735016287,-21600,iPhone
com.facebook.Facebook,107,1735016134,1735016241,1735016242,-21600,iPhone
com.google.Sheets,32,1735016102,1735016134,1735016135,-21600,iPhone
com.facebook.Facebook,112,1735015990,1735016102,1735016103,-21600,iPhone
com.openai.chat,21,1735015969,1735015990,1735015990,-21600,iPhone
com.facebook.Facebook,2,1735015967,1735015969,1735015970,-21600,iPhone
com.openai.chat,1,1735015966,1735015967,1735015968,-21600,iPhone
com.facebook.Facebook,69,1735015897,1735015966,1735015967,-21600,iPhone
com.facebook.Messenger,22,1735015875,1735015897,1735015898,-21600,iPhone
com.facebook.Facebook,51,1735015824,1735015875,1735015876,-21600,iPhone
com.facebook.Messenger,54,1735015770,1735015824,1735015825,-21600,iPhone
com.facebook.Facebook,192,1735015577,1735015769,1735015770,-21600,iPhone
com.openai.chat,25,1735015552,1735015577,1735015578,-21600,iPhone
com.google.chrome.ios,2,1735015549,1735015551,1735015552,-21600,iPhone
com.facebook.Facebook,13,1735015536,1735015549,1735015550,-21600,iPhone
com.xingin.discover,66,1735015470,1735015536,1735015537,-21600,iPhone
com.google.chrome.ios,13,1735015456,1735015469,1735015470,-21600,iPhone
com.facebook.Facebook,199,1735015255,1735015454,1735015454,-21600,iPhone
com.xingin.discover,45,1735015210,1735015255,1735015255,-21600,iPhone
com.xingin.discover,3325,1735011728,1735015053,1735015053,-21600,iPhone
com.tencent.xin,27,1735011701,1735011728,1735011729,-21600,iPhone
com.xingin.discover,254,1735011447,1735011701,1735011701,-21600,iPhone
com.tencent.xin,643,1735010804,1735011447,1735011447,-21600,iPhone
com.facebook.Facebook,135,1735010669,1735010804,1735010805,-21600,iPhone
com.amazon.Amazon,1,1735010668,1735010669,1735010670,-21600,iPhone
com.facebook.Facebook,1,1735010665,1735010666,1735010666,-21600,iPhone
com.amazon.Amazon,3,1735010659,1735010662,1735010663,-21600,iPhone
com.microsoft.Office.Outlook,10,1735010647,1735010657,1735010658,-21600,iPhone
com.sunsama.mobile,73,1735010572,1735010645,1735010646,-21600,iPhone
com.duosecurity.DuoMobile,2,1735010570,1735010572,1735010572,-21600,iPhone
com.tencent.xin,36,1735010534,1735010570,1735010570,-21600,iPhone
com.duosecurity.DuoMobile,7,1735010527,1735010534,1735010535,-21600,iPhone
com.sunsama.mobile,57,1735010468,1735010525,1735010526,-21600,iPhone
com.google.Chrome,834,1735009635,1735010469,1735010469,-21600,MacBook
com.tencent.xin,48,1735010414,1735010462,1735010463,-21600,iPhone
com.tencent.xin,47,1735009702,1735009749,1735009750,-21600,iPhone
com.amazon.Amazon,5,1735009697,1735009702,1735009703,-21600,iPhone
com.tencent.xin,1,1735009696,1735009697,1735009698,-21600,iPhone
com.amazon.Amazon,15,1735009680,1735009695,1735009695,-21600,iPhone
com.amazon.Amazon,43,1735009621,1735009664,1735009665,-21600,iPhone
com.discoverfinancial.mobile,60,1735009549,1735009609,1735009610,-21600,iPhone
com.apple.CoreAuthUI,3,1735009556,1735009559,1735009559,-21600,iPhone
com.chase,41,1735009508,1735009549,1735009549,-21600,iPhone
com.apple.CoreAuthUI,2,1735009512,1735009514,1735009515,-21600,iPhone
com.xingin.discover,5,1735009480,1735009485,1735009485,-21600,iPhone
com.xingin.discover,87,1735009166,1735009253,1735009254,-21600,iPhone
com.google.Chrome,673,1735008490,1735009163,1735009164,-21600,MacBook
com.xingin.discover,2,1735008819,1735008821,1735008821,-21600,iPhone
com.sunsama.native-app,6,1735008484,1735008490,1735008490,-21600,MacBook
com.google.Chrome,43,1735008441,1735008484,1735008484,-21600,MacBook
com.sunsama.native-app,17,1735008424,1735008441,1735008442,-21600,MacBook
com.tencent.xinWeChat,2,1735008422,1735008424,1735008424,-21600,MacBook
com.xingin.discover,60,1735008341,1735008401,1735008401,-21600,iPhone
com.tencent.xin,6,1735008335,1735008341,1735008342,-21600,iPhone
com.tencent.xinWeChat,338,1735007924,1735008262,1735008263,-21600,MacBook
com.tencent.xin,31,1735007986,1735008017,1735008017,-21600,iPhone
com.xingin.discover,8,1735007978,1735007986,1735007986,-21600,iPhone
com.tencent.xin,2,1735007971,1735007973,1735007974,-21600,iPhone
com.apple.finder,271,1735007653,1735007924,1735007925,-21600,MacBook
com.sunsama.native-app,52,1735007601,1735007653,1735007654,-21600,MacBook
com.tencent.xinWeChat,0,1735007601,1735007601,1735007602,-21600,MacBook
com.google.Chrome,3,1735007598,1735007601,1735007601,-21600,MacBook
com.sunsama.native-app,2,1735007596,1735007598,1735007598,-21600,MacBook
com.apple.podcasts,1,1735007595,1735007596,1735007596,-21600,MacBook
com.tencent.xinWeChat,2,1735007593,1735007595,1735007595,-21600,MacBook
com.google.Chrome,1,1735007592,1735007593,1735007594,-21600,MacBook
com.apple.finder,4,1735007588,1735007592,1735007592,-21600,MacBook
com.tencent.xinWeChat,5,1735007583,1735007588,1735007588,-21600,MacBook
com.apple.finder,1,1735007582,1735007583,1735007583,-21600,MacBook
com.tencent.xinWeChat,4,1735007578,1735007582,1735007583,-21600,MacBook
com.apple.finder,0,1735007578,1735007578,1735007579,-21600,MacBook
com.tencent.xinWeChat,8,1735007570,1735007578,1735007578,-21600,MacBook
com.apple.finder,1,1735007569,1735007570,1735007571,-21600,MacBook
com.tencent.xinWeChat,1,1735007568,1735007569,1735007570,-21600,MacBook
com.apple.finder,0,1735007568,1735007568,1735007569,-21600,MacBook
com.tencent.xinWeChat,17,1735007551,1735007568,1735007568,-21600,MacBook
com.apple.podcasts,22,1735007529,1735007551,1735007551,-21600,MacBook
com.tencent.xinWeChat,17,1735007512,1735007529,1735007530,-21600,MacBook
com.apple.podcasts,1,1735007511,1735007512,1735007512,-21600,MacBook
com.tencent.xinWeChat,24,1735007487,1735007511,1735007512,-21600,MacBook
com.google.Chrome,21,1735007466,1735007487,1735007488,-21600,MacBook
com.tencent.xinWeChat,3,1735007463,1735007466,1735007467,-21600,MacBook
com.google.Chrome,19,1735007444,1735007463,1735007464,-21600,MacBook
com.tencent.xinWeChat,9,1735007435,1735007444,1735007445,-21600,MacBook
com.google.Chrome,6,1735007429,1735007435,1735007436,-21600,MacBook
com.tencent.xinWeChat,7,1735007422,1735007429,1735007429,-21600,MacBook
com.google.Chrome,7,1735007415,1735007422,1735007423,-21600,MacBook
com.tencent.xinWeChat,3,1735007412,1735007415,1735007415,-21600,MacBook
com.apple.finder,3,1735007409,1735007412,1735007412,-21600,MacBook
com.apple.archiveutility,1,1735007408,1735007409,1735007409,-21600,MacBook
com.apple.finder,5,1735007403,1735007408,1735007409,-21600,MacBook
com.tencent.xinWeChat,2,1735007401,1735007403,1735007403,-21600,MacBook
com.google.Chrome,40,1735007361,1735007401,1735007402,-21600,MacBook
com.tencent.xinWeChat,7,1735007354,1735007361,1735007362,-21600,MacBook
com.google.Chrome,25,1735007329,1735007354,1735007354,-21600,MacBook
com.tencent.xinWeChat,72,1735007257,1735007329,1735007330,-21600,MacBook
com.apple.finder,5,1735007252,1735007257,1735007258,-21600,MacBook
com.google.Chrome,234,1735007018,1735007252,1735007253,-21600,MacBook
com.tencent.xin,66,1735007059,1735007125,1735007126,-21600,iPhone
com.netease.cloudmusic,4,1735007055,1735007059,1735007059,-21600,iPhone
com.sunsama.native-app,37,1735006981,1735007018,1735007019,-21600,MacBook
com.google.Chrome,432,1735006549,1735006981,1735006982,-21600,MacBook
com.netease.cloudmusic,4,1735006927,1735006931,1735006932,-21600,iPhone
com.tencent.xin,5,1735006921,1735006926,1735006927,-21600,iPhone
com.tencent.xin,312,1735006568,1735006880,1735006881,-21600,iPhone
com.netease.cloudmusic,4,1735006385,1735006389,1735006390,-21600,iPhone
com.netease.cloudmusic,7,1735005270,1735005277,1735005277,-21600,iPhone
com.netease.cloudmusic,21,1735005247,1735005268,1735005269,-21600,iPhone
com.google.Chrome,16,1735005239,1735005255,1735005256,-21600,MacBook
com.apple.Preferences,28,1735005219,1735005247,1735005247,-21600,iPhone
com.tencent.xin,607,1735004598,1735005205,1735005205,-21600,iPhone
com.openai.chat,64,1735004534,1735004598,1735004599,-21600,iPhone
com.tencent.xin,39,1735004495,1735004534,1735004535,-21600,iPhone
com.openai.chat,42,1735004453,1735004495,1735004496,-21600,iPhone
com.tencent.xin,3,1735004450,1735004453,1735004454,-21600,iPhone
com.openai.chat,30,1735004420,1735004450,1735004451,-21600,iPhone
com.tencent.xin,15,1735004405,1735004420,1735004421,-21600,iPhone
com.google.chrome.ios,1,1735004404,1735004405,1735004407,-21600,iPhone
com.openai.chat,46,1735004358,1735004404,1735004405,-21600,iPhone
com.google.chrome.ios,5,1735004352,1735004357,1735004359,-21600,iPhone
com.tencent.xin,44,1735004308,1735004352,1735004354,-21600,iPhone
com.google.chrome.ios,44,1735004263,1735004307,1735004308,-21600,iPhone
com.openai.chat,1,1735004262,1735004263,1735004263,-21600,iPhone
com.tencent.xin,19,1735004242,1735004261,1735004262,-21600,iPhone
com.openai.chat,175,1735004067,1735004242,1735004243,-21600,iPhone
com.openai.chat,9,1735004057,1735004066,1735004066,-21600,iPhone
com.tencent.xin,20,1735004037,1735004057,1735004058,-21600,iPhone
com.openai.chat,1,1735004036,1735004037,1735004038,-21600,iPhone
com.google.chrome.ios,3,1735004031,1735004034,1735004035,-21600,iPhone
com.tencent.xin,31,1735004000,1735004031,1735004031,-21600,iPhone
com.netease.cloudmusic,1,1735003999,1735004000,1735004001,-21600,iPhone
com.tencent.xin,1,1735003998,1735003999,1735003999,-21600,iPhone
com.netease.cloudmusic,4,1735003993,1735003997,1735003997,-21600,iPhone
com.tencent.xin,1,1735003992,1735003993,1735003994,-21600,iPhone
com.netease.cloudmusic,15,1735003976,1735003991,1735003991,-21600,iPhone
com.microsoft.Office.Outlook,5,1735003971,1735003976,1735003977,-21600,iPhone
com.apple.MobileSMS,8,1735003963,1735003971,1735003971,-21600,iPhone
com.google.Chrome,16,1735003950,1735003966,1735003967,-21600,MacBook
com.netease.cloudmusic,3,1735003958,1735003961,1735003962,-21600,iPhone
com.xingin.discover,1,1735003957,1735003958,1735003959,-21600,iPhone
com.apple.camera,0,1735003284,1735003284,1735003285,-21600,iPhone
com.microsoft.Office.Outlook,10,1735003190,1735003200,1735003200,-21600,iPhone
com.ridewithvia.UCA.UniversityOfChicagoRider,13,1735003177,1735003190,1735003190,-21600,iPhone
com.ridewithvia.UCA.UniversityOfChicagoRider,6,1735003127,1735003133,1735003134,-21600,iPhone
com.ridewithvia.UCA.UniversityOfChicagoRider,11,1735003103,1735003114,1735003115,-21600,iPhone
com.ridewithvia.UCA.UniversityOfChicagoRider,45,1735003017,1735003062,1735003062,-21600,iPhone
com.ridewithvia.UCA.UniversityOfChicagoRider,76,1735002937,1735003013,1735003014,-21600,iPhone
com.ridewithvia.UCA.UniversityOfChicagoRider,50,1735002851,1735002901,1735002902,-21600,iPhone
com.ridewithvia.UCA.UniversityOfChicagoRider,7,1735002835,1735002842,1735002843,-21600,iPhone
com.ridewithvia.UCA.UniversityOfChicagoRider,85,1735002734,1735002819,1735002820,-21600,iPhone
com.ridewithvia.UCA.UniversityOfChicagoRider,14,1735002717,1735002731,1735002732,-21600,iPhone
com.ridewithvia.UCA.UniversityOfChicagoRider,15,1735002692,1735002707,1735002707,-21600,iPhone
com.apple.camera,1,1735002696,1735002697,1735002697,-21600,iPhone
com.ridewithvia.UCA.UniversityOfChicagoRider,7,1735002679,1735002686,1735002687,-21600,iPhone
com.ridewithvia.UCA.UniversityOfChicagoRider,6,1735002653,1735002659,1735002660,-21600,iPhone
com.ridewithvia.UCA.UniversityOfChicagoRider,23,1735002629,1735002652,1735002653,-21600,iPhone
com.ridewithvia.UCA.UniversityOfChicagoRider,28,1735002555,1735002583,1735002584,-21600,iPhone
com.ridewithvia.UCA.UniversityOfChicagoRider,101,1735002417,1735002518,1735002519,-21600,iPhone
com.discoverfinancial.mobile,15,1735002402,1735002417,1735002418,-21600,iPhone
com.discoverfinancial.mobile,2,1735002399,1735002401,1735002401,-21600,iPhone
com.discoverfinancial.mobile,7,1735002367,1735002374,1735002375,-21600,iPhone
com.apple.PassbookUIService,5,1735002368,1735002373,1735002374,-21600,iPhone
com.discoverfinancial.mobile,17,1735001979,1735001996,1735001996,-21600,iPhone
com.apple.CoreAuthUI,1,1735001987,1735001988,1735001989,-21600,iPhone
com.microsoft.Office.Outlook,5,1735001974,1735001979,1735001980,-21600,iPhone
com.microsoft.Office.Outlook,9,1735001963,1735001972,1735001973,-21600,iPhone
com.ridewithvia.UCA.UniversityOfChicagoRider,6,1735000988,1735000994,1735000995,-21600,iPhone
com.ridewithvia.UCA.UniversityOfChicagoRider,24,1735000949,1735000973,1735000974,-21600,iPhone
com.ridewithvia.UCA.UniversityOfChicagoRider,17,1735000931,1735000948,1735000949,-21600,iPhone
com.ridewithvia.UCA.UniversityOfChicagoRider,45,1735000873,1735000918,1735000918,-21600,iPhone
com.ridewithvia.UCA.UniversityOfChicagoRider,14,1735000845,1735000859,1735000859,-21600,iPhone
com.ridewithvia.UCA.UniversityOfChicagoRider,31,1735000667,1735000698,1735000699,-21600,iPhone
com.ridewithvia.UCA.UniversityOfChicagoRider,5,1735000611,1735000616,1735000616,-21600,iPhone
com.ridewithvia.UCA.UniversityOfChicagoRider,1,1735000610,1735000611,1735000611,-21600,iPhone
com.ridewithvia.UCA.UniversityOfChicagoRider,9,1735000595,1735000604,1735000605,-21600,iPhone
com.ridewithvia.UCA.UniversityOfChicagoRider,58,1735000391,1735000449,1735000449,-21600,iPhone
com.google.Chrome,4,1735000420,1735000424,1735000425,-21600,MacBook
com.sunsama.native-app,8,1735000412,1735000420,1735000420,-21600,MacBook
com.apple.finder,28,1735000384,1735000412,1735000413,-21600,MacBook
com.apple.AppStore,23,1735000365,1735000388,1735000389,-21600,iPhone
com.google.Chrome,146,1735000238,1735000384,1735000385,-21600,MacBook
com.google.chrome.ios,13,1735000352,1735000365,1735000365,-21600,iPhone
com.microsoft.Office.Outlook,2,1735000350,1735000352,1735000353,-21600,iPhone
com.google.chrome.ios,3,1735000347,1735000350,1735000351,-21600,iPhone
com.microsoft.Office.Outlook,15,1735000332,1735000347,1735000347,-21600,iPhone
com.ridewithvia.UCA.UniversityOfChicagoRider,9,1735000323,1735000332,1735000332,-21600,iPhone
com.tencent.xin,9,1735000313,1735000322,1735000323,-21600,iPhone
com.ridewithvia.UCA.UniversityOfChicagoRider,5,1735000308,1735000313,1735000314,-21600,iPhone
com.tencent.xin,18,1735000290,1735000308,1735000309,-21600,iPhone
com.ridewithvia.UCA.UniversityOfChicagoRider,43,1735000247,1735000290,1735000291,-21600,iPhone
com.tencent.xin,3,1735000244,1735000247,1735000247,-21600,iPhone
notion.id,116,1735000122,1735000238,1735000239,-21600,MacBook
com.google.Chrome,2,1735000120,1735000122,1735000123,-21600,MacBook
notion.id,8,1735000112,1735000120,1735000121,-21600,MacBook
com.google.Chrome,27,1735000085,1735000112,1735000113,-21600,MacBook
notion.id,18,1735000067,1735000085,1735000085,-21600,MacBook
com.google.Chrome,7,1735000060,1735000067,1735000068,-21600,MacBook
notion.id,36,1735000024,1735000060,1735000061,-21600,MacBook
com.google.Chrome,48,1734999976,1735000024,1735000025,-21600,MacBook
notion.id,2,1734999974,1734999976,1734999976,-21600,MacBook
com.google.Chrome,31,1734999943,1734999974,1734999975,-21600,MacBook
notion.id,25,1734999918,1734999943,1734999944,-21600,MacBook
com.google.Chrome,6,1734999912,1734999918,1734999919,-21600,MacBook
notion.id,28,1734999884,1734999912,1734999913,-21600,MacBook
com.google.Chrome,7,1734999877,1734999884,1734999884,-21600,MacBook
notion.id,3,1734999874,1734999877,1734999877,-21600,MacBook
com.google.Chrome,17,1734999857,1734999874,1734999874,-21600,MacBook
notion.id,1,1734999856,1734999857,1734999857,-21600,MacBook
com.google.Chrome,9,1734999847,1734999856,1734999856,-21600,MacBook
notion.id,14,1734999833,1734999847,1734999848,-21600,MacBook
com.google.Chrome,2,1734999831,1734999833,1734999834,-21600,MacBook
notion.id,8,1734999823,1734999831,1734999832,-21600,MacBook
com.google.Chrome,41,1734999782,1734999823,1734999823,-21600,MacBook
notion.id,8,1734999774,1734999782,1734999783,-21600,MacBook
com.google.Chrome,59,1734999715,1734999774,1734999775,-21600,MacBook
com.apple.finder,12,1734999703,1734999715,1734999715,-21600,MacBook
com.apple.archiveutility,0,1734999703,1734999703,1734999704,-21600,MacBook
com.apple.finder,2,1734999701,1734999703,1734999703,-21600,MacBook
com.google.Chrome,89,1734999612,1734999701,1734999702,-21600,MacBook
notion.id,4,1734999608,1734999612,1734999613,-21600,MacBook
com.google.Chrome,6,1734999602,1734999608,1734999609,-21600,MacBook
notion.id,6,1734999596,1734999602,1734999602,-21600,MacBook
com.google.Chrome,2,1734999594,1734999596,1734999597,-21600,MacBook
notion.id,13,1734999581,1734999594,1734999595,-21600,MacBook
com.google.Chrome,1,1734999580,1734999581,1734999582,-21600,MacBook
notion.id,4,1734999576,1734999580,1734999580,-21600,MacBook
com.google.Chrome,20,1734999556,1734999576,1734999576,-21600,MacBook
notion.id,13,1734999543,1734999556,1734999557,-21600,MacBook
com.google.Chrome,60,1734999483,1734999543,1734999544,-21600,MacBook
notion.id,1,1734999482,1734999483,1734999483,-21600,MacBook
com.apple.finder,6,1734999476,1734999482,1734999482,-21600,MacBook
com.apple.archiveutility,1,1734999475,1734999476,1734999476,-21600,MacBook
com.apple.finder,4,1734999471,1734999475,1734999475,-21600,MacBook
com.sunsama.native-app,0,1734999471,1734999471,1734999471,-21600,MacBook
notion.id,28,1734999443,1734999471,1734999471,-21600,MacBook
com.google.Chrome,24,1734999419,1734999443,1734999443,-21600,MacBook
notion.id,4,1734999415,1734999419,1734999419,-21600,MacBook
com.google.Chrome,4,1734999411,1734999415,1734999416,-21600,MacBook
notion.id,17,1734999394,1734999411,1734999412,-21600,MacBook
com.google.Chrome,18,1734999376,1734999394,1734999395,-21600,MacBook
notion.id,10,1734999366,1734999376,1734999377,-21600,MacBook
com.google.Chrome,31,1734999335,1734999366,1734999367,-21600,MacBook
notion.id,1,1734999334,1734999335,1734999335,-21600,MacBook
com.google.Chrome,10,1734999324,1734999334,1734999334,-21600,MacBook
notion.id,2,1734999322,1734999324,1734999324,-21600,MacBook
com.google.Chrome,16,1734999306,1734999322,1734999323,-21600,MacBook
notion.id,4,1734999302,1734999306,1734999306,-21600,MacBook
com.google.Chrome,31,1734999271,1734999302,1734999303,-21600,MacBook
notion.id,27,1734999244,1734999271,1734999272,-21600,MacBook
com.google.Chrome,62,1734999182,1734999244,1734999245,-21600,MacBook
notion.id,14,1734999168,1734999182,1734999182,-21600,MacBook
com.sunsama.native-app,6,1734999162,1734999168,1734999169,-21600,MacBook
com.google.Chrome,24,1734999138,1734999162,1734999162,-21600,MacBook
notion.id,2,1734999136,1734999138,1734999138,-21600,MacBook
com.sunsama.native-app,6,1734999130,1734999136,1734999136,-21600,MacBook
com.apple.Notes,0,1734999130,1734999130,1734999131,-21600,MacBook
com.google.Chrome,198,1734998932,1734999130,1734999131,-21600,MacBook
notion.id,3,1734998929,1734998932,1734998933,-21600,MacBook
com.apple.Notes,1,1734998928,1734998929,1734998930,-21600,MacBook
com.apple.finder,1,1734998927,1734998928,1734998929,-21600,MacBook
com.google.Chrome,99,1734998828,1734998927,1734998928,-21600,MacBook
notion.id,2,1734998826,1734998828,1734998828,-21600,MacBook
com.apple.finder,4,1734998822,1734998826,1734998827,-21600,MacBook
com.apple.Notes,1,1734998821,1734998822,1734998822,-21600,MacBook
com.google.Chrome,522,1734998299,1734998821,1734998821,-21600,MacBook
com.apple.Notes,6,1734998293,1734998299,1734998300,-21600,MacBook
notion.id,3,1734998290,1734998293,1734998294,-21600,MacBook
com.apple.Notes,1,1734998289,1734998290,1734998291,-21600,MacBook
notion.id,0,1734998289,1734998289,1734998289,-21600,MacBook
com.apple.finder,3,1734998286,1734998289,1734998289,-21600,MacBook
com.apple.Notes,1,1734998285,1734998286,1734998287,-21600,MacBook
com.sunsama.native-app,16,1734998269,1734998285,1734998286,-21600,MacBook
com.google.Chrome,67,1734998202,1734998269,1734998270,-21600,MacBook
com.apple.Notes,12,1734998190,1734998202,1734998203,-21600,MacBook
com.google.Chrome,609,1734997581,1734998190,1734998191,-21600,MacBook
com.apple.Notes,1,1734997580,1734997581,1734997582,-21600,MacBook
com.google.Chrome,122,1734997458,1734997580,1734997581,-21600,MacBook
com.apple.Notes,1,1734997457,1734997458,1734997459,-21600,MacBook
com.google.Chrome,9,1734997448,1734997457,1734997457,-21600,MacBook
com.apple.Notes,38,1734997410,1734997448,1734997448,-21600,MacBook
com.google.Chrome,66,1734997344,1734997410,1734997411,-21600,MacBook
com.apple.Notes,10,1734997334,1734997344,1734997345,-21600,MacBook
com.google.Chrome,15,1734997319,1734997334,1734997335,-21600,MacBook
com.apple.Notes,11,1734997308,1734997319,1734997319,-21600,MacBook
com.google.Chrome,493,1734996815,1734997308,1734997309,-21600,MacBook
com.apple.Notes,1,1734996814,1734996815,1734996816,-21600,MacBook
com.google.Chrome,477,1734996337,1734996814,1734996814,-21600,MacBook
com.tencent.xin,2,1734996726,1734996728,1734996728,-21600,iPhone
com.apple.Notes,15,1734996322,1734996337,1734996338,-21600,MacBook
com.google.Chrome,31,1734996291,1734996322,1734996323,-21600,MacBook
com.apple.Notes,14,1734996277,1734996291,1734996292,-21600,MacBook
com.google.Chrome,18,1734996259,1734996277,1734996278,-21600,MacBook
com.tencent.xin,6,1734996199,1734996205,1734996206,-21600,iPhone
com.tencent.xin,17,1734995952,1734995969,1734995970,-21600,iPhone
com.tencent.xin,143,1734995799,1734995942,1734995943,-21600,iPhone
com.tencent.xin,14,1734995785,1734995799,1734995799,-21600,iPhone
com.microsoft.Office.Outlook,9,1734995776,1734995785,1734995785,-21600,iPhone
com.tencent.xin,2,1734995774,1734995776,1734995776,-21600,iPhone
com.google.Maps,9,1734995764,1734995773,1734995773,-21600,iPhone
com.google.Chrome,15,1734995748,1734995763,1734995763,-21600,MacBook
com.apple.Notes,1,1734995747,1734995748,1734995749,-21600,MacBook
com.sunsama.native-app,2,1734995745,1734995747,1734995748,-21600,MacBook
com.apple.Notes,3,1734995742,1734995745,1734995746,-21600,MacBook
com.sunsama.native-app,9,1734995733,1734995742,1734995743,-21600,MacBook
com.google.Chrome,780,1734994953,1734995733,1734995733,-21600,MacBook
com.google.Maps,15,1734995701,1734995716,1734995717,-21600,iPhone
com.apple.Notes,18,1734994935,1734994953,1734994954,-21600,MacBook
com.google.Chrome,171,1734994764,1734994935,1734994936,-21600,MacBook
com.apple.Notes,0,1734994764,1734994764,1734994765,-21600,MacBook
com.sunsama.native-app,2,1734994762,1734994764,1734994764,-21600,MacBook
com.apple.Notes,4,1734994758,1734994762,1734994763,-21600,MacBook
com.google.Chrome,21,1734994737,1734994758,1734994759,-21600,MacBook
com.apple.Notes,7,1734994730,1734994737,1734994737,-21600,MacBook
com.google.Chrome,1,1734994729,1734994730,1734994730,-21600,MacBook
com.apple.Notes,2,1734994727,1734994729,1734994730,-21600,MacBook
com.google.Chrome,8,1734994719,1734994727,1734994728,-21600,MacBook
com.apple.Notes,2,1734994717,1734994719,1734994719,-21600,MacBook
com.google.Chrome,57,1734994660,1734994717,1734994718,-21600,MacBook
com.apple.Notes,1,1734994659,1734994660,1734994660,-21600,MacBook
com.google.Chrome,33,1734994626,1734994659,1734994659,-21600,MacBook
com.apple.Notes,5,1734994621,1734994626,1734994626,-21600,MacBook
com.google.Chrome,64,1734994557,1734994621,1734994621,-21600,MacBook
com.apple.Notes,5,1734994552,1734994557,1734994558,-21600,MacBook
com.google.Chrome,25,1734994527,1734994552,1734994553,-21600,MacBook
com.apple.Notes,1,1734994526,1734994527,1734994528,-21600,MacBook
com.google.Chrome,30,1734994496,1734994526,1734994526,-21600,MacBook
com.apple.Notes,2,1734994494,1734994496,1734994497,-21600,MacBook
com.google.Chrome,35,1734994459,1734994494,1734994495,-21600,MacBook
com.apple.Notes,0,1734994459,1734994459,1734994460,-21600,MacBook
com.google.Chrome,25,1734994434,1734994459,1734994459,-21600,MacBook
com.apple.Notes,1,1734994433,1734994434,1734994435,-21600,MacBook
com.google.Chrome,21,1734994412,1734994433,1734994433,-21600,MacBook
com.apple.Notes,1,1734994411,1734994412,1734994413,-21600,MacBook
com.google.Chrome,27,1734994384,1734994411,1734994411,-21600,MacBook
com.sunsama.native-app,2,1734994382,1734994384,1734994384,-21600,MacBook
com.google.Chrome,2,1734994380,1734994382,1734994383,-21600,MacBook
com.sunsama.native-app,2,1734994378,1734994380,1734994381,-21600,MacBook
com.google.Chrome,1,1734994377,1734994378,1734994379,-21600,MacBook
com.apple.Notes,1,1734994376,1734994377,1734994378,-21600,MacBook
com.google.Chrome,32,1734994344,1734994376,1734994377,-21600,MacBook
com.apple.Notes,7,1734994337,1734994344,1734994344,-21600,MacBook
com.google.Chrome,76,1734994261,1734994337,1734994338,-21600,MacBook
com.apple.Notes,3,1734994258,1734994261,1734994262,-21600,MacBook
com.google.Chrome,12,1734994246,1734994258,1734994258,-21600,MacBook
com.apple.Notes,1,1734994245,1734994246,1734994247,-21600,MacBook
com.google.Chrome,60,1734994185,1734994245,1734994246,-21600,MacBook
com.apple.Notes,6,1734994179,1734994185,1734994186,-21600,MacBook
com.google.Chrome,36,1734994143,1734994179,1734994180,-21600,MacBook
com.apple.Notes,6,1734994137,1734994143,1734994144,-21600,MacBook
com.google.Chrome,92,1734994045,1734994137,1734994138,-21600,MacBook
com.sunsama.native-app,1,1734994044,1734994045,1734994046,-21600,MacBook
com.apple.Notes,14,1734994030,1734994044,1734994044,-21600,MacBook
com.apple.systempreferences,15,1734994015,1734994030,1734994030,-21600,MacBook
com.google.Chrome,7,1734994008,1734994015,1734994016,-21600,MacBook
com.apple.systempreferences,2,1734993997,1734993999,1734993999,-21600,MacBook
com.apple.Notes,20,1734993977,1734993997,1734993998,-21600,MacBook
com.google.Chrome,1,1734993976,1734993977,1734993978,-21600,MacBook
com.apple.Notes,1,1734993975,1734993976,1734993976,-21600,MacBook
com.google.Chrome,88,1734993887,1734993975,1734993975,-21600,MacBook
com.apple.Notes,12,1734993875,1734993887,1734993887,-21600,MacBook
com.google.Chrome,10,1734993865,1734993875,1734993876,-21600,MacBook
com.apple.Notes,11,1734993854,1734993865,1734993866,-21600,MacBook
com.google.Chrome,6,1734993848,1734993854,1734993855,-21600,MacBook
com.sunsama.native-app,1,1734993847,1734993848,1734993848,-21600,MacBook
com.apple.Notes,61,1734993786,1734993847,1734993847,-21600,MacBook
com.google.Chrome,178,1734993608,1734993786,1734993787,-21600,MacBook
com.apple.Notes,7,1734993601,1734993608,1734993609,-21600,MacBook
com.sunsama.native-app,40,1734993561,1734993601,1734993601,-21600,MacBook
com.google.Chrome,1,1734993560,1734993561,1734993561,-21600,MacBook
com.sunsama.native-app,1,1734993559,1734993560,1734993560,-21600,MacBook
com.apple.Notes,45,1734993514,1734993559,1734993559,-21600,MacBook
com.google.Chrome,202,1734993312,1734993514,1734993515,-21600,MacBook
com.apple.Notes,8,1734993304,1734993312,1734993313,-21600,MacBook
com.sunsama.native-app,2,1734993302,1734993304,1734993304,-21600,MacBook
com.apple.Notes,42,1734993260,1734993302,1734993303,-21600,MacBook
com.google.Chrome,25,1734993235,1734993260,1734993261,-21600,MacBook
com.apple.Notes,16,1734993219,1734993235,1734993236,-21600,MacBook
com.google.Chrome,2,1734993217,1734993219,1734993219,-21600,MacBook
com.apple.Notes,4,1734993213,1734993217,1734993217,-21600,MacBook
com.google.Chrome,2,1734993211,1734993213,1734993214,-21600,MacBook
com.apple.Notes,6,1734993205,1734993211,1734993212,-21600,MacBook
com.google.Chrome,2,1734993203,1734993205,1734993206,-21600,MacBook
com.apple.Notes,3,1734993200,1734993203,1734993204,-21600,MacBook
com.google.Chrome,15,1734993185,1734993200,1734993200,-21600,MacBook
com.apple.Notes,15,1734993170,1734993185,1734993186,-21600,MacBook
com.google.Chrome,2,1734993168,1734993170,1734993170,-21600,MacBook
com.apple.Notes,5,1734993163,1734993168,1734993169,-21600,MacBook
com.google.Chrome,16,1734993147,1734993163,1734993163,-21600,MacBook
com.apple.Notes,7,1734993140,1734993147,1734993147,-21600,MacBook
com.google.Chrome,5,1734993135,1734993140,1734993140,-21600,MacBook
com.apple.Notes,1,1734993134,1734993135,1734993136,-21600,MacBook
com.google.Chrome,9,1734993125,1734993134,1734993135,-21600,MacBook
com.apple.Notes,128,1734992997,1734993125,1734993126,-21600,MacBook
com.google.Chrome,3,1734992994,1734992997,1734992997,-21600,MacBook
com.apple.Notes,28,1734992966,1734992994,1734992994,-21600,MacBook
com.google.Chrome,2,1734992964,1734992966,1734992966,-21600,MacBook
com.apple.Notes,47,1734992917,1734992964,1734992964,-21600,MacBook
com.google.Chrome,2,1734992915,1734992917,1734992918,-21600,MacBook
com.apple.Notes,22,1734992893,1734992915,1734992915,-21600,MacBook
com.google.Chrome,73,1734992820,1734992893,1734992894,-21600,MacBook
com.sunsama.native-app,1,1734992819,1734992820,1734992820,-21600,MacBook
com.apple.Notes,13,1734992806,1734992819,1734992819,-21600,MacBook
com.google.Chrome,453,1734992353,1734992806,1734992807,-21600,MacBook
com.apple.finder,1,1734992352,1734992353,1734992354,-21600,MacBook
com.sunsama.native-app,1,1734992351,1734992352,1734992353,-21600,MacBook
com.apple.Notes,21,1734992330,1734992351,1734992352,-21600,MacBook
com.google.Chrome,106,1734992224,1734992330,1734992331,-21600,MacBook
com.sunsama.native-app,1,1734992223,1734992224,1734992225,-21600,MacBook
com.apple.Notes,14,1734992209,1734992223,1734992223,-21600,MacBook
com.google.Chrome,2,1734992207,1734992209,1734992210,-21600,MacBook
com.sunsama.native-app,1,1734992206,1734992207,1734992208,-21600,MacBook
com.apple.Notes,9,1734992197,1734992206,1734992207,-21600,MacBook
com.apple.finder,0,1734992197,1734992197,1734992198,-21600,MacBook
com.google.Chrome,514,1734991683,1734992197,1734992198,-21600,MacBook
com.sunsama.native-app,1,1734991682,1734991683,1734991684,-21600,MacBook
com.apple.Notes,6,1734991676,1734991682,1734991682,-21600,MacBook
com.sunsama.native-app,1,1734991675,1734991676,1734991676,-21600,MacBook
com.google.Chrome,2,1734991673,1734991675,1734991676,-21600,MacBook
com.sunsama.native-app,1,1734991672,1734991673,1734991674,-21600,MacBook
com.google.Chrome,44,1734991628,1734991672,1734991672,-21600,MacBook
com.sunsama.native-app,27,1734991601,1734991628,1734991629,-21600,MacBook
com.google.Chrome,7,1734991594,1734991601,1734991602,-21600,MacBook
com.sunsama.native-app,182,1734991412,1734991594,1734991595,-21600,MacBook
com.google.Chrome,30,1734991382,1734991412,1734991412,-21600,MacBook
com.sunsama.native-app,54,1734991328,1734991382,1734991382,-21600,MacBook
com.apple.Notes,266,1734991062,1734991328,1734991329,-21600,MacBook
com.sunsama.native-app,1,1734991061,1734991062,1734991062,-21600,MacBook
com.apple.Notes,1,1734991060,1734991061,1734991062,-21600,MacBook
com.sunsama.native-app,4,1734991056,1734991060,1734991061,-21600,MacBook
com.apple.Notes,12,1734991044,1734991056,1734991057,-21600,MacBook
com.sunsama.native-app,2,1734991042,1734991044,1734991045,-21600,MacBook
com.apple.Notes,13,1734991029,1734991042,1734991042,-21600,MacBook
com.sunsama.native-app,134,1734990895,1734991029,1734991030,-21600,MacBook
com.apple.finder,1,1734990894,1734990895,1734990896,-21600,MacBook
com.google.Chrome,6,1734990888,1734990894,1734990894,-21600,MacBook
com.amazon.Amazon,6,1734990854,1734990860,1734990861,-21600,iPhone
com.google.Chrome,314,1734989887,1734990201,1734990202,-21600,MacBook
com.amazon.Amazon,2,1734990038,1734990040,1734990040,-21600,iPhone
com.apple.Notes,16,1734989871,1734989887,1734989888,-21600,MacBook
com.apple.Notes,319,1734989529,1734989848,1734989849,-21600,MacBook
com.google.Chrome,551,1734988978,1734989529,1734989529,-21600,MacBook
com.apple.Notes,7,1734988971,1734988978,1734988978,-21600,MacBook
com.google.Chrome,396,1734988575,1734988971,1734988971,-21600,MacBook
com.apple.Notes,1,1734988574,1734988575,1734988575,-21600,MacBook
com.google.Chrome,55,1734988519,1734988574,1734988574,-21600,MacBook
com.apple.Notes,7,1734988512,1734988519,1734988519,-21600,MacBook
com.apple.finder,0,1734988512,1734988512,1734988513,-21600,MacBook
com.google.Chrome,198,1734988314,1734988512,1734988513,-21600,MacBook
com.apple.finder,1,1734988313,1734988314,1734988315,-21600,MacBook
com.google.Chrome,284,1734988029,1734988313,1734988313,-21600,MacBook
com.amazon.Amazon,64,1734988176,1734988240,1734988242,-21600,iPhone
com.amazon.Amazon,17,1734988157,1734988174,1734988175,-21600,iPhone
com.apple.BarcodeScanner,1,1734988156,1734988157,1734988160,-21600,iPhone
com.apple.BarcodeScanner,3,1734988151,1734988154,1734988155,-21600,iPhone
com.amazon.Amazon,3,1734988148,1734988151,1734988151,-21600,iPhone
com.apple.BarcodeScanner,5,1734988135,1734988140,1734988141,-21600,iPhone
com.apple.BarcodeScanner,15,1734988119,1734988134,1734988134,-21600,iPhone
com.apple.AuthenticationServicesUI,7,1734988123,1734988130,1734988130,-21600,iPhone
com.apple.finder,15,1734988014,1734988029,1734988030,-21600,MacBook
com.sunsama.native-app,5,1734988009,1734988014,1734988014,-21600,MacBook
com.apple.finder,10,1734987999,1734988009,1734988010,-21600,MacBook
com.apple.Notes,0,1734987999,1734987999,1734988000,-21600,MacBook
com.apple.finder,2,1734987997,1734987999,1734987999,-21600,MacBook
com.apple.Notes,42,1734987955,1734987997,1734987997,-21600,MacBook
com.sunsama.native-app,0,1734987955,1734987955,1734987956,-21600,MacBook
com.google.Chrome,195,1734987760,1734987955,1734987956,-21600,MacBook
com.sunsama.native-app,10,1734987750,1734987760,1734987761,-21600,MacBook
com.microsoft.Outlook,6,1734987744,1734987750,1734987751,-21600,MacBook
com.sunsama.native-app,0,1734987744,1734987744,1734987745,-21600,MacBook
com.google.Chrome,459,1734987285,1734987744,1734987744,-21600,MacBook
com.sunsama.native-app,10,1734987275,1734987285,1734987285,-21600,MacBook
com.google.Chrome,2,1734987273,1734987275,1734987275,-21600,MacBook
com.apple.Notes,5,1734987268,1734987273,1734987273,-21600,MacBook
com.sunsama.native-app,111,1734987157,1734987268,1734987269,-21600,MacBook
com.apple.finder,0,1734987157,1734987157,1734987157,-21600,MacBook
com.google.Chrome,3,1734987154,1734987157,1734987157,-21600,MacBook
com.apple.podcasts,4,1734987150,1734987154,1734987155,-21600,MacBook
com.google.Chrome,190,1734986960,1734987150,1734987151,-21600,MacBook
com.tencent.xin,3,1734986927,1734986930,1734986930,-21600,iPhone
com.apple.Preferences,5,1734986921,1734986926,1734986927,-21600,iPhone
com.tencent.xin,13,1734986907,1734986920,1734986920,-21600,iPhone
com.tencent.xin,6,1734986890,1734986896,1734986897,-21600,iPhone
com.tencent.xin,9,1734986419,1734986428,1734986428,-21600,iPhone
com.apple.camera,1,1734986420,1734986421,1734986422,-21600,iPhone
com.tencent.xin,1,1734986416,1734986417,1734986418,-21600,iPhone
com.tencent.xin,6,1734986396,1734986402,1734986403,-21600,iPhone
com.tencent.xin,72,1734985282,1734985354,1734985355,-21600,iPhone
com.tencent.xin,12,1734985078,1734985090,1734985091,-21600,iPhone
com.tencent.xin,56,1734984292,1734984348,1734984349,-21600,iPhone
com.apple.camera,1,1734984295,1734984296,1734984296,-21600,iPhone
com.tencent.xin,13,1734984238,1734984251,1734984251,-21600,iPhone
com.tencent.xin,21,1734984194,1734984215,1734984216,-21600,iPhone
com.apple.camera,5,1734984142,1734984147,1734984148,-21600,iPhone
com.apple.weather,5,1734984141,1734984146,1734984148,-21600,iPhone
com.apple.weather,6,1734984067,1734984073,1734984074,-21600,iPhone
com.apple.camera,1,1734984037,1734984038,1734984039,-21600,iPhone
com.apple.camera,0,1734983720,1734983720,1734983721,-21600,iPhone
com.apple.MobileSMS,10,1734983574,1734983584,1734983584,-21600,iPhone
com.tencent.xin,9,1734983564,1734983573,1734983573,-21600,iPhone
com.google.Chrome,516,1734982965,1734983481,1734983482,-21600,MacBook
com.apple.podcasts,2,1734982963,1734982965,1734982966,-21600,MacBook
com.google.Chrome,67,1734982896,1734982963,1734982964,-21600,MacBook
com.apple.podcasts,39,1734982857,1734982896,1734982897,-21600,MacBook
com.google.Chrome,3,1734982854,1734982857,1734982866,-21600,MacBook
com.apple.podcasts,2,1734982852,1734982854,1734982854,-21600,MacBook
com.google.Chrome,2,1734982850,1734982852,1734982853,-21600,MacBook
com.apple.finder,107,1734982743,1734982850,1734982850,-21600,MacBook
com.xingin.discover,2,1734982823,1734982825,1734982826,-21600,iPhone
com.google.Chrome,41,1734982702,1734982743,1734982744,-21600,MacBook
com.xingin.discover,15,1734982715,1734982730,1734982731,-21600,iPhone
com.xingin.discover,13,1734982682,1734982695,1734982695,-21600,iPhone
com.xingin.discover,3,1734982675,1734982678,1734982678,-21600,iPhone
com.xingin.discover,3102,1734979069,1734982171,1734982171,-21600,iPhone
com.xingin.discover,777,1734978251,1734979028,1734979029,-21600,iPhone
com.tinyspeck.chatlyio,12,1734978232,1734978244,1734978245,-21600,iPhone
com.tencent.xin,11,1734978216,1734978227,1734978228,-21600,iPhone
com.tencent.xin,52,1734978162,1734978214,1734978214,-21600,iPhone
com.tinyspeck.chatlyio,1,1734978161,1734978162,1734978162,-21600,iPhone
com.tencent.xin,3,1734978158,1734978161,1734978161,-21600,iPhone
com.xingin.discover,4,1734978152,1734978156,1734978157,-21600,iPhone
com.xingin.discover,44,1734978015,1734978059,1734978060,-21600,iPhone
com.xingin.discover,1564,1734976447,1734978011,1734978012,-21600,iPhone
com.xingin.discover,143,1734976253,1734976396,1734976397,-21600,iPhone
com.apple.mobiletimer,3,1734976248,1734976251,1734976252,-21600,iPhone
com.google.Chrome,569,1734975678,1734976247,1734976248,-21600,MacBook
com.apple.finder,0,1734975678,1734975678,1734975679,-21600,MacBook
com.google.Chrome,2,1734975676,1734975678,1734975679,-21600,MacBook
notion.id,14,1734975662,1734975676,1734975677,-21600,MacBook
com.google.Chrome,5,1734975657,1734975662,1734975663,-21600,MacBook
notion.id,12,1734975645,1734975657,1734975657,-21600,MacBook
com.google.Chrome,115,1734975530,1734975645,1734975646,-21600,MacBook
notion.id,3,1734975527,1734975530,1734975531,-21600,MacBook
com.google.Chrome,0,1734975527,1734975527,1734975528,-21600,MacBook
com.microsoft.Outlook,9,1734975512,1734975521,1734975522,-21600,MacBook
com.google.Chrome,610,1734974902,1734975512,1734975513,-21600,MacBook
com.apple.mobiletimer,1,1734974931,1734974932,1734974932,-21600,iPhone
com.apple.mobiletimer,9,1734974916,1734974925,1734974927,-21600,iPhone
com.apple.sidecar,3,1734974916,1734974919,1734974919,-21600,iPhone
com.google.Chrome,472,1734974197,1734974669,1734974670,-21600,MacBook
com.google.Chrome,258,1734973720,1734973978,1734973979,-21600,MacBook
com.microsoft.Outlook,14,1734973659,1734973673,1734973674,-21600,MacBook
com.google.Chrome,59,1734973600,1734973659,1734973660,-21600,MacBook
com.microsoft.Outlook,30,1734973570,1734973600,1734973601,-21600,MacBook
com.google.Chrome,174,1734973396,1734973570,1734973571,-21600,MacBook
com.microsoft.Outlook,12,1734973384,1734973396,1734973397,-21600,MacBook
com.google.Chrome,11,1734973373,1734973384,1734973385,-21600,MacBook
com.apple.mobiletimer,25,1734973200,1734973225,1734973226,-21600,iPhone
com.apple.mobiletimer,30,1734972300,1734972330,1734972331,-21600,iPhone
com.apple.mobiletimer,5,1734971596,1734971601,1734971602,-21600,iPhone
com.apple.mobiletimer,25,1734971400,1734971425,1734971425,-21600,iPhone
com.apple.mobiletimer,45,1734968905,1734968950,1734968951,-21600,iPhone
com.apple.mobiletimer,4,1734968900,1734968904,1734968905,-21600,iPhone
com.apple.mobiletimer,5,1734968777,1734968782,1734968783,-21600,iPhone
com.microsoft.Office.Outlook,2,1734968760,1734968762,1734968763,-21600,iPhone
com.xingin.discover,3,1734968757,1734968760,1734968760,-21600,iPhone
com.xingin.discover,18,1734968734,1734968752,1734968752,-21600,iPhone
com.xingin.discover,1,1734968733,1734968734,1734968734,-21600,iPhone
com.xingin.discover,767,1734942232,1734942999,1734942999,-21600,iPhone
com.google.chrome.ios,42,1734942188,1734942230,1734942231,-21600,iPhone
com.apple.mobilesafari,5,1734942183,1734942188,1734942188,-21600,iPhone
com.google.chrome.ios,53,1734942130,1734942183,1734942184,-21600,iPhone
com.apple.mobilesafari,116,1734942014,1734942130,1734942131,-21600,iPhone
com.google.chrome.ios,32,1734941981,1734942013,1734942013,-21600,iPhone
com.google.chrome.ios,28,1734941371,1734941399,1734941399,-21600,iPhone
com.apple.mobilenotes,302,1734941068,1734941370,1734941370,-21600,iPhone
com.apple.mobilenotes,809,1734940258,1734941067,1734941068,-21600,iPhone
com.openai.chat,10,1734940248,1734940258,1734940258,-21600,iPhone
com.apple.mobilenotes,41,1734940207,1734940248,1734940249,-21600,iPhone
com.google.chrome.ios,8,1734940198,1734940206,1734940207,-21600,iPhone
com.apple.mobilesafari,2,1734940196,1734940198,1734940199,-21600,iPhone
com.apple.mobiletimer,5,1734940191,1734940196,1734940196,-21600,iPhone
com.apple.mobiletimer,1,1734939984,1734939985,1734939985,-21600,iPhone
com.apple.mobiletimer,16,1734939799,1734939815,1734939815,-21600,iPhone
com.microsoft.Office.Outlook,3,1734939792,1734939795,1734939795,-21600,iPhone
com.apple.MobileSMS,2,1734939789,1734939791,1734939792,-21600,iPhone
com.microsoft.Office.Outlook,2,1734939786,1734939788,1734939788,-21600,iPhone
com.tencent.xin,7,1734939777,1734939784,1734939785,-21600,iPhone
com.tencent.xin,2,1734939772,1734939774,1734939775,-21600,iPhone
com.google.Chrome,3,1734939738,1734939741,1734939742,-21600,MacBook
com.apple.Notes,14,1734939724,1734939738,1734939739,-21600,MacBook
com.apple.finder,149,1734939575,1734939724,1734939725,-21600,MacBook
com.apple.Notes,1,1734939574,1734939575,1734939576,-21600,MacBook
com.apple.finder,0,1734939574,1734939574,1734939575,-21600,MacBook
com.apple.Notes,6,1734939568,1734939574,1734939574,-21600,MacBook
com.apple.finder,3,1734939565,1734939568,1734939569,-21600,MacBook
com.google.Chrome,1,1734939564,1734939565,1734939565,-21600,MacBook
com.apple.podcasts,13,1734939551,1734939564,1734939565,-21600,MacBook
com.google.Chrome,14,1734939537,1734939551,1734939552,-21600,MacBook
com.sunsama.native-app,36,1734939501,1734939537,1734939537,-21600,MacBook
com.apple.Notes,4,1734939497,1734939501,1734939502,-21600,MacBook
com.google.Chrome,1169,1734938328,1734939497,1734939498,-21600,MacBook
com.tencent.xin,9,1734938556,1734938565,1734938566,-21600,iPhone
com.sunsama.native-app,127,1734938201,1734938328,1734938329,-21600,MacBook
com.google.Chrome,4,1734938197,1734938201,1734938202,-21600,MacBook
com.sunsama.native-app,42,1734938155,1734938197,1734938197,-21600,MacBook
com.google.Chrome,12,1734938143,1734938155,1734938155,-21600,MacBook
com.sunsama.native-app,532,1734937611,1734938143,1734938144,-21600,MacBook
com.google.Chrome,2,1734937609,1734937611,1734937612,-21600,MacBook
com.google.Chrome,338,1734936935,1734937273,1734937274,-21600,MacBook
com.apple.podcasts,5,1734936930,1734936935,1734936935,-21600,MacBook
com.tencent.xin,5,1734936152,1734936157,1734936158,-21600,iPhone
com.tencent.xin,31,1734936092,1734936123,1734936124,-21600,iPhone
com.tencent.xin,10,1734935958,1734935968,1734935969,-21600,iPhone
com.tencent.xin,10,1734935947,1734935957,1734935958,-21600,iPhone
com.tencent.xin,10,1734935936,1734935946,1734935947,-21600,iPhone
com.tencent.xin,10,1734935916,1734935926,1734935927,-21600,iPhone
com.tencent.xin,19,1734935800,1734935819,1734935820,-21600,iPhone
com.apple.PassbookUIService,3,1734935801,1734935804,1734935804,-21600,iPhone
com.tencent.xin,8,1734935470,1734935478,1734935479,-21600,iPhone
com.tencent.xin,15,1734935453,1734935468,1734935469,-21600,iPhone
com.microsoft.Office.Outlook,8,1734935445,1734935453,1734935454,-21600,iPhone
com.tencent.xin,2,1734935443,1734935445,1734935446,-21600,iPhone
com.xingin.discover,1239,1734934204,1734935443,1734935444,-21600,iPhone
com.google.ios.youtube,128,1734934075,1734934203,1734934203,-21600,iPhone
com.openai.chat,294,1734933781,1734934075,1734934076,-21600,iPhone
com.google.ios.youtube,1,1734933780,1734933781,1734933782,-21600,iPhone
com.openai.chat,361,1734933419,1734933780,1734933780,-21600,iPhone
com.google.ios.youtube,645,1734932774,1734933419,1734933420,-21600,iPhone
com.openai.chat,369,1734932772,1734933141,1734933142,-21600,iPhone
com.google.ios.youtube,287,1734932485,1734932772,1734932772,-21600,iPhone
com.openai.chat,92,1734932393,1734932485,1734932486,-21600,iPhone
com.google.ios.youtube,160,1734932233,1734932393,1734932393,-21600,iPhone
com.openai.chat,20,1734932213,1734932233,1734932234,-21600,iPhone
com.google.ios.youtube,673,1734931540,1734932213,1734932214,-21600,iPhone
com.google.chrome.ios,256,1734931284,1734931540,1734931540,-21600,iPhone
com.xingin.discover,126,1734931158,1734931284,1734931285,-21600,iPhone
com.tencent.xin,11,1734931147,1734931158,1734931158,-21600,iPhone
com.apple.mobilenotes,4,1734931143,1734931147,1734931148,-21600,iPhone
com.tencent.xin,4,1734931139,1734931143,1734931143,-21600,iPhone
com.apple.mobilenotes,19,1734931120,1734931139,1734931139,-21600,iPhone
com.microsoft.Office.Outlook,2,1734931118,1734931120,1734931121,-21600,iPhone
com.apple.mobilenotes,12,1734931106,1734931118,1734931119,-21600,iPhone
com.tencent.xin,20,1734931085,1734931105,1734931106,-21600,iPhone
com.google.chrome.ios,2,1734931082,1734931084,1734931084,-21600,iPhone
com.xingin.discover,1,1734931081,1734931082,1734931082,-21600,iPhone
com.openai.chat,143,1734930938,1734931081,1734931081,-21600,iPhone
com.xingin.discover,265,1734930673,1734930938,1734930938,-21600,iPhone
com.tencent.xin,8,1734930665,1734930673,1734930674,-21600,iPhone
com.xingin.discover,10,1734930655,1734930665,1734930666,-21600,iPhone
com.tencent.xin,13,1734930642,1734930655,1734930655,-21600,iPhone
com.openai.chat,11,1734930631,1734930642,1734930643,-21600,iPhone
com.tencent.xin,83,1734930548,1734930631,1734930632,-21600,iPhone
com.openai.chat,7,1734930541,1734930548,1734930549,-21600,iPhone
com.tencent.xin,80,1734930461,1734930541,1734930542,-21600,iPhone
com.openai.chat,41,1734930420,1734930461,1734930461,-21600,iPhone
com.tencent.xin,9,1734930411,1734930420,1734930421,-21600,iPhone
com.openai.chat,6,1734930405,1734930411,1734930411,-21600,iPhone
com.tencent.xin,22,1734930383,1734930405,1734930406,-21600,iPhone
com.openai.chat,5,1734930378,1734930383,1734930383,-21600,iPhone
com.tencent.xin,51,1734930327,1734930378,1734930379,-21600,iPhone
com.openai.chat,3,1734930324,1734930327,1734930327,-21600,iPhone
com.tencent.xin,79,1734930245,1734930324,1734930325,-21600,iPhone
com.openai.chat,165,1734930080,1734930245,1734930245,-21600,iPhone
com.xingin.discover,2,1734930078,1734930080,1734930080,-21600,iPhone
com.openai.chat,94,1734929984,1734930078,1734930079,-21600,iPhone
com.xingin.discover,47,1734929937,1734929984,1734929985,-21600,iPhone
com.openai.chat,1,1734929936,1734929937,1734929938,-21600,iPhone
com.xingin.discover,99,1734929837,1734929936,1734929936,-21600,iPhone
com.apple.PassbookUIService,31,1734929785,1734929816,1734929816,-21600,iPhone
com.xingin.discover,2809,1734927007,1734929816,1734929816,-21600,iPhone
com.tencent.xin,75,1734926932,1734927007,1734927008,-21600,iPhone
com.xingin.discover,17,1734926915,1734926932,1734926932,-21600,iPhone
com.tencent.xin,25,1734926887,1734926912,1734926912,-21600,iPhone
com.tencent.xin,16,1734926866,1734926882,1734926883,-21600,iPhone
com.tencent.xin,17,1734926849,1734926866,1734926866,-21600,iPhone
com.tencent.xin,22,1734926823,1734926845,1734926846,-21600,iPhone
com.xingin.discover,430,1734926393,1734926823,1734926824,-21600,iPhone
com.tencent.xin,44,1734926349,1734926393,1734926394,-21600,iPhone
com.microsoft.Office.Outlook,6,1734926343,1734926349,1734926350,-21600,iPhone
com.tencent.xin,1,1734926342,1734926343,1734926344,-21600,iPhone
com.xingin.discover,220,1734926122,1734926342,1734926342,-21600,iPhone
com.tencent.xin,19,1734926102,1734926121,1734926122,-21600,iPhone
com.tencent.xin,5,1734926030,1734926035,1734926036,-21600,iPhone
com.tencent.xin,32,1734925974,1734926006,1734926008,-21600,iPhone
com.xingin.discover,31,1734925943,1734925974,1734925975,-21600,iPhone
com.apple.calculator,1,1734925941,1734925942,1734925943,-21600,iPhone
com.tencent.xin,41,1734925900,1734925941,1734925941,-21600,iPhone
com.apple.calculator,14,1734925886,1734925900,1734925900,-21600,iPhone
com.tencent.xin,5,1734925881,1734925886,1734925887,-21600,iPhone
com.discoverfinancial.mobile,2,1734925879,1734925881,1734925882,-21600,iPhone
com.ubercab.UberEats,15,1734925864,1734925879,1734925880,-21600,iPhone
com.discoverfinancial.mobile,21,1734925840,1734925861,1734925862,-21600,iPhone
com.apple.CoreAuthUI,2,1734925843,1734925845,1734925846,-21600,iPhone
com.tencent.xin,13,1734925827,1734925840,1734925841,-21600,iPhone
com.discoverfinancial.mobile,1,1734925826,1734925827,1734925827,-21600,iPhone
com.tencent.xin,1,1734925825,1734925826,1734925827,-21600,iPhone
com.xingin.discover,1551,1734924270,1734925821,1734925822,-21600,iPhone
net.whatsapp.WhatsApp,10,1734924260,1734924270,1734924271,-21600,iPhone
com.tencent.xin,2,1734924258,1734924260,1734924261,-21600,iPhone
com.xingin.discover,841,1734923417,1734924258,1734924259,-21600,iPhone
com.tencent.xin,5,1734923412,1734923417,1734923418,-21600,iPhone
net.whatsapp.WhatsApp,28,1734923383,1734923411,1734923412,-21600,iPhone
com.xingin.discover,1552,1734921831,1734923383,1734923383,-21600,iPhone
tv.danmaku.bilianime,898,1734920931,1734921829,1734921829,-21600,iPhone
com.naver.linewebtoon,2,1734920928,1734920930,1734920930,-21600,iPhone
com.bilibili.bilicomic,1,1734920927,1734920928,1734920929,-21600,iPhone
tv.danmaku.bilianime,1,1734920926,1734920927,1734920928,-21600,iPhone
com.bilibili.bilicomic,110,1734920814,1734920924,1734920925,-21600,iPhone
com.apple.camera,0,1734920189,1734920189,1734920190,-21600,iPhone
com.google.calendar,3,1734920179,1734920182,1734920182,-21600,iPhone
com.google.calendar,31,1734920115,1734920146,1734920147,-21600,iPhone
com.google.calendar,6,1734920063,1734920069,1734920070,-21600,iPhone
com.google.calendar,6,1734920034,1734920040,1734920041,-21600,iPhone
com.google.calendar,24,1734920001,1734920025,1734920026,-21600,iPhone
com.google.calendar,10,1734919967,1734919977,1734919978,-21600,iPhone
com.google.calendar,76,1734919881,1734919957,1734919958,-21600,iPhone
com.amazon.Amazon,3,1734919877,1734919880,1734919881,-21600,iPhone
com.amazon.Amazon,6,1734918791,1734918797,1734918798,-21600,iPhone
com.amazon.Amazon,90,1734918192,1734918282,1734918283,-21600,iPhone
com.apple.mobiletimer,5,1734918187,1734918192,1734918192,-21600,iPhone
com.apple.camera,18,1734911811,1734911829,1734911830,-21600,iPhone
com.tencent.xin,9,1734911809,1734911818,1734911819,-21600,iPhone
com.tencent.xin,3,1734910767,1734910770,1734910770,-21600,iPhone
com.apple.PassbookUIService,3,1734910767,1734910770,1734910770,-21600,iPhone
com.tencent.xin,8,1734909931,1734909939,1734909940,-21600,iPhone
com.tencent.xin,69,1734908676,1734908745,1734908747,-21600,iPhone
com.apple.MobileSMS,3,1734908673,1734908676,1734908677,-21600,iPhone
com.microsoft.Office.Outlook,13,1734908656,1734908669,1734908669,-21600,iPhone
com.google.Maps,3,1734908653,1734908656,1734908657,-21600,iPhone
com.google.Maps,11,1734908530,1734908541,1734908542,-21600,iPhone
com.zimride.instant,12,1734908517,1734908529,1734908529,-21600,iPhone
com.apple.camera,2,1734908521,1734908523,1734908524,-21600,iPhone
com.zimride.instant,14,1734907850,1734907864,1734907865,-21600,iPhone
com.apple.PassbookUIService,5,1734907850,1734907855,1734907856,-21600,iPhone
com.zimride.instant,5,1734907672,1734907677,1734907677,-21600,iPhone
com.zimride.instant,3,1734907669,1734907672,1734907672,-21600,iPhone
com.zimride.instant,30,1734907636,1734907666,1734907667,-21600,iPhone
com.zimride.instant,18,1734907498,1734907516,1734907516,-21600,iPhone
com.zimride.instant,14,1734907419,1734907433,1734907433,-21600,iPhone
com.zimride.instant,53,1734907361,1734907414,1734907414,-21600,iPhone
com.apple.PassbookUIService,11,1734907395,1734907406,1734907407,-21600,iPhone
com.google.Maps,5,1734907356,1734907361,1734907362,-21600,iPhone
com.google.Maps,34,1734906895,1734906929,1734906930,-21600,iPhone
com.zimride.instant,24,1734906869,1734906893,1734906894,-21600,iPhone
com.ubercab.UberClient,14,1734906855,1734906869,1734906870,-21600,iPhone
com.apple.camera,5,1734906369,1734906374,1734906375,-21600,iPhone
com.google.chrome.ios,7,1734902894,1734902901,1734902901,-21600,iPhone
com.google.chrome.ios,230,1734901719,1734901949,1734901952,-21600,iPhone
com.apple.BarcodeScanner,5,1734901714,1734901719,1734901719,-21600,iPhone
com.tencent.xin,2,1734901711,1734901713,1734901713,-21600,iPhone
com.tencent.xin,4,1734900741,1734900745,1734900746,-21600,iPhone
com.ubercab.UberClient,4,1734900736,1734900740,1734900742,-21600,iPhone
com.ubercab.UberClient,5,1734900731,1734900736,1734900737,-21600,iPhone
com.apple.camera,1,1734900733,1734900734,1734900734,-21600,iPhone
com.ubercab.UberClient,4,1734900601,1734900605,1734900605,-21600,iPhone
com.ubercab.UberClient,1,1734899659,1734899660,1734899661,-21600,iPhone
com.ubercab.UberClient,14,1734899246,1734899260,1734899261,-21600,iPhone
com.google.Maps,2,1734899244,1734899246,1734899248,-21600,iPhone
com.tencent.xin,12,1734899232,1734899244,1734899245,-21600,iPhone
com.apple.Preferences,9,1734899223,1734899232,1734899232,-21600,iPhone
com.tencent.xin,6,1734899215,1734899221,1734899222,-21600,iPhone
com.google.Maps,2,1734899213,1734899215,1734899216,-21600,iPhone
com.tencent.xin,1,1734899212,1734899213,1734899214,-21600,iPhone
com.google.Maps,2,1734899210,1734899212,1734899213,-21600,iPhone
com.ubercab.UberClient,20,1734899190,1734899210,1734899211,-21600,iPhone
com.google.Maps,1,1734899189,1734899190,1734899191,-21600,iPhone
com.google.calendar,4,1734899185,1734899189,1734899190,-21600,iPhone
com.google.calendar,2,1734899182,1734899184,1734899185,-21600,iPhone
com.ubercab.UberClient,39,1734895228,1734895267,1734895267,-21600,iPhone
com.ubercab.UberClient,8,1734895220,1734895228,1734895228,-21600,iPhone
com.microsoft.Office.Outlook,3,1734895215,1734895218,1734895219,-21600,iPhone
com.microsoft.Office.Outlook,6,1734895208,1734895214,1734895215,-21600,iPhone
com.microsoft.Office.Outlook,6,1734895201,1734895207,1734895208,-21600,iPhone
com.microsoft.Office.Outlook,5,1734895144,1734895149,1734895150,-21600,iPhone
com.microsoft.Office.Outlook,9,1734895135,1734895144,1734895144,-21600,iPhone
com.apple.MobileSMS,4,1734895131,1734895135,1734895135,-21600,iPhone
com.microsoft.Office.Outlook,2,1734895129,1734895131,1734895132,-21600,iPhone
com.apple.calculator,50,1734895077,1734895127,1734895128,-21600,iPhone
com.apple.Preferences,19,1734895057,1734895076,1734895077,-21600,iPhone
com.apple.mobiletimer,13,1734895042,1734895055,1734895055,-21600,iPhone
com.apple.PassbookUIService,7,1734895043,1734895050,1734895050,-21600,iPhone
com.apple.mobiletimer,4,1734892667,1734892671,1734892671,-21600,iPhone
com.google.Maps,3,1734888727,1734888730,1734888731,-21600,iPhone
com.google.Maps,25,1734888000,1734888025,1734888025,-21600,iPhone
com.google.Maps,18,1734887975,1734887993,1734887993,-21600,iPhone
com.tencent.xin,4,1734887971,1734887975,1734887975,-21600,iPhone
com.tencent.xin,7,1734887857,1734887864,1734887865,-21600,iPhone
com.tencent.xin,6,1734887504,1734887510,1734887511,-21600,iPhone
com.tencent.xin,2,1734887475,1734887477,1734887478,-21600,iPhone
com.tencent.xin,6,1734887374,1734887380,1734887381,-21600,iPhone
com.tencent.xin,6,1734887323,1734887329,1734887330,-21600,iPhone
com.tencent.xin,1,1734887259,1734887260,1734887261,-21600,iPhone
com.tencent.xin,2,1734887207,1734887209,1734887209,-21600,iPhone
com.tencent.xin,5,1734887163,1734887168,1734887168,-21600,iPhone
com.tencent.xin,2,1734887038,1734887040,1734887040,-21600,iPhone
com.tencent.xin,29,1734886983,1734887012,1734887013,-21600,iPhone
com.ubercab.UberClient,6,1734886977,1734886983,1734886983,-21600,iPhone
com.tencent.xin,10,1734886967,1734886977,1734886978,-21600,iPhone
com.ubercab.UberClient,15,1734886952,1734886967,1734886968,-21600,iPhone
com.tencent.xin,4,1734886948,1734886952,1734886953,-21600,iPhone
com.tencent.xin,17,1734886868,1734886885,1734886885,-21600,iPhone
com.tencent.xin,32,1734886825,1734886857,1734886858,-21600,iPhone
com.ubercab.UberClient,25,1734886799,1734886824,1734886825,-21600,iPhone
com.ubercab.UberClient,5,1734886674,1734886679,1734886680,-21600,iPhone
com.amazon.Amazon,30,1734886644,1734886674,1734886674,-21600,iPhone
com.ubercab.UberClient,2,1734886641,1734886643,1734886644,-21600,iPhone
com.ubercab.UberClient,4,1734886605,1734886609,1734886609,-21600,iPhone
com.tencent.xin,2,1734886603,1734886605,1734886605,-21600,iPhone
com.tencent.xin,3,1734886576,1734886579,1734886580,-21600,iPhone
com.ubercab.UberClient,14,1734886562,1734886576,1734886577,-21600,iPhone
com.ubercab.UberClient,102,1734886412,1734886514,1734886515,-21600,iPhone
com.apple.PassbookUIService,8,1734886427,1734886435,1734886436,-21600,iPhone
com.tencent.xin,25,1734886387,1734886412,1734886413,-21600,iPhone
com.ubercab.UberClient,14,1734886373,1734886387,1734886387,-21600,iPhone
com.tencent.xin,5,1734886368,1734886373,1734886373,-21600,iPhone
com.ubercab.UberClient,7,1734886361,1734886368,1734886369,-21600,iPhone
com.tencent.xin,2,1734886359,1734886361,1734886361,-21600,iPhone
com.ubercab.UberClient,45,1734886314,1734886359,1734886360,-21600,iPhone
com.tencent.xin,10,1734886304,1734886314,1734886315,-21600,iPhone
com.ubercab.UberClient,1,1734886303,1734886304,1734886304,-21600,iPhone
com.tencent.xin,7,1734886295,1734886302,1734886303,-21600,iPhone
com.tencent.xin,10,1734886192,1734886202,1734886202,-21600,iPhone
com.tencent.xin,64,1734886117,1734886181,1734886182,-21600,iPhone
com.apple.AppStore,3,1734886114,1734886117,1734886117,-21600,iPhone
com.tencent.weread,83,1734886014,1734886097,1734886097,-21600,iPad
com.apple.Preferences,1,1734886013,1734886014,1734886014,-21600,iPad
com.tencent.weread,47,1734885966,1734886013,1734886014,-21600,iPad
com.apple.mobilesafari,8,1734885958,1734885966,1734885973,-21600,iPad
com.apple.AppStore,6,1734885956,1734885962,1734885962,-21600,iPhone
com.apple.AppStore,84,1734885816,1734885900,1734885901,-21600,iPhone
com.apple.PassbookUIService,14,1734885826,1734885840,1734885841,-21600,iPhone
com.duosecurity.DuoMobile,1,1734885814,1734885815,1734885816,-21600,iPhone
com.tencent.xin,1,1734885812,1734885813,1734885814,-21600,iPhone
com.tencent.xin,3,1734885701,1734885704,1734885705,-21600,iPhone
com.tencent.xin,25,1734885669,1734885694,1734885694,-21600,iPhone
com.tencent.xin,1,1734885658,1734885659,1734885660,-21600,iPhone
com.tencent.xin,15,1734885562,1734885577,1734885578,-21600,iPhone
com.tencent.xin,19,1734885542,1734885561,1734885562,-21600,iPhone
com.tencent.xin,10,1734885486,1734885496,1734885496,-21600,iPhone
com.tencent.xin,2,1734885400,1734885402,1734885403,-21600,iPhone
com.tencent.xin,3,1734885392,1734885395,1734885395,-21600,iPhone
com.tencent.xin,1,1734885387,1734885388,1734885389,-21600,iPhone
com.tencent.xin,6,1734885375,1734885381,1734885381,-21600,iPhone
com.tencent.xin,8,1734885365,1734885373,1734885373,-21600,iPhone
com.tencent.xin,29,1734885297,1734885326,1734885327,-21600,iPhone
com.tencent.xin,41,1734885225,1734885266,1734885267,-21600,iPhone
com.tencent.xin,6,1734885217,1734885223,1734885224,-21600,iPhone
com.tinyspeck.chatlyio,6,1734885211,1734885217,1734885217,-21600,iPhone
com.tencent.xin,2,1734885209,1734885211,1734885211,-21600,iPhone
tv.danmaku.bilianime,469,1734884738,1734885207,1734885208,-21600,iPhone
com.tencent.weread,12,1734884726,1734884738,1734884739,-21600,iPhone
tv.danmaku.bilianime,1,1734884725,1734884726,1734884727,-21600,iPhone
com.tencent.weread,1,1734884724,1734884725,1734884725,-21600,iPhone
com.bilibili.bilicomic,2,1734884721,1734884723,1734884723,-21600,iPhone
com.tencent.xin,5,1734884712,1734884717,1734884717,-21600,iPhone
com.tencent.xin,0,1734884696,1734884696,1734884697,-21600,iPhone
com.tencent.xin,1,1734884690,1734884691,1734884692,-21600,iPhone
com.tencent.xin,2,1734884666,1734884668,1734884669,-21600,iPhone
com.apple.MobileSMS,6,1734884659,1734884665,1734884665,-21600,iPhone
com.apple.MobileSMS,3,1734884600,1734884603,1734884604,-21600,iPhone
com.tencent.xin,33,1734884565,1734884598,1734884599,-21600,iPhone
com.tencent.xin,29,1734884100,1734884129,1734884130,-21600,iPhone
com.tencent.xin,11,1734884024,1734884035,1734884036,-21600,iPhone
com.tencent.xin,25,1734883921,1734883946,1734883946,-21600,iPhone
com.tencent.xin,14,1734883399,1734883413,1734883413,-21600,iPhone
com.tencent.xin,2,1734883396,1734883398,1734883399,-21600,iPhone
com.microsoft.Office.Outlook,10,1734883386,1734883396,1734883397,-21600,iPhone
com.tencent.xin,21,1734876600,1734876621,1734876623,-21600,iPhone
com.tinyspeck.chatlyio,8,1734876592,1734876600,1734876600,-21600,iPhone
com.tencent.xin,1,1734876590,1734876591,1734876592,-21600,iPhone
com.google.chrome.ios,7,1734876580,1734876587,1734876588,-21600,iPhone
com.google.chrome.ios,1079,1734856697,1734857776,1734857777,-21600,iPhone
com.google.chrome.ios,367,1734856325,1734856692,1734856693,-21600,iPhone
com.apple.mobilesafari,1,1734856324,1734856325,1734856326,-21600,iPhone
com.google.chrome.ios,2,1734856322,1734856324,1734856325,-21600,iPhone
com.apple.mobiletimer,64,1734856251,1734856315,1734856316,-21600,iPhone
com.apple.mobiletimer,3,1734856247,1734856250,1734856250,-21600,iPhone
com.tinyspeck.chatlyio,4,1734856242,1734856246,1734856246,-21600,iPhone
com.tinyspeck.chatlyio,7,1734856202,1734856209,1734856209,-21600,iPhone
com.apple.camera,1,1734856202,1734856203,1734856203,-21600,iPhone
com.tinyspeck.chatlyio,3,1734856072,1734856075,1734856075,-21600,iPhone
com.apple.podcasts,3,1734856063,1734856066,1734856067,-21600,MacBook
com.google.Chrome,20,1734856043,1734856063,1734856063,-21600,MacBook
com.sunsama.native-app,25,1734856018,1734856043,1734856044,-21600,MacBook
com.google.Chrome,1,1734856017,1734856018,1734856019,-21600,MacBook
com.sunsama.native-app,4,1734856013,1734856017,1734856018,-21600,MacBook
com.google.Chrome,3,1734856010,1734856013,1734856014,-21600,MacBook
com.apple.finder,4,1734856006,1734856010,1734856011,-21600,MacBook
com.apple.finder,5,1734855922,1734855927,1734855927,-21600,MacBook
com.google.Chrome,79,1734855843,1734855922,1734855922,-21600,MacBook
com.apple.Notes,14,1734855829,1734855843,1734855844,-21600,MacBook
com.google.Chrome,69,1734855760,1734855829,1734855830,-21600,MacBook
com.microsoft.Outlook,1,1734855759,1734855760,1734855761,-21600,MacBook
com.google.Chrome,75,1734855684,1734855759,1734855760,-21600,MacBook
com.microsoft.Outlook,2,1734855662,1734855664,1734855665,-21600,MacBook
com.google.Chrome,20,1734855642,1734855662,1734855663,-21600,MacBook
com.microsoft.Outlook,14,1734855628,1734855642,1734855642,-21600,MacBook
com.apple.finder,1,1734855627,1734855628,1734855629,-21600,MacBook
com.google.Chrome,10,1734855617,1734855627,1734855628,-21600,MacBook
com.apple.finder,1,1734855616,1734855617,1734855618,-21600,MacBook
com.google.Chrome,3,1734855613,1734855616,1734855616,-21600,MacBook
com.microsoft.Outlook,19,1734855594,1734855613,1734855614,-21600,MacBook
com.google.Chrome,202,1734855392,1734855594,1734855594,-21600,MacBook
com.apple.Notes,13,1734855379,1734855392,1734855392,-21600,MacBook
com.google.Chrome,2,1734855377,1734855379,1734855379,-21600,MacBook
com.sunsama.native-app,0,1734855377,1734855377,1734855378,-21600,MacBook
com.google.Chrome,56,1734855321,1734855377,1734855377,-21600,MacBook
com.apple.finder,2,1734855319,1734855321,1734855321,-21600,MacBook
com.google.Chrome,3,1734855316,1734855319,1734855319,-21600,MacBook
com.apple.finder,2,1734855314,1734855316,1734855317,-21600,MacBook
com.google.Chrome,6,1734855308,1734855314,1734855314,-21600,MacBook
com.apple.Notes,55,1734855253,1734855308,1734855309,-21600,MacBook
com.google.Chrome,2,1734855251,1734855253,1734855254,-21600,MacBook
com.apple.Notes,0,1734855251,1734855251,1734855252,-21600,MacBook
com.sunsama.native-app,1,1734855250,1734855251,1734855251,-21600,MacBook
com.apple.Notes,7,1734855243,1734855250,1734855250,-21600,MacBook
com.google.Chrome,142,1734855101,1734855243,1734855244,-21600,MacBook
com.sunsama.native-app,1,1734855100,1734855101,1734855102,-21600,MacBook
com.google.Chrome,67,1734855033,1734855100,1734855100,-21600,MacBook
com.apple.Notes,4,1734855029,1734855033,1734855034,-21600,MacBook
com.google.Chrome,21,1734855008,1734855029,1734855030,-21600,MacBook
com.apple.Notes,34,1734854974,1734855008,1734855008,-21600,MacBook
com.google.Chrome,1,1734854973,1734854974,1734854975,-21600,MacBook
com.sunsama.native-app,1,1734854972,1734854973,1734854974,-21600,MacBook
com.google.Chrome,94,1734854878,1734854972,1734854972,-21600,MacBook
com.apple.Notes,4,1734854874,1734854878,1734854878,-21600,MacBook
com.google.Chrome,1,1734854873,1734854874,1734854874,-21600,MacBook
com.sunsama.native-app,1,1734854872,1734854873,1734854873,-21600,MacBook
com.google.Chrome,341,1734854531,1734854872,1734854872,-21600,MacBook
com.apple.Notes,3,1734854528,1734854531,1734854531,-21600,MacBook
com.google.Chrome,2,1734854526,1734854528,1734854528,-21600,MacBook
com.sunsama.native-app,1,1734854525,1734854526,1734854527,-21600,MacBook
com.google.Chrome,48,1734854477,1734854525,1734854526,-21600,MacBook
com.apple.Notes,13,1734854464,1734854477,1734854478,-21600,MacBook
com.apple.finder,1,1734854463,1734854464,1734854464,-21600,MacBook
com.apple.Notes,5,1734854458,1734854463,1734854463,-21600,MacBook
com.apple.finder,1,1734854457,1734854458,1734854458,-21600,MacBook
com.google.Chrome,3,1734854454,1734854457,1734854457,-21600,MacBook
com.sunsama.native-app,5,1734854449,1734854454,1734854455,-21600,MacBook
com.google.Chrome,668,1734853781,1734854449,1734854450,-21600,MacBook
com.sunsama.native-app,2,1734853779,1734853781,1734853781,-21600,MacBook
com.google.Chrome,25,1734853754,1734853779,1734853780,-21600,MacBook
com.sunsama.native-app,1,1734853753,1734853754,1734853755,-21600,MacBook
com.google.Chrome,5,1734853748,1734853753,1734853753,-21600,MacBook
com.sunsama.native-app,94,1734853654,1734853748,1734853749,-21600,MacBook
com.google.Chrome,7,1734853647,1734853654,1734853654,-21600,MacBook
com.sunsama.native-app,1,1734853646,1734853647,1734853648,-21600,MacBook
com.google.Chrome,5,1734853641,1734853646,1734853646,-21600,MacBook
com.sunsama.native-app,371,1734853270,1734853641,1734853641,-21600,MacBook
com.apple.Notes,3,1734853267,1734853270,1734853271,-21600,MacBook
com.apple.finder,0,1734853267,1734853267,1734853268,-21600,MacBook
com.apple.Notes,2,1734853265,1734853267,1734853267,-21600,MacBook
com.apple.finder,0,1734853265,1734853265,1734853266,-21600,MacBook
com.apple.Notes,30,1734853235,1734853265,1734853265,-21600,MacBook
com.apple.Notes,302,1734852104,1734852406,1734852406,-21600,MacBook
com.apple.finder,1,1734852103,1734852104,1734852104,-21600,MacBook
com.apple.Notes,0,1734852103,1734852103,1734852104,-21600,MacBook
com.apple.finder,1,1734852102,1734852103,1734852103,-21600,MacBook
com.apple.Notes,1,1734852101,1734852102,1734852103,-21600,MacBook
com.apple.finder,1,1734852100,1734852101,1734852101,-21600,MacBook
com.apple.Notes,1,1734852099,1734852100,1734852101,-21600,MacBook
com.apple.finder,0,1734852099,1734852099,1734852100,-21600,MacBook
com.apple.Notes,1,1734852098,1734852099,1734852099,-21600,MacBook
com.apple.finder,0,1734852098,1734852098,1734852098,-21600,MacBook
com.apple.Notes,3,1734852095,1734852098,1734852098,-21600,MacBook
com.apple.finder,1,1734852094,1734852095,1734852095,-21600,MacBook
com.apple.Notes,0,1734852094,1734852094,1734852095,-21600,MacBook
com.apple.finder,1,1734852093,1734852094,1734852094,-21600,MacBook
com.apple.Notes,0,1734852093,1734852093,1734852094,-21600,MacBook
com.apple.finder,1,1734852092,1734852093,1734852093,-21600,MacBook
com.apple.Notes,7,1734852085,1734852092,1734852093,-21600,MacBook
com.apple.finder,1,1734852084,1734852085,1734852086,-21600,MacBook
com.apple.Notes,4,1734852080,1734852084,1734852084,-21600,MacBook
com.google.Chrome,157,1734851923,1734852080,1734852080,-21600,MacBook
com.google.Chrome,505,1734850913,1734851418,1734851419,-21600,MacBook
com.apple.Notes,5,1734850908,1734850913,1734850913,-21600,MacBook
com.sunsama.native-app,2,1734850906,1734850908,1734850909,-21600,MacBook
com.google.Chrome,5,1734850901,1734850906,1734850907,-21600,MacBook
com.sunsama.native-app,16,1734850885,1734850901,1734850901,-21600,MacBook
com.sunsama.native-app,309,1734850376,1734850685,1734850685,-21600,MacBook
com.google.Chrome,177,1734850199,1734850376,1734850377,-21600,MacBook
com.sunsama.native-app,2,1734850197,1734850199,1734850200,-21600,MacBook
com.tinyspeck.chatlyio,4,1734850193,1734850197,1734850198,-21600,iPhone
com.sunsama.native-app,312,1734849229,1734849541,1734849541,-21600,MacBook
com.google.Chrome,3,1734849226,1734849229,1734849230,-21600,MacBook
com.sunsama.native-app,3,1734849223,1734849226,1734849226,-21600,MacBook
com.google.Chrome,2,1734849221,1734849223,1734849224,-21600,MacBook
com.sunsama.native-app,18,1734849203,1734849221,1734849221,-21600,MacBook
com.sunsama.native-app,299,1734848758,1734849057,1734849057,-21600,MacBook
com.google.Chrome,818,1734847940,1734848758,1734848758,-21600,MacBook
com.sunsama.native-app,1,1734847939,1734847940,1734847941,-21600,MacBook
com.apple.clock,1,1734847938,1734847939,1734847940,-21600,MacBook
com.google.Chrome,11,1734847927,1734847938,1734847939,-21600,MacBook
com.tinyspeck.chatlyio,2,1734847931,1734847933,1734847934,-21600,iPhone
com.apple.Notes,5,1734847922,1734847927,1734847927,-21600,MacBook
com.apple.clock,1,1734847921,1734847922,1734847923,-21600,MacBook
com.google.Chrome,0,1734847921,1734847921,1734847922,-21600,MacBook
com.sunsama.native-app,2,1734847919,1734847921,1734847921,-21600,MacBook
com.google.Chrome,15,1734847904,1734847919,1734847919,-21600,MacBook
com.apple.finder,2,1734847902,1734847904,1734847905,-21600,MacBook
com.apple.podcasts,2,1734847900,1734847902,1734847903,-21600,MacBook
com.google.Chrome,81,1734847819,1734847900,1734847901,-21600,MacBook
com.apple.clock,55,1734847764,1734847819,1734847820,-21600,MacBook
com.google.Chrome,36,1734847728,1734847764,1734847765,-21600,MacBook
com.apple.clock,9,1734847719,1734847728,1734847728,-21600,MacBook
com.apple.Notes,2,1734847717,1734847719,1734847719,-21600,MacBook
com.apple.clock,3,1734847714,1734847717,1734847718,-21600,MacBook
com.google.Chrome,96,1734847618,1734847714,1734847714,-21600,MacBook
com.apple.clock,1,1734847617,1734847618,1734847619,-21600,MacBook
com.apple.Notes,13,1734847604,1734847617,1734847617,-21600,MacBook
com.apple.clock,1,1734847603,1734847604,1734847605,-21600,MacBook
com.google.Chrome,182,1734847421,1734847603,1734847604,-21600,MacBook
com.apple.clock,21,1734847400,1734847421,1734847422,-21600,MacBook
com.google.Chrome,58,1734847342,1734847400,1734847401,-21600,MacBook
com.apple.clock,34,1734847308,1734847342,1734847342,-21600,MacBook
com.google.Chrome,288,1734847020,1734847308,1734847308,-21600,MacBook
com.tinyspeck.chatlyio,170,1734847058,1734847228,1734847229,-21600,iPhone
com.netease.cloudmusic,1,1734847054,1734847055,1734847056,-21600,iPhone
com.xingin.discover,2,1734847050,1734847052,1734847052,-21600,iPhone
com.apple.clock,12,1734847008,1734847020,1734847020,-21600,MacBook
com.apple.Notes,1,1734847007,1734847008,1734847009,-21600,MacBook
com.apple.finder,1,1734847006,1734847007,1734847007,-21600,MacBook
com.apple.Notes,32,1734846974,1734847006,1734847007,-21600,MacBook
com.apple.finder,0,1734846974,1734846974,1734846975,-21600,MacBook
com.apple.Notes,29,1734846945,1734846974,1734846974,-21600,MacBook
com.apple.finder,2,1734846943,1734846945,1734846945,-21600,MacBook
com.apple.clock,1,1734846942,1734846943,1734846944,-21600,MacBook
com.google.Chrome,48,1734846894,1734846942,1734846943,-21600,MacBook
com.apple.clock,1,1734846893,1734846894,1734846894,-21600,MacBook
com.google.Chrome,9,1734846884,1734846893,1734846893,-21600,MacBook
com.apple.clock,75,1734846809,1734846884,1734846885,-21600,MacBook
com.google.Chrome,8,1734846801,1734846809,1734846809,-21600,MacBook
com.apple.clock,4,1734846797,1734846801,1734846801,-21600,MacBook
com.google.Chrome,7,1734846790,1734846797,1734846797,-21600,MacBook
com.apple.clock,191,1734846599,1734846790,1734846790,-21600,MacBook
com.google.Chrome,69,1734846530,1734846599,1734846600,-21600,MacBook
com.apple.finder,2,1734846528,1734846530,1734846531,-21600,MacBook
com.apple.Notes,21,1734846507,1734846528,1734846529,-21600,MacBook
com.apple.podcasts,38,1734846469,1734846507,1734846507,-21600,MacBook
com.google.Chrome,3,1734846466,1734846469,1734846469,-21600,MacBook
com.apple.finder,1,1734846465,1734846466,1734846467,-21600,MacBook
com.apple.Notes,2,1734846463,1734846465,1734846465,-21600,MacBook
com.google.Chrome,140,1734846323,1734846463,1734846463,-21600,MacBook
com.apple.podcasts,5,1734846318,1734846323,1734846323,-21600,MacBook
com.google.Chrome,10,1734846308,1734846318,1734846318,-21600,MacBook
com.apple.Notes,0,1734846308,1734846308,1734846308,-21600,MacBook
com.sunsama.native-app,1,1734846307,1734846308,1734846308,-21600,MacBook
com.google.Chrome,50,1734846257,1734846307,1734846307,-21600,MacBook
com.apple.podcasts,3,1734846254,1734846257,1734846258,-21600,MacBook
com.google.Chrome,1,1734846253,1734846254,1734846254,-21600,MacBook
com.apple.Notes,1,1734846252,1734846253,1734846254,-21600,MacBook
com.google.Chrome,34,1734846218,1734846252,1734846252,-21600,MacBook
com.apple.Notes,18,1734846200,1734846218,1734846219,-21600,MacBook
com.sunsama.native-app,1,1734846199,1734846200,1734846200,-21600,MacBook
com.google.Chrome,94,1734846105,1734846199,1734846199,-21600,MacBook
com.apple.Notes,25,1734846080,1734846105,1734846105,-21600,MacBook
com.google.Chrome,44,1734846036,1734846080,1734846081,-21600,MacBook
com.apple.Notes,35,1734846001,1734846036,1734846036,-21600,MacBook
com.sunsama.native-app,1,1734846000,1734846001,1734846002,-21600,MacBook
com.google.Chrome,292,1734845708,1734846000,1734846001,-21600,MacBook
com.google.Chrome,584,1734843890,1734844474,1734844474,-21600,MacBook
com.apple.podcasts,5,1734843885,1734843890,1734843890,-21600,MacBook
com.google.Chrome,38,1734843847,1734843885,1734843885,-21600,MacBook
com.apple.podcasts,2,1734843845,1734843847,1734843847,-21600,MacBook
com.google.Chrome,5,1734843840,1734843845,1734843846,-21600,MacBook
com.apple.podcasts,1,1734843839,1734843840,1734843840,-21600,MacBook
com.google.Chrome,5,1734843834,1734843839,1734843839,-21600,MacBook
com.apple.podcasts,2,1734843832,1734843834,1734843834,-21600,MacBook
com.google.Chrome,11,1734843821,1734843832,1734843833,-21600,MacBook
com.apple.podcasts,3,1734843818,1734843821,1734843821,-21600,MacBook
com.google.Chrome,4,1734843814,1734843818,1734843818,-21600,MacBook
com.apple.podcasts,2,1734843812,1734843814,1734843814,-21600,MacBook
com.google.Chrome,252,1734843560,1734843812,1734843812,-21600,MacBook
com.sunsama.native-app,6,1734843554,1734843560,1734843561,-21600,MacBook
com.apple.Notes,3,1734843551,1734843554,1734843555,-21600,MacBook
com.google.Chrome,2,1734843549,1734843551,1734843551,-21600,MacBook
com.sunsama.native-app,14,1734843535,1734843549,1734843550,-21600,MacBook
com.google.Chrome,204,1734843331,1734843535,1734843536,-21600,MacBook
com.apple.finder,1,1734843330,1734843331,1734843331,-21600,MacBook
com.google.Chrome,17,1734843313,1734843330,1734843330,-21600,MacBook
com.apple.finder,3,1734843310,1734843313,1734843313,-21600,MacBook
com.apple.Notes,21,1734843289,1734843310,1734843311,-21600,MacBook
com.google.Chrome,1,1734843288,1734843289,1734843290,-21600,MacBook
com.apple.podcasts,3,1734843285,1734843288,1734843288,-21600,MacBook
com.apple.Notes,18,1734843267,1734843285,1734843285,-21600,MacBook
com.google.Chrome,698,1734842569,1734843267,1734843267,-21600,MacBook
com.apple.podcasts,41,1734842528,1734842569,1734842570,-21600,MacBook
com.google.Chrome,132,1734842396,1734842528,1734842529,-21600,MacBook
com.apple.podcasts,7,1734842389,1734842396,1734842396,-21600,MacBook
com.google.Chrome,54,1734842335,1734842389,1734842389,-21600,MacBook
com.apple.podcasts,44,1734842291,1734842335,1734842336,-21600,MacBook
com.google.Chrome,2,1734842289,1734842291,1734842292,-21600,MacBook
com.apple.podcasts,3,1734842286,1734842289,1734842290,-21600,MacBook
com.google.Chrome,0,1734842286,1734842286,1734842287,-21600,MacBook
com.apple.podcasts,6,1734842280,1734842286,1734842286,-21600,MacBook
com.google.Chrome,3,1734842277,1734842280,1734842281,-21600,MacBook
com.apple.podcasts,13,1734842264,1734842277,1734842277,-21600,MacBook
com.apple.Notes,4,1734842260,1734842264,1734842264,-21600,MacBook
com.google.Chrome,346,1734841914,1734842260,1734842261,-21600,MacBook
com.sunsama.native-app,2,1734841912,1734841914,1734841914,-21600,MacBook
com.google.Chrome,10,1734841902,1734841912,1734841913,-21600,MacBook
com.sunsama.native-app,28,1734841874,1734841902,1734841903,-21600,MacBook
com.google.Chrome,7,1734841867,1734841874,1734841875,-21600,MacBook
com.sunsama.native-app,16,1734841851,1734841867,1734841867,-21600,MacBook
com.apple.finder,2,1734841849,1734841851,1734841852,-21600,MacBook
com.apple.Notes,4,1734841845,1734841849,1734841850,-21600,MacBook
com.sunsama.native-app,2,1734841843,1734841845,1734841846,-21600,MacBook
com.tencent.xinWeChat,0,1734841843,1734841843,1734841844,-21600,MacBook
com.sunsama.native-app,1,1734841842,1734841843,1734841844,-21600,MacBook
com.google.Chrome,1,1734841841,1734841842,1734841843,-21600,MacBook
com.sunsama.native-app,9,1734841832,1734841841,1734841841,-21600,MacBook
com.apple.Notes,7,1734841825,1734841832,1734841833,-21600,MacBook
com.google.Chrome,193,1734841632,1734841825,1734841825,-21600,MacBook
com.apple.Notes,20,1734841612,1734841632,1734841633,-21600,MacBook
com.google.Chrome,4,1734841608,1734841612,1734841613,-21600,MacBook
com.apple.Notes,18,1734841590,1734841608,1734841609,-21600,MacBook
com.google.Chrome,151,1734841439,1734841590,1734841590,-21600,MacBook
com.google.Chrome,1138,1734840295,1734841433,1734841434,-21600,MacBook
com.apple.BarcodeScanner,21,1734840330,1734840351,1734840352,-21600,iPhone
com.apple.AuthenticationServicesUI,7,1734840333,1734840340,1734840340,-21600,iPhone
com.tencent.xin,17,1734840309,1734840326,1734840326,-21600,iPhone
com.tinyspeck.chatlyio,1,1734840307,1734840308,1734840309,-21600,iPhone
com.google.Chrome,470,1734839590,1734840060,1734840060,-21600,MacBook
com.apple.Notes,13,1734839577,1734839590,1734839591,-21600,MacBook
com.apple.clock,0,1734839577,1734839577,1734839578,-21600,MacBook
com.apple.Notes,2,1734839575,1734839577,1734839577,-21600,MacBook
com.apple.finder,2,1734839573,1734839575,1734839575,-21600,MacBook
com.google.Chrome,120,1734839453,1734839573,1734839574,-21600,MacBook
com.apple.finder,1,1734839452,1734839453,1734839453,-21600,MacBook
com.apple.Notes,14,1734839438,1734839452,1734839452,-21600,MacBook
com.apple.finder,2,1734839436,1734839438,1734839438,-21600,MacBook
com.google.Chrome,75,1734839361,1734839436,1734839436,-21600,MacBook
com.apple.mobilesafari,10,1734839355,1734839365,1734839366,-21600,iPad
com.google.Chrome,371,1734838275,1734838646,1734838647,-21600,MacBook
com.google.Chrome,1236,1734836411,1734837647,1734837647,-21600,MacBook
com.tencent.xin,11,1734837492,1734837503,1734837504,-21600,iPhone
com.tencent.xin,72,1734837140,1734837212,1734837213,-21600,iPhone
com.tencent.xin,1,1734836403,1734836404,1734836405,-21600,iPhone
com.apple.camera,0,1734836404,1734836404,1734836405,-21600,iPhone
com.tencent.xin,10,1734836392,1734836402,1734836403,-21600,iPhone
com.xingin.discover,13,1734836332,1734836345,1734836345,-21600,iPhone
com.tencent.xin,1,1734836331,1734836332,1734836333,-21600,iPhone
com.xingin.discover,1,1734836330,1734836331,1734836331,-21600,iPhone
com.tencent.xin,30,1734836300,1734836330,1734836330,-21600,iPhone
com.xingin.discover,18,1734836282,1734836300,1734836300,-21600,iPhone
com.tencent.xin,6,1734836276,1734836282,1734836282,-21600,iPhone
com.xingin.discover,23,1734836253,1734836276,1734836277,-21600,iPhone
com.tencent.xin,12,1734836241,1734836253,1734836254,-21600,iPhone
com.xingin.discover,13,1734836228,1734836241,1734836241,-21600,iPhone
com.tencent.xin,18,1734836210,1734836228,1734836229,-21600,iPhone
com.google.Maps,14,1734836196,1734836210,1734836211,-21600,iPhone
com.tencent.xin,9,1734836187,1734836196,1734836197,-21600,iPhone
com.google.Maps,1,1734836186,1734836187,1734836188,-21600,iPhone
com.xingin.discover,12,1734836174,1734836186,1734836187,-21600,iPhone
com.google.Maps,2,1734836172,1734836174,1734836175,-21600,iPhone
com.tencent.xin,23,1734836149,1734836172,1734836172,-21600,iPhone
com.google.Maps,36,1734836113,1734836149,1734836150,-21600,iPhone
com.tencent.xin,443,1734835669,1734836112,1734836113,-21600,iPhone
com.xingin.discover,89,1734835580,1734835669,1734835670,-21600,iPhone
com.tencent.xin,17,1734835563,1734835580,1734835580,-21600,iPhone
com.google.Chrome,325,1734835250,1734835575,1734835575,-21600,MacBook
com.xingin.discover,15,1734835548,1734835563,1734835564,-21600,iPhone
com.tencent.xin,16,1734835532,1734835548,1734835548,-21600,iPhone
com.xingin.discover,256,1734835276,1734835532,1734835533,-21600,iPhone
com.apple.finder,5,1734835245,1734835250,1734835251,-21600,MacBook
com.google.Chrome,2,1734835243,1734835245,1734835246,-21600,MacBook
com.apple.finder,1,1734835242,1734835243,1734835244,-21600,MacBook
com.google.Chrome,8,1734835234,1734835242,1734835243,-21600,MacBook
com.apple.finder,1,1734835233,1734835234,1734835235,-21600,MacBook
com.google.Chrome,144,1734835089,1734835233,1734835233,-21600,MacBook
com.google.Chrome,300,1734834034,1734834334,1734834335,-21600,MacBook
com.xingin.discover,2,1734834154,1734834156,1734834157,-21600,iPhone
com.xingin.discover,51,1734834094,1734834145,1734834146,-21600,iPhone
com.xingin.discover,557,1734833492,1734834049,1734834050,-21600,iPhone
com.google.Chrome,300,1734833529,1734833829,1734833830,-21600,MacBook
com.tencent.xin,11,1734833479,1734833490,1734833490,-21600,iPhone
com.google.Chrome,460,1734832840,1734833300,1734833300,-21600,MacBook
com.tencent.xin,20,1734832966,1734832986,1734832987,-21600,iPhone
com.tencent.xin,13,1734832839,1734832852,1734832853,-21600,iPhone
com.google.Maps,24,1734832815,1734832839,1734832839,-21600,iPhone
com.tencent.xin,4,1734832811,1734832815,1734832815,-21600,iPhone
com.google.Maps,16,1734832795,1734832811,1734832812,-21600,iPhone
com.tencent.xin,15,1734832779,1734832794,1734832794,-21600,iPhone
com.tencent.xin,1,1734832777,1734832778,1734832779,-21600,iPhone
com.google.Chrome,505,1734832056,1734832561,1734832562,-21600,MacBook
com.tencent.xin,11,1734832309,1734832320,1734832321,-21600,iPhone
com.google.Maps,7,1734832302,1734832309,1734832310,-21600,iPhone
com.tencent.xin,28,1734832273,1734832301,1734832302,-21600,iPhone
com.apple.finder,251,1734831805,1734832056,1734832056,-21600,MacBook
com.google.Chrome,600,1734831205,1734831805,1734831805,-21600,MacBook
com.google.Chrome,304,1734830740,1734831044,1734831045,-21600,MacBook
com.google.Chrome,583,1734829565,1734830148,1734830148,-21600,MacBook
com.apple.finder,62,1734829503,1734829565,1734829565,-21600,MacBook
com.google.Chrome,19,1734829484,1734829503,1734829503,-21600,MacBook
com.apple.Notes,61,1734829423,1734829484,1734829485,-21600,MacBook
com.google.Chrome,5,1734829418,1734829423,1734829423,-21600,MacBook
com.apple.Notes,0,1734829418,1734829418,1734829418,-21600,MacBook
com.google.Chrome,11,1734829407,1734829418,1734829418,-21600,MacBook
com.apple.Notes,17,1734829390,1734829407,1734829408,-21600,MacBook
com.google.Chrome,343,1734829047,1734829390,1734829390,-21600,MacBook
com.apple.finder,37,1734829010,1734829047,1734829048,-21600,MacBook
com.apple.clock,10,1734829000,1734829010,1734829010,-21600,MacBook
com.apple.finder,13,1734828987,1734829000,1734829001,-21600,MacBook
com.apple.Notes,107,1734828880,1734828987,1734828988,-21600,MacBook
com.google.Chrome,79,1734828801,1734828880,1734828880,-21600,MacBook
com.apple.Notes,4,1734828797,1734828801,1734828802,-21600,MacBook
com.apple.finder,2,1734828795,1734828797,1734828798,-21600,MacBook
com.google.Chrome,104,1734828691,1734828795,1734828795,-21600,MacBook
com.google.Chrome,343,1734827872,1734828215,1734828216,-21600,MacBook
com.microsoft.Office.Outlook,9,1734827926,1734827935,1734827935,-21600,iPhone
com.microsoft.Office.Outlook,4,1734827920,1734827924,1734827925,-21600,iPhone
com.sunsama.native-app,92,1734827780,1734827872,1734827873,-21600,MacBook
com.apple.finder,1,1734827779,1734827780,1734827781,-21600,MacBook
com.google.Chrome,1,1734827778,1734827779,1734827780,-21600,MacBook
com.apple.finder,1,1734827777,1734827778,1734827779,-21600,MacBook
com.google.Chrome,46,1734827731,1734827777,1734827778,-21600,MacBook
com.apple.finder,1,1734827730,1734827731,1734827731,-21600,MacBook
com.apple.systempreferences,1,1734827729,1734827730,1734827730,-21600,MacBook
com.google.Chrome,12,1734827717,1734827729,1734827729,-21600,MacBook
com.apple.systempreferences,2,1734827715,1734827717,1734827718,-21600,MacBook
com.google.Chrome,44,1734827671,1734827715,1734827716,-21600,MacBook
com.apple.systempreferences,8,1734827663,1734827671,1734827672,-21600,MacBook
com.google.Chrome,7,1734827656,1734827663,1734827664,-21600,MacBook
com.apple.systempreferences,16,1734827640,1734827656,1734827657,-21600,MacBook
com.google.Chrome,1,1734827639,1734827640,1734827641,-21600,MacBook
com.apple.systempreferences,8,1734827631,1734827639,1734827639,-21600,MacBook
com.apple.finder,5,1734827626,1734827631,1734827631,-21600,MacBook
com.valvesoftware.steam,16,1734827610,1734827626,1734827627,-21600,MacBook
com.google.Chrome,56,1734827554,1734827610,1734827611,-21600,MacBook
com.valvesoftware.steam,54,1734827500,1734827554,1734827554,-21600,MacBook
com.microsoft.Office.Outlook,61,1734827456,1734827517,1734827517,-21600,iPhone
com.apple.systempreferences,2,1734827498,1734827500,1734827501,-21600,MacBook
com.valvesoftware.steam,3,1734827495,1734827498,1734827500,-21600,MacBook
com.apple.systempreferences,3,1734827492,1734827495,1734827496,-21600,MacBook
com.valvesoftware.steam,4,1734827488,1734827492,1734827493,-21600,MacBook
com.apple.systempreferences,27,1734827461,1734827488,1734827488,-21600,MacBook
com.valvesoftware.steam,10,1734827451,1734827461,1734827462,-21600,MacBook
com.xfinity.digitalhome,4,1734827452,1734827456,1734827456,-21600,iPhone
com.apple.systempreferences,3,1734827448,1734827451,1734827452,-21600,MacBook
com.valvesoftware.steam,22,1734827426,1734827448,1734827449,-21600,MacBook
com.apple.systempreferences,2,1734827424,1734827426,1734827427,-21600,MacBook
com.valvesoftware.steam,0,1734827424,1734827424,1734827425,-21600,MacBook
com.apple.systempreferences,1,1734827423,1734827424,1734827424,-21600,MacBook
com.valvesoftware.steam,0,1734827423,1734827423,1734827424,-21600,MacBook
com.apple.systempreferences,11,1734827412,1734827423,1734827424,-21600,MacBook
com.apple.finder,1,1734827411,1734827412,1734827412,-21600,MacBook
com.microsoft.Outlook,1,1734827410,1734827411,1734827412,-21600,MacBook
com.adobe.acc.AdobeCreativeCloud,2,1734827408,1734827410,1734827411,-21600,MacBook
com.microsoft.Outlook,22,1734827386,1734827408,1734827409,-21600,MacBook
com.apple.systempreferences,14,1734827372,1734827386,1734827387,-21600,MacBook
com.apple.finder,13,1734827346,1734827359,1734827359,-21600,MacBook
com.microsoft.VSCode,4,1734827342,1734827346,1734827346,-21600,MacBook
com.apple.finder,9,1734827333,1734827342,1734827343,-21600,MacBook
com.sunsama.native-app,19,1734827314,1734827333,1734827333,-21600,MacBook
com.apple.finder,5,1734827309,1734827314,1734827314,-21600,MacBook
com.apple.Preview,6,1734827303,1734827309,1734827309,-21600,MacBook
com.apple.finder,6,1734827297,1734827303,1734827303,-21600,MacBook
com.sunsama.native-app,2,1734827295,1734827297,1734827300,-21600,MacBook
com.apple.finder,2,1734827293,1734827295,1734827296,-21600,MacBook
com.sunsama.native-app,1,1734827292,1734827293,1734827294,-21600,MacBook
com.apple.finder,0,1734827292,1734827292,1734827293,-21600,MacBook
com.sunsama.native-app,1,1734827291,1734827292,1734827292,-21600,MacBook
com.apple.finder,19,1734827272,1734827291,1734827292,-21600,MacBook
com.apple.systempreferences,5,1734827267,1734827272,1734827273,-21600,MacBook
com.valvesoftware.steam,3,1734827264,1734827267,1734827267,-21600,MacBook
com.apple.systempreferences,3,1734827261,1734827264,1734827265,-21600,MacBook
com.valvesoftware.steam,1,1734827260,1734827261,1734827262,-21600,MacBook
com.apple.systempreferences,1,1734827259,1734827260,1734827261,-21600,MacBook
com.valvesoftware.steam,1,1734827258,1734827259,1734827260,-21600,MacBook
com.apple.systempreferences,1,1734827257,1734827258,1734827259,-21600,MacBook
com.valvesoftware.steam,2,1734827255,1734827257,1734827257,-21600,MacBook
com.apple.systempreferences,9,1734827246,1734827255,1734827256,-21600,MacBook
com.valvesoftware.steam,0,1734827246,1734827246,1734827248,-21600,MacBook
com.apple.systempreferences,1,1734827245,1734827246,1734827247,-21600,MacBook
com.valvesoftware.steam,0,1734827234,1734827234,1734827235,-21600,MacBook
com.apple.systempreferences,2,1734827232,1734827234,1734827234,-21600,MacBook
com.valvesoftware.steam,0,1734827232,1734827232,1734827233,-21600,MacBook
com.apple.systempreferences,10,1734827222,1734827232,1734827232,-21600,MacBook
com.valvesoftware.steam,2,1734827220,1734827222,1734827223,-21600,MacBook
com.apple.systempreferences,1,1734827219,1734827220,1734827221,-21600,MacBook
com.valvesoftware.steam,0,1734827219,1734827219,1734827220,-21600,MacBook
com.apple.systempreferences,50,1734827169,1734827219,1734827220,-21600,MacBook
com.apple.finder,0,1734827169,1734827169,1734827170,-21600,MacBook
com.apple.systempreferences,1,1734827168,1734827169,1734827169,-21600,MacBook
com.sunsama.native-app,1,1734827167,1734827168,1734827169,-21600,MacBook
com.xfinity.digitalhome,6,1734827154,1734827160,1734827161,-21600,iPhone
com.apple.systempreferences,1,1734827154,1734827155,1734827156,-21600,MacBook
com.apple.finder,3,1734827151,1734827154,1734827154,-21600,MacBook
com.google.Chrome,15,1734827136,1734827151,1734827151,-21600,MacBook
com.sunsama.native-app,13,1734827123,1734827136,1734827137,-21600,MacBook
com.xfinity.digitalhome,65,1734826989,1734827054,1734827055,-21600,iPhone
com.microsoft.Office.Outlook,13,1734826973,1734826986,1734826987,-21600,iPhone
com.sunsama.native-app,357,1734826176,1734826533,1734826533,-21600,MacBook
com.google.Chrome,28,1734826148,1734826176,1734826176,-21600,MacBook
com.sunsama.native-app,199,1734825949,1734826148,1734826148,-21600,MacBook
com.google.Chrome,2,1734825947,1734825949,1734825950,-21600,MacBook
com.sunsama.native-app,3,1734825944,1734825947,1734825948,-21600,MacBook
com.google.Chrome,112,1734825832,1734825944,1734825945,-21600,MacBook
com.sunsama.native-app,19,1734825813,1734825832,1734825832,-21600,MacBook
com.google.Chrome,4,1734825809,1734825813,1734825813,-21600,MacBook
com.sunsama.native-app,1,1734825808,1734825809,1734825809,-21600,MacBook
com.google.Chrome,11,1734825797,1734825808,1734825808,-21600,MacBook
com.sunsama.native-app,2,1734825795,1734825797,1734825797,-21600,MacBook
com.google.Chrome,1,1734825794,1734825795,1734825796,-21600,MacBook
com.sunsama.native-app,31,1734825763,1734825794,1734825794,-21600,MacBook
com.google.Chrome,12,1734825751,1734825763,1734825763,-21600,MacBook
com.sunsama.native-app,3,1734825748,1734825751,1734825752,-21600,MacBook
com.google.Chrome,68,1734825680,1734825748,1734825748,-21600,MacBook
com.microsoft.Office.Outlook,32,1734825656,1734825688,1734825689,-21600,iPhone
com.sunsama.native-app,313,1734825367,1734825680,1734825680,-21600,MacBook
com.xingin.discover,2,1734825653,1734825655,1734825655,-21600,iPhone
com.google.Chrome,4,1734825363,1734825367,1734825367,-21600,MacBook
com.sunsama.native-app,86,1734825277,1734825363,1734825363,-21600,MacBook
com.google.Chrome,4,1734825273,1734825277,1734825277,-21600,MacBook
com.sunsama.native-app,225,1734825048,1734825273,1734825274,-21600,MacBook
com.apple.Notes,21,1734825027,1734825048,1734825048,-21600,MacBook
com.apple.systempreferences,1,1734825026,1734825027,1734825027,-21600,MacBook
com.google.Chrome,49,1734824977,1734825026,1734825026,-21600,MacBook
com.apple.systempreferences,2,1734824975,1734824977,1734824978,-21600,MacBook
com.sunsama.native-app,1,1734824974,1734824975,1734824975,-21600,MacBook
com.google.Chrome,2,1734824972,1734824974,1734824975,-21600,MacBook
com.sunsama.native-app,3,1734824969,1734824972,1734824973,-21600,MacBook
com.google.Chrome,3,1734824966,1734824969,1734824969,-21600,MacBook
com.sunsama.native-app,1,1734824955,1734824956,1734824960,-21600,MacBook
com.google.Chrome,4,1734824951,1734824955,1734824959,-21600,MacBook
com.apple.systempreferences,0,1734824951,1734824951,1734824956,-21600,MacBook
com.sunsama.native-app,2,1734824946,1734824948,1734824949,-21600,MacBook
com.apple.finder,3,1734824943,1734824946,1734824946,-21600,MacBook
todesktop.com.ToDesktop-Installer,1,1734824942,1734824943,1734824943,-21600,MacBook
com.google.Chrome,1,1734824941,1734824942,1734824943,-21600,MacBook
todesktop.com.ToDesktop-Installer,1,1734824931,1734824932,1734824933,-21600,MacBook
com.google.Chrome,1,1734824930,1734824931,1734824931,-21600,MacBook
com.apple.finder,4,1734824925,1734824929,1734824929,-21600,MacBook
com.google.Chrome,29,1734824896,1734824925,1734824926,-21600,MacBook
com.apple.finder,1,1734824895,1734824896,1734824897,-21600,MacBook
com.google.Chrome,1,1734824894,1734824895,1734824895,-21600,MacBook
com.apple.archiveutility,1,1734824893,1734824894,1734824895,-21600,MacBook
com.apple.finder,5,1734824888,1734824893,1734824894,-21600,MacBook
com.google.Chrome,6,1734824882,1734824888,1734824889,-21600,MacBook
com.apple.finder,0,1734824882,1734824882,1734824882,-21600,MacBook
com.google.Chrome,682,1734824200,1734824882,1734824882,-21600,MacBook
com.apple.Notes,33,1734824167,1734824200,1734824201,-21600,MacBook
com.apple.finder,0,1734824167,1734824167,1734824168,-21600,MacBook
com.google.Chrome,102,1734824065,1734824167,1734824167,-21600,MacBook
com.apple.finder,1,1734823735,1734823736,1734823737,-21600,MacBook
com.microsoft.VSCode,2,1734823733,1734823735,1734823736,-21600,MacBook
com.apple.Terminal,4,1734823729,1734823733,1734823734,-21600,MacBook
com.apple.Notes,11,1734823718,1734823729,1734823729,-21600,MacBook
com.xingin.discover,46,1734823676,1734823722,1734823722,-21600,iPhone
com.google.Chrome,60,1734823658,1734823718,1734823718,-21600,MacBook
com.xingin.discover,27,1734823632,1734823659,1734823660,-21600,iPhone
com.microsoft.Office.Outlook,9,1734823622,1734823631,1734823632,-21600,iPhone
com.xingin.discover,3,1734823619,1734823622,1734823623,-21600,iPhone
com.google.Chrome,334,1734823210,1734823544,1734823545,-21600,MacBook
com.xingin.discover,51,1734823213,1734823264,1734823265,-21600,iPhone
com.xingin.discover,358,1734822850,1734823208,1734823209,-21600,iPhone
com.google.Chrome,352,1734822619,1734822971,1734822971,-21600,MacBook
com.tencent.xin,175,1734822674,1734822849,1734822850,-21600,iPhone
com.microsoft.Outlook,1,1734822618,1734822619,1734822619,-21600,MacBook
com.google.Chrome.app.pclfgflcpfaoljnfkkdaehijdkagjkgj,2,1734822616,1734822618,1734822618,-21600,MacBook
com.microsoft.Outlook,2,1734822614,1734822616,1734822617,-21600,MacBook
com.google.Chrome,449,1734822165,1734822614,1734822615,-21600,MacBook
com.microsoft.Outlook,35,1734822012,1734822047,1734822047,-21600,MacBook
com.google.Chrome,203,1734821809,1734822012,1734822013,-21600,MacBook
com.tencent.xin,23,1734821915,1734821938,1734821939,-21600,iPhone
com.discoverfinancial.mobile,19,1734821896,1734821915,1734821916,-21600,iPhone
com.apple.CoreAuthUI,3,1734821902,1734821905,1734821906,-21600,iPhone
com.tencent.xin,5,1734821891,1734821896,1734821897,-21600,iPhone
com.discoverfinancial.mobile,1,1734821890,1734821891,1734821892,-21600,iPhone
com.tencent.xin,33,1734821857,1734821890,1734821891,-21600,iPhone
com.xingin.discover,3,1734821854,1734821857,1734821858,-21600,iPhone
com.xingin.discover,927,1734820881,1734821808,1734821809,-21600,iPhone
com.google.Chrome,842,1734820323,1734821165,1734821165,-21600,MacBook
com.tencent.xin,2,1734820878,1734820880,1734820880,-21600,iPhone
com.xingin.discover,4,1734820870,1734820874,1734820875,-21600,iPhone
com.apple.Notes,27,1734820296,1734820323,1734820323,-21600,MacBook
com.google.Chrome,702,1734819594,1734820296,1734820297,-21600,MacBook
com.google.Chrome,346,1734819098,1734819444,1734819445,-21600,MacBook
com.xingin.discover,970,1734818131,1734819101,1734819102,-21600,iPhone
com.google.Chrome,575,1734817820,1734818395,1734818395,-21600,MacBook
com.ubercab.UberEats,18,1734818113,1734818131,1734818131,-21600,iPhone
com.apple.Preferences,5,1734818108,1734818113,1734818115,-21600,iPhone
com.ubercab.UberEats,6,1734818101,1734818107,1734818107,-21600,iPhone
tv.danmaku.bilianime,4,1734818095,1734818099,1734818100,-21600,iPhone
tv.danmaku.bilianime,6,1734818088,1734818094,1734818095,-21600,iPhone
com.microsoft.VSCode,14,1734817806,1734817820,1734817820,-21600,MacBook
com.apple.finder,1,1734817805,1734817806,1734817806,-21600,MacBook
com.microsoft.VSCode,0,1734817805,1734817805,1734817806,-21600,MacBook
com.apple.finder,1,1734817804,1734817805,1734817805,-21600,MacBook
com.google.Chrome,3,1734817775,1734817778,1734817779,-21600,MacBook
com.apple.Terminal,28,1734817747,1734817775,1734817776,-21600,MacBook
com.google.Chrome,3,1734817744,1734817747,1734817748,-21600,MacBook
com.apple.finder,4,1734817740,1734817744,1734817744,-21600,MacBook
com.google.Chrome,4,1734817736,1734817740,1734817740,-21600,MacBook
com.apple.finder,6,1734817730,1734817736,1734817737,-21600,MacBook
com.google.Chrome,32,1734817698,1734817730,1734817730,-21600,MacBook
com.apple.finder,0,1734817698,1734817698,1734817699,-21600,MacBook
com.apple.archiveutility,2,1734817696,1734817698,1734817698,-21600,MacBook
com.apple.finder,9,1734817687,1734817696,1734817696,-21600,MacBook
com.apple.archiveutility,3,1734817684,1734817687,1734817687,-21600,MacBook
com.apple.finder,4,1734817680,1734817684,1734817685,-21600,MacBook
com.google.Chrome,6,1734817674,1734817680,1734817681,-21600,MacBook
com.apple.archiveutility,1,1734817673,1734817674,1734817674,-21600,MacBook
com.apple.finder,27,1734817646,1734817673,1734817674,-21600,MacBook
com.google.Chrome,125,1734817521,1734817646,1734817646,-21600,MacBook
com.google.Chrome.app.pclfgflcpfaoljnfkkdaehijdkagjkgj,12,1734817500,1734817512,1734817513,-21600,MacBook
com.apple.finder,2,1734817498,1734817500,1734817501,-21600,MacBook
com.google.Chrome,652,1734816846,1734817498,1734817499,-21600,MacBook
com.microsoft.Outlook,6,1734816840,1734816846,1734816885,-21600,MacBook
com.apple.Notes,24,1734816816,1734816840,1734816881,-21600,MacBook
com.google.Chrome,6,1734816810,1734816816,1734816878,-21600,MacBook
com.apple.Notes,1,1734816809,1734816810,1734816874,-21600,MacBook
com.google.Chrome,47,1734816762,1734816809,1734816840,-21600,MacBook
com.apple.finder,1,1734816716,1734816717,1734816727,-21600,MacBook
com.google.Chrome,1,1734816715,1734816716,1734816725,-21600,MacBook
tv.danmaku.bilianime,1,1734816621,1734816622,1734816623,-21600,iPhone
tv.danmaku.bilianime,3,1734815119,1734815122,1734815122,-21600,iPhone
tv.danmaku.bilianime,977,1734814090,1734815067,1734815068,-21600,iPhone
com.bilibili.bilicomic,241,1734813849,1734814090,1734814091,-21600,iPhone
tv.danmaku.bilianime,2,1734813847,1734813849,1734813849,-21600,iPhone
com.apple.AppStore,40,1734813798,1734813838,1734813839,-21600,iPhone
com.openai.chat,6,1734813790,1734813796,1734813796,-21600,iPhone
com.ubercab.UberEats,2,1734813788,1734813790,1734813790,-21600,iPhone
com.discoverfinancial.mobile,1,1734813787,1734813788,1734813789,-21600,iPhone
com.apple.PassbookUIService,5,1734813780,1734813785,1734813786,-21600,iPhone
com.openai.chat,50,1734813727,1734813777,1734813778,-21600,iPhone
com.ubercab.UberEats,150,1734813577,1734813727,1734813728,-21600,iPhone
com.openai.chat,44,1734813533,1734813577,1734813578,-21600,iPhone
com.ubercab.UberEats,38,1734813495,1734813533,1734813533,-21600,iPhone
com.openai.chat,18,1734813477,1734813495,1734813496,-21600,iPhone
com.ubercab.UberEats,88,1734813389,1734813477,1734813478,-21600,iPhone
com.openai.chat,22,1734813367,1734813389,1734813389,-21600,iPhone
com.ubercab.UberEats,160,1734813206,1734813366,1734813367,-21600,iPhone
com.apple.calculator,11,1734813195,1734813206,1734813207,-21600,iPhone
com.ubercab.UberEats,163,1734813032,1734813195,1734813195,-21600,iPhone
com.google.chrome.ios,6,1734813016,1734813022,1734813023,-21600,iPhone
com.google.chrome.ios,3064,1734809857,1734812921,1734812921,-21600,iPhone
com.tencent.xin,193,1734809661,1734809854,1734809855,-21600,iPhone
com.tencent.xin,2,1734809297,1734809299,1734809300,-21600,iPhone
com.tencent.xin,25,1734808954,1734808979,1734808980,-21600,iPhone
com.microsoft.Office.Outlook,12,1734808941,1734808953,1734808954,-21600,iPhone
com.tencent.xin,1,1734808940,1734808941,1734808942,-21600,iPhone
com.microsoft.Office.Outlook,9,1734808930,1734808939,1734808939,-21600,iPhone
com.apple.MobileSMS,6,1734808923,1734808929,1734808930,-21600,iPhone
com.tencent.xin,2,1734808920,1734808922,1734808922,-21600,iPhone
com.microsoft.Office.Outlook,29,1734808890,1734808919,1734808920,-21600,iPhone
com.google.chrome.ios,3,1734808885,1734808888,1734808889,-21600,iPhone
com.google.chrome.ios,734,1734778116,1734778850,1734778851,-21600,iPhone
com.google.chrome.ios,1860,1734776255,1734778115,1734778116,-21600,iPhone
com.xingin.discover,1,1734776251,1734776252,1734776253,-21600,iPhone
com.amazon.Amazon,7,1734776243,1734776250,1734776251,-21600,iPhone
com.amazon.Amazon,7,1734775622,1734775629,1734775630,-21600,iPhone
com.amazon.Amazon,62,1734775058,1734775120,1734775121,-21600,iPhone
com.apple.camera,2,1734775050,1734775052,1734775053,-21600,iPhone
com.apple.finder,27,1734774731,1734774758,1734774759,-21600,MacBook
com.google.Chrome,11,1734774720,1734774731,1734774732,-21600,MacBook
com.apple.Dictionary,2,1734771939,1734771941,1734771942,-21600,MacBook
com.google.Chrome,4335,1734767604,1734771939,1734771940,-21600,MacBook
com.apple.finder,4,1734767600,1734767604,1734767604,-21600,MacBook
com.apple.Preview,6,1734767594,1734767600,1734767601,-21600,MacBook
com.apple.finder,3,1734767591,1734767594,1734767594,-21600,MacBook
com.google.Chrome,3,1734767588,1734767591,1734767592,-21600,MacBook
com.apple.finder,11,1734767577,1734767588,1734767588,-21600,MacBook
com.google.Chrome,794,1734766783,1734767577,1734767577,-21600,MacBook
com.apple.Notes,1,1734766782,1734766783,1734766783,-21600,MacBook
com.google.Chrome,161,1734766621,1734766782,1734766782,-21600,MacBook
com.apple.finder,1,1734766038,1734766039,1734766040,-21600,MacBook
com.google.Chrome,397,1734765641,1734766038,1734766038,-21600,MacBook
com.apple.Notes,7,1734765634,1734765641,1734765641,-21600,MacBook
com.google.Chrome,115,1734765519,1734765634,1734765634,-21600,MacBook
com.apple.Notes,11,1734765508,1734765519,1734765519,-21600,MacBook
com.google.Chrome,50,1734765458,1734765508,1734765509,-21600,MacBook
com.apple.Notes,14,1734765444,1734765458,1734765459,-21600,MacBook
com.google.Chrome,420,1734765024,1734765444,1734765445,-21600,MacBook
com.apple.Notes,1,1734765023,1734765024,1734765025,-21600,MacBook
com.google.Chrome,10,1734765013,1734765023,1734765023,-21600,MacBook
com.apple.Notes,3,1734765010,1734765013,1734765014,-21600,MacBook
com.google.Chrome,356,1734764654,1734765010,1734765010,-21600,MacBook
com.apple.mobilesafari,7,1734764650,1734764657,1734764658,-21600,iPad
com.apple.finder,2,1734764582,1734764584,1734764584,-21600,MacBook
com.apple.Notes,3,1734764579,1734764582,1734764583,-21600,MacBook
com.apple.finder,1,1734764578,1734764579,1734764580,-21600,MacBook
com.google.Chrome,243,1734764335,1734764578,1734764578,-21600,MacBook
com.apple.finder,1,1734764334,1734764335,1734764336,-21600,MacBook
com.apple.Notes,26,1734764308,1734764334,1734764335,-21600,MacBook
com.google.Chrome,12,1734764296,1734764308,1734764309,-21600,MacBook
com.apple.finder,1,1734764295,1734764296,1734764296,-21600,MacBook
com.apple.Notes,1,1734764294,1734764295,1734764295,-21600,MacBook
com.google.Chrome,2,1734764292,1734764294,1734764295,-21600,MacBook
com.apple.finder,1,1734764291,1734764292,1734764293,-21600,MacBook
com.apple.Notes,1,1734764290,1734764291,1734764292,-21600,MacBook
com.apple.finder,1,1734764289,1734764290,1734764291,-21600,MacBook
com.microsoft.Outlook,2,1734764287,1734764289,1734764289,-21600,MacBook
com.google.Chrome,10,1734764277,1734764287,1734764288,-21600,MacBook
com.microsoft.Outlook,11,1734764266,1734764277,1734764277,-21600,MacBook
com.apple.Notes,0,1734764266,1734764266,1734764267,-21600,MacBook
com.google.Chrome,44,1734764222,1734764266,1734764266,-21600,MacBook
com.apple.finder,1,1734764221,1734764222,1734764222,-21600,MacBook
com.apple.Notes,44,1734764177,1734764221,1734764221,-21600,MacBook
com.apple.finder,0,1734764177,1734764177,1734764178,-21600,MacBook
com.google.Chrome,49,1734764128,1734764177,1734764178,-21600,MacBook
com.apple.Notes,2,1734764126,1734764128,1734764129,-21600,MacBook
com.apple.finder,0,1734764126,1734764126,1734764127,-21600,MacBook
com.google.Chrome,4,1734764122,1734764126,1734764127,-21600,MacBook
com.apple.finder,1,1734764121,1734764122,1734764123,-21600,MacBook
com.tencent.xinWeChat,6,1734764115,1734764121,1734764121,-21600,MacBook
com.google.Chrome,189,1734763926,1734764115,1734764115,-21600,MacBook
com.apple.mobilesafari,1,1734763864,1734763865,1734763866,-21600,iPad
com.tencent.xin,10,1734761856,1734761866,1734761867,-21600,iPhone
com.chase,39,1734761817,1734761856,1734761856,-21600,iPhone
com.apple.CoreAuthUI,2,1734761817,1734761819,1734761820,-21600,iPhone
com.tencent.xin,12,1734761805,1734761817,1734761818,-21600,iPhone
com.chase,0,1734761805,1734761805,1734761806,-21600,iPhone
com.tencent.xin,9,1734761794,1734761803,1734761803,-21600,iPhone
com.xingin.discover,3,1734761790,1734761793,1734761793,-21600,iPhone
com.xingin.discover,2,1734761249,1734761251,1734761251,-21600,iPhone
com.xingin.discover,112,1734761098,1734761210,1734761211,-21600,iPhone
com.tencent.xin,8,1734761090,1734761098,1734761098,-21600,iPhone
com.google.Chrome,344,1734759604,1734759948,1734759949,-21600,MacBook
com.tencent.xin,27,1734759669,1734759696,1734759697,-21600,iPhone
com.tencent.xin,9,1734759660,1734759669,1734759669,-21600,iPhone
com.apple.camera,1,1734759665,1734759666,1734759666,-21600,iPhone
com.google.Chrome,506,1734758356,1734758862,1734758863,-21600,MacBook
com.tencent.xin,3,1734758489,1734758492,1734758493,-21600,iPhone
com.tencent.xin,16,1734758340,1734758356,1734758357,-21600,iPhone
com.tencent.xinWeChat,3,1734758353,1734758356,1734758356,-21600,MacBook
com.google.Chrome,197,1734758156,1734758353,1734758353,-21600,MacBook
com.tencent.xinWeChat,1,1734758155,1734758156,1734758157,-21600,MacBook
com.google.Chrome,41,1734758114,1734758155,1734758155,-21600,MacBook
com.tencent.xinWeChat,12,1734758102,1734758114,1734758115,-21600,MacBook
com.google.Chrome,1,1734758101,1734758102,1734758102,-21600,MacBook
com.tencent.xinWeChat,8,1734758093,1734758101,1734758101,-21600,MacBook
com.google.Chrome,57,1734758036,1734758093,1734758094,-21600,MacBook
com.tencent.xinWeChat,2,1734758034,1734758036,1734758036,-21600,MacBook
com.google.Chrome,68,1734757966,1734758034,1734758035,-21600,MacBook
com.tencent.xinWeChat,16,1734757950,1734757966,1734757967,-21600,MacBook
com.google.Chrome,3,1734757947,1734757950,1734757951,-21600,MacBook
com.tencent.xinWeChat,1,1734757946,1734757947,1734757948,-21600,MacBook
com.google.Chrome,52,1734757894,1734757946,1734757946,-21600,MacBook
com.tencent.xinWeChat,16,1734757878,1734757894,1734757895,-21600,MacBook
com.google.Chrome,3,1734757875,1734757878,1734757879,-21600,MacBook
com.tencent.xinWeChat,2,1734757873,1734757875,1734757876,-21600,MacBook
com.google.Chrome,6,1734757867,1734757873,1734757874,-21600,MacBook
com.tencent.xinWeChat,2,1734757865,1734757867,1734757867,-21600,MacBook
com.google.Chrome,7,1734757858,1734757865,1734757865,-21600,MacBook
com.tencent.xinWeChat,2,1734757856,1734757858,1734757859,-21600,MacBook
com.google.Chrome,4,1734757852,1734757856,1734757856,-21600,MacBook
com.tencent.xinWeChat,6,1734757846,1734757852,1734757853,-21600,MacBook
com.google.Chrome,2,1734757844,1734757846,1734757847,-21600,MacBook
com.tencent.xinWeChat,2,1734757842,1734757844,1734757845,-21600,MacBook
com.google.Chrome,3,1734757839,1734757842,1734757842,-21600,MacBook
com.tencent.xinWeChat,1,1734757838,1734757839,1734757839,-21600,MacBook
com.google.Chrome,33,1734757805,1734757838,1734757839,-21600,MacBook
com.tencent.xinWeChat,10,1734757795,1734757805,1734757805,-21600,MacBook
com.google.Chrome,23,1734757772,1734757795,1734757796,-21600,MacBook
com.tencent.xinWeChat,10,1734757762,1734757772,1734757772,-21600,MacBook
com.google.Chrome,32,1734757730,1734757762,1734757762,-21600,MacBook
com.tencent.xinWeChat,2,1734757728,1734757730,1734757730,-21600,MacBook
com.google.Chrome,4,1734757724,1734757728,1734757728,-21600,MacBook
com.tencent.xinWeChat,33,1734757691,1734757724,1734757725,-21600,MacBook
com.tencent.xin,38,1734757668,1734757706,1734757706,-21600,iPhone
com.google.Chrome,175,1734757516,1734757691,1734757692,-21600,MacBook
com.discoverfinancial.mobile,14,1734757654,1734757668,1734757670,-21600,iPhone
com.apple.CoreAuthUI,2,1734757658,1734757660,1734757661,-21600,iPhone
com.tencent.xin,1,1734757653,1734757654,1734757657,-21600,iPhone
com.discoverfinancial.mobile,2,1734757651,1734757653,1734757654,-21600,iPhone
com.microsoft.Office.Outlook,7,1734757643,1734757650,1734757650,-21600,iPhone
com.tencent.xin,19,1734757622,1734757641,1734757642,-21600,iPhone
com.tencent.xin,106,1734757516,1734757622,1734757625,-21600,iPhone
com.tencent.xinWeChat,0,1734757516,1734757516,1734757517,-21600,MacBook
com.google.Chrome,1,1734757515,1734757516,1734757516,-21600,MacBook
com.apple.Notes,2,1734757513,1734757515,1734757516,-21600,MacBook
com.google.Chrome,1143,1734756370,1734757513,1734757513,-21600,MacBook
com.tencent.xin,18,1734757450,1734757468,1734757469,-21600,iPhone
com.microsoft.Office.Outlook,17,1734757433,1734757450,1734757450,-21600,iPhone
com.tencent.xin,9,1734757424,1734757433,1734757434,-21600,iPhone
com.tencent.xin,11,1734756477,1734756488,1734756490,-21600,iPhone
com.xingin.discover,14,1734756463,1734756477,1734756477,-21600,iPhone
com.tencent.xin,9,1734756454,1734756463,1734756464,-21600,iPhone
com.xingin.discover,18,1734756436,1734756454,1734756455,-21600,iPhone
com.tencent.xin,30,1734756405,1734756435,1734756435,-21600,iPhone
com.apple.BarcodeScanner,16,1734756388,1734756404,1734756405,-21600,iPhone
com.apple.AuthenticationServicesUI,10,1734756391,1734756401,1734756402,-21600,iPhone
com.tencent.xin,4,1734756382,1734756386,1734756387,-21600,iPhone
com.xingin.discover,4,1734756378,1734756382,1734756383,-21600,iPhone
com.apple.finder,2,1734756368,1734756370,1734756371,-21600,MacBook
com.apple.iBooksX,5,1734756363,1734756368,1734756368,-21600,MacBook
com.apple.finder,4,1734756359,1734756363,1734756364,-21600,MacBook
com.google.Chrome,276,1734756083,1734756359,1734756359,-21600,MacBook
com.apple.Notes,2,1734756081,1734756083,1734756083,-21600,MacBook
com.google.Chrome,397,1734755684,1734756081,1734756082,-21600,MacBook
com.apple.finder,1,1734755683,1734755684,1734755685,-21600,MacBook
com.google.Chrome,1267,1734754416,1734755683,1734755684,-21600,MacBook
com.xingin.discover,1183,1734753231,1734754414,1734754415,-21600,iPhone
com.google.chrome.ios,10,1734753221,1734753231,1734753232,-21600,iPhone
com.xingin.discover,63,1734753158,1734753221,1734753221,-21600,iPhone
com.tencent.xin,22,1734753136,1734753158,1734753158,-21600,iPhone
com.xingin.discover,4,1734753132,1734753136,1734753137,-21600,iPhone
com.tencent.xin,5,1734753127,1734753132,1734753133,-21600,iPhone
com.xingin.discover,12,1734753115,1734753127,1734753127,-21600,iPhone
com.tencent.xin,38,1734753077,1734753115,1734753116,-21600,iPhone
com.xingin.discover,17,1734753060,1734753077,1734753078,-21600,iPhone
com.tencent.xin,11,1734753049,1734753060,1734753061,-21600,iPhone
com.xingin.discover,5,1734753044,1734753049,1734753049,-21600,iPhone
com.tencent.xin,35,1734753009,1734753044,1734753045,-21600,iPhone
com.xingin.discover,8,1734753001,1734753009,1734753009,-21600,iPhone
com.tencent.xin,38,1734752963,1734753001,1734753002,-21600,iPhone
com.google.Chrome,304,1734752695,1734752999,1734752999,-21600,MacBook
com.google.calendar,7,1734752956,1734752963,1734752963,-21600,iPhone
com.tencent.xin,7,1734752949,1734752956,1734752957,-21600,iPhone
com.xingin.discover,1,1734752948,1734752949,1734752949,-21600,iPhone
com.google.calendar,19,1734752929,1734752948,1734752949,-21600,iPhone
com.xingin.discover,8,1734752921,1734752929,1734752930,-21600,iPhone
com.tencent.xin,12,1734752909,1734752921,1734752922,-21600,iPhone
com.xingin.discover,1,1734752908,1734752909,1734752909,-21600,iPhone
com.tencent.xin,1,1734752907,1734752908,1734752908,-21600,iPhone
com.tencent.xin,63,1734752841,1734752904,1734752905,-21600,iPhone
com.google.calendar,4,1734752837,1734752841,1734752841,-21600,iPhone
com.tencent.xin,1,1734752835,1734752836,1734752837,-21600,iPhone
com.tencent.xin,118,1734752716,1734752834,1734752835,-21600,iPhone
com.apple.finder,16,1734752679,1734752695,1734752696,-21600,MacBook
com.google.Chrome,848,1734751831,1734752679,1734752680,-21600,MacBook
com.google.Chrome,457,1734751351,1734751808,1734751808,-21600,MacBook
com.apple.finder,0,1734751351,1734751351,1734751352,-21600,MacBook
com.microsoft.Outlook,14,1734751337,1734751351,1734751351,-21600,MacBook
com.google.Chrome,2,1734751335,1734751337,1734751338,-21600,MacBook
com.microsoft.Outlook,3,1734751332,1734751335,1734751336,-21600,MacBook
com.google.Chrome,3,1734751329,1734751332,1734751332,-21600,MacBook
com.microsoft.Outlook,14,1734751315,1734751329,1734751329,-21600,MacBook
com.google.Chrome,80,1734751235,1734751315,1734751316,-21600,MacBook
com.microsoft.Outlook,1,1734751234,1734751235,1734751236,-21600,MacBook
com.google.Chrome,1,1734751233,1734751234,1734751235,-21600,MacBook
com.apple.finder,16,1734751217,1734751233,1734751234,-21600,MacBook
com.google.Chrome,2,1734751215,1734751217,1734751218,-21600,MacBook
com.apple.finder,7,1734751208,1734751215,1734751215,-21600,MacBook
com.google.Chrome,4,1734751204,1734751208,1734751209,-21600,MacBook
com.apple.finder,1,1734751203,1734751204,1734751205,-21600,MacBook
com.google.Chrome,471,1734750732,1734751203,1734751204,-21600,MacBook
com.apple.finder,3,1734750729,1734750732,1734750733,-21600,MacBook
com.google.Chrome,7,1734750722,1734750729,1734750729,-21600,MacBook
com.apple.Notes,4,1734750718,1734750722,1734750722,-21600,MacBook
com.google.Chrome,7,1734750711,1734750718,1734750718,-21600,MacBook
com.apple.Notes,2,1734750709,1734750711,1734750712,-21600,MacBook
com.google.Chrome,54,1734750655,1734750709,1734750709,-21600,MacBook
com.apple.Notes,5,1734750650,1734750655,1734750656,-21600,MacBook
com.google.Chrome,70,1734750580,1734750650,1734750651,-21600,MacBook
com.apple.Notes,4,1734750576,1734750580,1734750580,-21600,MacBook
com.google.Chrome,70,1734750506,1734750576,1734750577,-21600,MacBook
com.apple.Notes,3,1734750503,1734750506,1734750507,-21600,MacBook
com.google.Chrome,35,1734750468,1734750503,1734750503,-21600,MacBook
com.apple.Notes,11,1734750457,1734750468,1734750468,-21600,MacBook
com.google.Chrome,20,1734750437,1734750457,1734750458,-21600,MacBook
com.apple.Notes,3,1734750434,1734750437,1734750438,-21600,MacBook
com.google.Chrome,152,1734750282,1734750434,1734750434,-21600,MacBook
com.apple.Notes,6,1734750276,1734750282,1734750282,-21600,MacBook
com.google.Chrome,108,1734750168,1734750276,1734750276,-21600,MacBook
com.apple.Notes,5,1734750163,1734750168,1734750168,-21600,MacBook
com.google.Chrome,51,1734750112,1734750163,1734750164,-21600,MacBook
com.apple.Notes,4,1734750108,1734750112,1734750112,-21600,MacBook
com.google.Chrome,112,1734749996,1734750108,1734750109,-21600,MacBook
com.tencent.xin,2,1734749684,1734749686,1734749686,-21600,iPhone
com.xingin.discover,760,1734748924,1734749684,1734749684,-21600,iPhone
com.google.Chrome,325,1734748746,1734749071,1734749071,-21600,MacBook
com.xingin.discover,2,1734748922,1734748924,1734748924,-21600,iPhone
com.tencent.xin,5,1734748916,1734748921,1734748921,-21600,iPhone
com.apple.Preferences,2,1734748914,1734748916,1734748916,-21600,iPhone
com.apple.MobileSMS,6,1734748908,1734748914,1734748915,-21600,iPhone
com.apple.Preferences,8,1734748900,1734748908,1734748908,-21600,iPhone
com.microsoft.Office.Outlook,8,1734748892,1734748900,1734748900,-21600,iPhone
com.tencent.xin,1,1734748891,1734748892,1734748893,-21600,iPhone
com.apple.MobileSMS,18,1734748873,1734748891,1734748892,-21600,iPhone
com.microsoft.Office.Outlook,12,1734748859,1734748871,1734748871,-21600,iPhone
com.tencent.xin,44,1734748815,1734748859,1734748859,-21600,iPhone
com.tencent.xin,23,1734748779,1734748802,1734748803,-21600,iPhone
com.microsoft.Office.Outlook,7,1734748772,1734748779,1734748780,-21600,iPhone
com.apple.Notes,4,1734748742,1734748746,1734748747,-21600,MacBook
com.google.Chrome,137,1734748605,1734748742,1734748742,-21600,MacBook
com.apple.Notes,9,1734748596,1734748605,1734748606,-21600,MacBook
com.google.Chrome,98,1734748498,1734748596,1734748597,-21600,MacBook
com.apple.Notes,12,1734748486,1734748498,1734748499,-21600,MacBook
com.google.Chrome,63,1734748423,1734748486,1734748486,-21600,MacBook
com.apple.Notes,8,1734748415,1734748423,1734748423,-21600,MacBook
com.google.Chrome,2,1734748413,1734748415,1734748415,-21600,MacBook
com.apple.Notes,6,1734748407,1734748413,1734748413,-21600,MacBook
com.google.Chrome,316,1734748091,1734748407,1734748407,-21600,MacBook
com.google.Chrome,1279,1734746623,1734747902,1734747903,-21600,MacBook
com.microsoft.Office.Outlook,13,1734746867,1734746880,1734746881,-21600,iPhone
com.apple.MobileSMS,3,1734746864,1734746867,1734746867,-21600,iPhone
net.whatsapp.WhatsApp,6,1734746857,1734746863,1734746863,-21600,iPhone
com.google.Chrome,357,1734746195,1734746552,1734746553,-21600,MacBook
com.google.Chrome,396,1734745690,1734746086,1734746086,-21600,MacBook
com.google.Chrome,302,1734745043,1734745345,1734745345,-21600,MacBook
com.google.Chrome,1270,1734743234,1734744504,1734744505,-21600,MacBook
com.tencent.xin,5,1734743244,1734743249,1734743250,-21600,iPhone
com.apple.finder,2,1734743232,1734743234,1734743235,-21600,MacBook
com.google.Chrome,11,1734743221,1734743232,1734743233,-21600,MacBook
com.apple.finder,6,1734743215,1734743221,1734743222,-21600,MacBook
com.apple.Safari,2,1734743213,1734743215,1734743216,-21600,MacBook
com.google.Chrome,1008,1734742205,1734743213,1734743213,-21600,MacBook
com.tencent.xin,204,1734742819,1734743023,1734743024,-21600,iPhone
com.tencent.xin,178,1734742418,1734742596,1734742597,-21600,iPhone
tv.danmaku.bilianime,6,1734742412,1734742418,1734742419,-21600,iPhone
com.apple.Notes,2,1734742203,1734742205,1734742205,-21600,MacBook
com.google.Chrome,10,1734742193,1734742203,1734742203,-21600,MacBook
com.apple.Notes,11,1734742182,1734742193,1734742193,-21600,MacBook
com.apple.Safari,0,1734742182,1734742182,1734742183,-21600,MacBook
com.google.Chrome,372,1734741810,1734742182,1734742182,-21600,MacBook
com.apple.Safari,0,1734741810,1734741810,1734741811,-21600,MacBook
com.apple.Notes,6,1734741804,1734741810,1734741810,-21600,MacBook
com.google.Chrome,380,1734741424,1734741804,1734741805,-21600,MacBook
com.adobe.acc.AdobeCreativeCloud,2,1734740814,1734740816,1734740816,-21600,MacBook
com.google.Chrome,18,1734740796,1734740814,1734740815,-21600,MacBook
com.google.Chrome,395,1734740246,1734740641,1734740642,-21600,MacBook
com.apple.Notes,17,1734739729,1734739746,1734739747,-21600,MacBook
com.google.Chrome,2,1734739727,1734739729,1734739730,-21600,MacBook
com.apple.Notes,9,1734739718,1734739727,1734739728,-21600,MacBook
com.google.Chrome,6,1734739712,1734739718,1734739719,-21600,MacBook
com.apple.Notes,1,1734739711,1734739712,1734739713,-21600,MacBook
com.tencent.xinWeChat,2,1734739709,1734739711,1734739711,-21600,MacBook
com.google.Chrome,100,1734739609,1734739709,1734739710,-21600,MacBook
com.apple.Notes,8,1734739601,1734739609,1734739659,-21600,MacBook
com.google.Chrome,4,1734739597,1734739601,1734739658,-21600,MacBook
com.apple.Notes,2,1734739595,1734739597,1734739655,-21600,MacBook
com.google.Chrome,3,1734739592,1734739595,1734739653,-21600,MacBook
com.apple.Notes,36,1734739556,1734739592,1734739650,-21600,MacBook
com.google.Chrome,70,1734739486,1734739556,1734739647,-21600,MacBook
com.apple.finder,2,1734739475,1734739477,1734739644,-21600,MacBook
com.google.Chrome,2,1734739473,1734739475,1734739615,-21600,MacBook
com.apple.mobilesafari,24,1734739313,1734739337,1734739338,-21600,iPad
com.apple.mobilesafari,6,1734739305,1734739311,1734739311,-21600,iPad
tv.danmaku.bilianime,447,1734738690,1734739137,1734739138,-21600,iPhone
tv.danmaku.bilianime,2,1734738322,1734738324,1734738326,-21600,iPhone
tv.danmaku.bilianime,2700,1734735501,1734738201,1734738203,-21600,iPhone
com.apple.Preferences,9,1734735851,1734735860,1734735861,-21600,iPhone
com.ubercab.UberEats,300,1734735198,1734735498,1734735498,-21600,iPhone
com.google.chrome.ios,3,1734735192,1734735195,1734735196,-21600,iPhone
com.apple.mobilesafari,8,1734735099,1734735107,1734735108,-21600,iPad
com.google.chrome.ios,18,1734735071,1734735089,1734735090,-21600,iPhone
com.apple.mobilesafari,3316,1734731750,1734735066,1734735066,-21600,iPad
com.google.chrome.ios,10,1734733914,1734733924,1734733924,-21600,iPhone
com.google.chrome.ios,10,1734732420,1734732430,1734732430,-21600,iPhone
com.apple.mobilesafari,604,1734731079,1734731683,1734731684,-21600,iPad
com.google.chrome.ios,10,1734731260,1734731270,1734731271,-21600,iPhone
com.google.chrome.ios,172,1734730907,1734731079,1734731081,-21600,iPad
com.apple.mobilesafari,6,1734730901,1734730907,1734730908,-21600,iPad
com.google.chrome.ios,1020,1734729881,1734730901,1734730903,-21600,iPad
com.google.chrome.ios,10,1734730271,1734730281,1734730281,-21600,iPhone
com.apple.mobilesafari,58,1734729823,1734729881,1734729883,-21600,iPad
com.apple.Preferences,10,1734729813,1734729823,1734729826,-21600,iPad
com.apple.mobilesafari,144,1734729669,1734729813,1734729814,-21600,iPad
com.google.chrome.ios,10,1734729774,1734729784,1734729785,-21600,iPhone
com.google.chrome.ios,18,1734729651,1734729669,1734729672,-21600,iPad
com.apple.mobilesafari,1806,1734727845,1734729651,1734729652,-21600,iPad
com.google.chrome.ios,10,1734729574,1734729584,1734729584,-21600,iPhone
com.google.chrome.ios,10,1734729548,1734729558,1734729558,-21600,iPhone
com.google.chrome.ios,63,1734727808,1734727871,1734727872,-21600,iPhone
com.apple.CoreAuthUI,2,1734727836,1734727838,1734727838,-21600,iPhone
com.apple.mobilesafari,163,1734727667,1734727830,1734727831,-21600,iPad
com.apple.CoreAuthUI,5,1734727822,1734727827,1734727827,-21600,iPhone
com.atebits.Tweetie2,167,1734727492,1734727659,1734727659,-21600,iPad
com.apple.mobilesafari,205,1734727286,1734727491,1734727492,-21600,iPad
com.google.chrome.ios,24,1734727261,1734727285,1734727288,-21600,iPad
com.openai.chat,13,1734727248,1734727261,1734727261,-21600,iPad
com.apple.Preferences,0,1734727247,1734727247,1734727250,-21600,iPad
com.atebits.Tweetie2,17,1734727230,1734727247,1734727249,-21600,iPad
com.openai.chat,0,1734727230,1734727230,1734727249,-21600,iPad
com.apple.Preferences,71,1734727159,1734727230,1734727230,-21600,iPad
com.openai.chat,28,1734727131,1734727159,1734727160,-21600,iPad
com.atebits.Tweetie2,90,1734727041,1734727131,1734727133,-21600,iPad
com.openai.chat,26,1734727015,1734727041,1734727042,-21600,iPad
com.atebits.Tweetie2,14,1734727001,1734727015,1734727015,-21600,iPad
com.openai.chat,25,1734726976,1734727001,1734727002,-21600,iPad
com.atebits.Tweetie2,10,1734726965,1734726975,1734726975,-21600,iPad
com.atebits.Tweetie2,19,1734726945,1734726964,1734726965,-21600,iPad
com.atebits.Tweetie2,107,1734726837,1734726944,1734726944,-21600,iPad
com.apple.Preferences,0,1734726832,1734726832,1734726834,-21600,iPad
com.apple.mobilesafari,229,1734726603,1734726832,1734726834,-21600,iPad
tv.danmaku.bilianime,382,1734726209,1734726591,1734726591,-21600,iPhone
com.microsoft.Office.Outlook,22,1734726181,1734726203,1734726204,-21600,iPhone
com.apple.mobilesafari,4,1734726176,1734726180,1734726181,-21600,iPhone
com.apple.mobilesafari,965,1734724890,1734725855,1734725857,-21600,iPhone
com.google.chrome.ios,295,1734724593,1734724888,1734724889,-21600,iPhone
com.google.chrome.ios,528,1734723919,1734724447,1734724447,-21600,iPhone
com.google.chrome.ios,490,1734723278,1734723768,1734723769,-21600,iPhone
com.apple.mobilenotes,8,1734723270,1734723278,1734723279,-21600,iPhone
com.tencent.xin,38,1734723231,1734723269,1734723270,-21600,iPhone
com.google.chrome.ios,30,1734723201,1734723231,1734723231,-21600,iPhone
com.tencent.xin,1,1734723200,1734723201,1734723202,-21600,iPhone
com.google.chrome.ios,1382,1734721818,1734723200,1734723200,-21600,iPhone
com.tencent.xin,123,1734721695,1734721818,1734721819,-21600,iPhone
com.google.chrome.ios,5,1734721690,1734721695,1734721695,-21600,iPhone
com.google.chrome.ios,3,1734720754,1734720757,1734720758,-21600,iPhone
com.microsoft.Office.Outlook,12,1734720739,1734720751,1734720752,-21600,iPhone
com.amazon.Amazon,128,1734720611,1734720739,1734720740,-21600,iPhone
com.tencent.xin,19,1734720592,1734720611,1734720613,-21600,iPhone
com.amazon.Amazon,17,1734720575,1734720592,1734720592,-21600,iPhone
com.tencent.xin,9,1734720566,1734720575,1734720576,-21600,iPhone
com.amazon.Amazon,212,1734720354,1734720566,1734720567,-21600,iPhone
com.tencent.xin,17,1734720337,1734720354,1734720355,-21600,iPhone
com.amazon.Amazon,67,1734720270,1734720337,1734720338,-21600,iPhone
com.tencent.xin,25,1734720245,1734720270,1734720271,-21600,iPhone
com.amazon.Amazon,6,1734720239,1734720245,1734720248,-21600,iPhone
com.tencent.xin,54,1734720183,1734720237,1734720237,-21600,iPhone
com.google.chrome.ios,8,1734720175,1734720183,1734720183,-21600,iPhone
com.tencent.xin,31,1734720138,1734720169,1734720169,-21600,iPhone
com.microsoft.Office.Outlook,9,1734720129,1734720138,1734720138,-21600,iPhone
com.tencent.xin,1,1734720128,1734720129,1734720130,-21600,iPhone
com.amazon.Amazon,6,1734720122,1734720128,1734720128,-21600,iPhone
com.tencent.xin,811,1734718796,1734719607,1734719608,-21600,iPhone
com.microsoft.Office.Outlook,22,1734718774,1734718796,1734718797,-21600,iPhone
com.tencent.xin,1,1734718773,1734718774,1734718774,-21600,iPhone
com.microsoft.Office.Outlook,8,1734718763,1734718771,1734718772,-21600,iPhone
com.apple.mobilenotes,11,1734718752,1734718763,1734718764,-21600,iPhone
com.apple.mobilenotes,1,1734686866,1734686867,1734686868,-21600,iPhone
com.apple.mobilenotes,6,1734686858,1734686864,1734686864,-21600,iPhone
com.apple.mobilenotes,756,1734685850,1734686606,1734686607,-21600,iPhone
com.apple.mobilenotes,48,1734685802,1734685850,1734685850,-21600,iPhone
com.apple.mobilenotes,3,1734685797,1734685800,1734685800,-21600,iPhone
com.apple.mobilenotes,19,1734685778,1734685797,1734685797,-21600,iPhone
com.tencent.xin,255,1734685521,1734685776,1734685776,-21600,iPhone
com.apple.Preferences,8,1734685513,1734685521,1734685522,-21600,iPhone
com.tencent.xin,24,1734685487,1734685511,1734685512,-21600,iPhone
com.apple.mobilenotes,4,1734685483,1734685487,1734685488,-21600,iPhone
com.apple.mobilenotes,6,1734684648,1734684654,1734684654,-21600,iPhone
com.apple.mobilenotes,266,1734684343,1734684609,1734684610,-21600,iPhone
com.google.chrome.ios,11,1734684332,1734684343,1734684344,-21600,iPhone
com.apple.mobilenotes,1,1734684331,1734684332,1734684333,-21600,iPhone
com.tencent.xin,94,1734684236,1734684330,1734684331,-21600,iPhone
com.apple.mobilenotes,3,1734684233,1734684236,1734684237,-21600,iPhone
com.apple.mobilenotes,6,1734683886,1734683892,1734683893,-21600,iPhone
com.tencent.xin,4,1734683882,1734683886,1734683886,-21600,iPhone
com.apple.mobilenotes,15,1734683867,1734683882,1734683883,-21600,iPhone
com.openai.chat,6,1734683861,1734683867,1734683867,-21600,iPhone
com.tencent.xin,5,1734683856,1734683861,1734683861,-21600,iPhone
com.openai.chat,18,1734683838,1734683856,1734683856,-21600,iPhone
com.xingin.discover,108,1734683729,1734683837,1734683837,-21600,iPhone
com.openai.chat,13,1734683716,1734683729,1734683730,-21600,iPhone
com.tencent.xin,21,1734683695,1734683716,1734683716,-21600,iPhone
com.openai.chat,58,1734683637,1734683695,1734683695,-21600,iPhone
com.tencent.xin,11,1734683626,1734683637,1734683638,-21600,iPhone
com.tencent.xin,6,1734683619,1734683625,1734683626,-21600,iPhone
com.openai.chat,58,1734683561,1734683619,1734683620,-21600,iPhone
com.xingin.discover,15,1734683546,1734683561,1734683562,-21600,iPhone
com.tencent.xin,22,1734683524,1734683546,1734683547,-21600,iPhone
com.xingin.discover,1,1734683520,1734683521,1734683521,-21600,iPhone
com.openai.chat,36,1734683483,1734683519,1734683520,-21600,iPhone
com.xingin.discover,3,1734683480,1734683483,1734683483,-21600,iPhone
com.apple.mobilenotes,18,1734683462,1734683480,1734683481,-21600,iPhone
com.openai.chat,6,1734683455,1734683461,1734683462,-21600,iPhone
com.xingin.discover,631,1734682824,1734683455,1734683455,-21600,iPhone
com.openai.chat,11,1734682813,1734682824,1734682824,-21600,iPhone
com.google.chrome.ios,44,1734682769,1734682813,1734682813,-21600,iPhone
com.openai.chat,29,1734682740,1734682769,1734682770,-21600,iPhone
com.google.chrome.ios,20,1734682720,1734682740,1734682741,-21600,iPhone
com.apple.mobilenotes,115,1734682603,1734682718,1734682719,-21600,iPhone
com.apple.mobilenotes,175,1734681295,1734681470,1734681471,-21600,iPhone
com.openai.chat,445,1734680850,1734681295,1734681295,-21600,iPhone
com.apple.mobilenotes,22,1734680828,1734680850,1734680851,-21600,iPhone
com.google.chrome.ios,1,1734680827,1734680828,1734680828,-21600,iPhone
com.openai.chat,74,1734680753,1734680827,1734680827,-21600,iPhone
com.google.chrome.ios,4,1734680749,1734680753,1734680753,-21600,iPhone
com.openai.chat,8,1734680741,1734680749,1734680749,-21600,iPhone
com.google.chrome.ios,9,1734680732,1734680741,1734680741,-21600,iPhone
com.openai.chat,1,1734680731,1734680732,1734680732,-21600,iPhone
com.google.chrome.ios,1,1734680730,1734680731,1734680731,-21600,iPhone
com.openai.chat,68,1734680662,1734680730,1734680730,-21600,iPhone
com.google.chrome.ios,6,1734680656,1734680662,1734680663,-21600,iPhone
com.openai.chat,11,1734680645,1734680656,1734680656,-21600,iPhone
com.google.chrome.ios,9,1734680636,1734680645,1734680646,-21600,iPhone
com.openai.chat,462,1734680174,1734680636,1734680636,-21600,iPhone
com.apple.mobilenotes,9,1734680164,1734680173,1734680174,-21600,iPhone
com.apple.mobilenotes,142,1734680021,1734680163,1734680163,-21600,iPhone
com.apple.mobilenotes,189,1734679830,1734680019,1734680019,-21600,iPhone
com.google.chrome.ios,16,1734679808,1734679824,1734679825,-21600,iPhone
com.apple.mobilesafari,2570,1734676901,1734679471,1734679472,-21600,iPad
com.google.chrome.ios,152,1734676748,1734676900,1734676901,-21600,iPad
com.google.chrome.ios,22,1734676726,1734676748,1734676750,-21600,iPad
com.google.chrome.ios,6,1734676720,1734676726,1734676727,-21600,iPhone
com.google.chrome.ios,34,1734676685,1734676719,1734676720,-21600,iPhone
com.xingin.discover,152,1734676532,1734676684,1734676685,-21600,iPhone
com.xingin.discover,10,1734676402,1734676412,1734676412,-21600,iPhone
com.apple.camera,1,1734676404,1734676405,1734676406,-21600,iPhone
com.xingin.discover,137,1734676140,1734676277,1734676278,-21600,iPhone
com.xingin.discover,2448,1734673541,1734675989,1734675989,-21600,iPhone
com.tencent.xinWeChat,306,1734674771,1734675077,1734675077,-21600,MacBook
com.apple.finder,0,1734674771,1734674771,1734674772,-21600,MacBook
com.google.Chrome,4,1734674767,1734674771,1734674771,-21600,MacBook
com.google.Chrome,336,1734673519,1734673855,1734673855,-21600,MacBook
com.xingin.discover,3351,1734670188,1734673539,1734673540,-21600,iPhone
com.google.Chrome,310,1734672706,1734673016,1734673017,-21600,MacBook
com.google.Chrome,726,1734671345,1734672071,1734672071,-21600,MacBook
com.google.Chrome,647,1734670572,1734671219,1734671219,-21600,MacBook
com.google.Chrome,1773,1734668710,1734670483,1734670484,-21600,MacBook
com.tencent.xin,3,1734670184,1734670187,1734670188,-21600,iPhone
com.tencent.xin,74,1734669586,1734669660,1734669661,-21600,iPhone
com.tencent.xin,8,1734669577,1734669585,1734669586,-21600,iPhone
com.apple.finder,1,1734668709,1734668710,1734668711,-21600,MacBook
com.tencent.xinWeChat,3,1734668706,1734668709,1734668710,-21600,MacBook
com.apple.Notes,3,1734668703,1734668706,1734668707,-21600,MacBook
com.tencent.xinWeChat,15,1734668688,1734668703,1734668704,-21600,MacBook
com.apple.Notes,13,1734668675,1734668688,1734668689,-21600,MacBook
com.tencent.xinWeChat,8,1734668667,1734668675,1734668676,-21600,MacBook
com.apple.Notes,12,1734668655,1734668667,1734668668,-21600,MacBook
com.tencent.xin,5,1734668660,1734668665,1734668666,-21600,iPhone
com.google.Chrome,3,1734668652,1734668655,1734668655,-21600,MacBook
com.apple.Notes,2,1734668650,1734668652,1734668652,-21600,MacBook
com.apple.finder,0,1734668650,1734668650,1734668651,-21600,MacBook
com.google.Chrome,2215,1734666435,1734668650,1734668650,-21600,MacBook
com.tencent.xin,1,1734665310,1734665311,1734665312,-21600,iPhone
com.tencent.xin,239,1734665053,1734665292,1734665293,-21600,iPhone
com.apple.finder,7,1734664486,1734664493,1734664494,-21600,MacBook
com.google.Chrome,118,1734664368,1734664486,1734664486,-21600,MacBook
com.apple.finder,8,1734664360,1734664368,1734664368,-21600,MacBook
com.tencent.xin,6,1734664345,1734664351,1734664352,-21600,iPhone
com.tencent.xin,54,1734664274,1734664328,1734664329,-21600,iPhone
com.google.chrome.ios,5,1734664267,1734664272,1734664273,-21600,iPhone
com.google.chrome.ios,10,1734663180,1734663190,1734663190,-21600,iPhone
com.google.chrome.ios,1069,1734661507,1734662576,1734662577,-21600,iPhone
com.amazon.Amazon,7,1734661500,1734661507,1734661508,-21600,iPhone
com.google.chrome.ios,3,1734661497,1734661500,1734661501,-21600,iPhone
com.google.chrome.ios,1478,1734659746,1734661224,1734661224,-21600,iPhone
com.apple.CoreAuthUI,3,1734659778,1734659781,1734659781,-21600,iPhone
com.tencent.xin,10,1734659736,1734659746,1734659746,-21600,iPhone
com.xingin.discover,1405,1734658331,1734659736,1734659737,-21600,iPhone
com.tencent.xin,27,1734658304,1734658331,1734658332,-21600,iPhone
com.apple.MobileSMS,19,1734658284,1734658303,1734658304,-21600,iPhone
com.xingin.discover,1455,1734656829,1734658284,1734658285,-21600,iPhone
com.xingin.discover,1029,1734655734,1734656763,1734656764,-21600,iPhone
com.tencent.xin,12,1734655722,1734655734,1734655734,-21600,iPhone
com.tencent.xin,79,1734655642,1734655721,1734655721,-21600,iPhone
com.xingin.discover,1299,1734654343,1734655642,1734655643,-21600,iPhone
com.google.chrome.ios,3,1734654340,1734654343,1734654344,-21600,iPhone
com.tencent.xin,3,1734654337,1734654340,1734654340,-21600,iPhone
com.tencent.xin,42,1734654294,1734654336,1734654337,-21600,iPhone
com.tencent.xin,734,1734653559,1734654293,1734654294,-21600,iPhone
com.apple.mobilenotes,2,1734653557,1734653559,1734653559,-21600,iPhone
com.tencent.xin,205,1734653351,1734653556,1734653557,-21600,iPhone
com.google.chrome.ios,9,1734653342,1734653351,1734653352,-21600,iPhone
com.tencent.xin,3,1734653339,1734653342,1734653343,-21600,iPhone
com.google.chrome.ios,922,1734652417,1734653339,1734653340,-21600,iPhone
com.apple.CoreAuthUI,2,1734652508,1734652510,1734652511,-21600,iPhone
com.apple.mobilesafari,8,1734652409,1734652417,1734652418,-21600,iPhone
com.google.chrome.ios,101,1734652307,1734652408,1734652409,-21600,iPhone
com.microsoft.Office.Outlook,17,1734652290,1734652307,1734652307,-21600,iPhone
com.google.chrome.ios,23,1734652267,1734652290,1734652291,-21600,iPhone
com.microsoft.Office.Outlook,11,1734652256,1734652267,1734652267,-21600,iPhone
com.google.chrome.ios,221,1734652034,1734652255,1734652256,-21600,iPhone
com.apple.mobilenotes,44,1734651990,1734652034,1734652034,-21600,iPhone
com.google.chrome.ios,16,1734651974,1734651990,1734651991,-21600,iPhone
com.apple.mobilenotes,16,1734651958,1734651974,1734651975,-21600,iPhone
com.google.chrome.ios,7,1734651951,1734651958,1734651959,-21600,iPhone
com.apple.mobilenotes,92,1734651859,1734651951,1734651952,-21600,iPhone
com.google.chrome.ios,3,1734651856,1734651859,1734651860,-21600,iPhone
com.tencent.xin,13,1734651841,1734651854,1734651855,-21600,iPhone
com.microsoft.Office.Outlook,3,1734651838,1734651841,1734651842,-21600,iPhone
com.tencent.xin,1,1734651836,1734651837,1734651838,-21600,iPhone
com.xingin.discover,9,1734651826,1734651835,1734651836,-21600,iPhone
com.apple.mobilenotes,24,1734651802,1734651826,1734651827,-21600,iPhone
com.google.chrome.ios,25,1734651777,1734651802,1734651803,-21600,iPhone
com.netease.cloudmusic,4,1734651773,1734651777,1734651777,-21600,iPhone
com.netease.cloudmusic,64,1734651670,1734651734,1734651735,-21600,iPhone
com.google.chrome.ios,11,1734651658,1734651669,1734651670,-21600,iPhone
com.apple.mobilenotes,14,1734651644,1734651658,1734651658,-21600,iPhone
com.xingin.discover,46,1734651598,1734651644,1734651645,-21600,iPhone
com.google.chrome.ios,7,1734651590,1734651597,1734651598,-21600,iPhone
com.microsoft.Office.Outlook,1,1734651588,1734651589,1734651590,-21600,iPhone
com.apple.mobilenotes,39,1734651548,1734651587,1734651588,-21600,iPhone
com.google.chrome.ios,10,1734651537,1734651547,1734651548,-21600,iPhone
com.microsoft.Office.Outlook,6,1734651529,1734651535,1734651535,-21600,iPhone
com.xingin.discover,4090,1734647438,1734651528,1734651529,-21600,iPhone
com.google.chrome.ios,18,1734647419,1734647437,1734647438,-21600,iPhone
com.bilibili.bilicomic,207,1734647211,1734647418,1734647419,-21600,iPhone
com.bilibili.bilicomic,2,1734647208,1734647210,1734647211,-21600,iPhone
com.microsoft.Office.Outlook,12,1734647194,1734647206,1734647206,-21600,iPhone
com.microsoft.Office.Outlook,20,1734647174,1734647194,1734647194,-21600,iPhone
com.apple.finder,136,1734647047,1734647183,1734647184,-21600,MacBook
com.google.chrome.ios,5,1734647163,1734647168,1734647169,-21600,iPhone
com.google.Chrome,4868,1734642179,1734647047,1734647047,-21600,MacBook
com.google.chrome.ios,10,1734646447,1734646457,1734646458,-21600,iPhone
com.google.chrome.ios,10,1734644248,1734644258,1734644258,-21600,iPhone
com.apple.finder,2,1734642177,1734642179,1734642179,-21600,MacBook
com.apple.Preview,100,1734642077,1734642177,1734642178,-21600,MacBook
com.tencent.xinWeChat,9,1734642068,1734642077,1734642078,-21600,MacBook
com.apple.finder,3,1734642065,1734642068,1734642068,-21600,MacBook
com.google.Chrome,3,1734642062,1734642065,1734642065,-21600,MacBook
com.apple.finder,2,1734642060,1734642062,1734642062,-21600,MacBook
com.google.chrome.ios,12,1734641930,1734641942,1734641943,-21600,iPhone
com.microsoft.Office.Outlook,15,1734641915,1734641930,1734641931,-21600,iPhone
com.apple.MobileSMS,8,1734641907,1734641915,1734641916,-21600,iPhone
com.netease.cloudmusic,11,1734641894,1734641905,1734641906,-21600,iPhone
com.netease.cloudmusic,12,1734641167,1734641179,1734641182,-21600,iPhone
tv.danmaku.bilianime,2,1734641162,1734641164,1734641164,-21600,iPhone
tv.danmaku.bilianime,753,1734640387,1734641140,1734641142,-21600,iPhone
tv.danmaku.bilianime,82,1734640109,1734640191,1734640192,-21600,iPhone
tv.danmaku.bilianime,1185,1734638915,1734640100,1734640101,-21600,iPhone
tv.danmaku.bilianime,4556,1734634271,1734638827,1734638828,-21600,iPhone
com.apple.mobilenotes,3,1734634269,1734634272,1734634272,-21600,iPhone
tv.danmaku.bilianime,8,1734634261,1734634269,1734634269,-21600,iPhone
com.apple.mobilenotes,11,1734634250,1734634261,1734634261,-21600,iPhone
tv.danmaku.bilianime,10,1734634240,1734634250,1734634251,-21600,iPhone
com.apple.mobilenotes,9,1734634231,1734634240,1734634241,-21600,iPhone
com.google.chrome.ios,24,1734634207,1734634231,1734634232,-21600,iPhone
com.apple.mobilenotes,15,1734634191,1734634206,1734634206,-21600,iPhone
tv.danmaku.bilianime,11,1734634180,1734634191,1734634191,-21600,iPhone
com.apple.mobilenotes,44,1734634136,1734634180,1734634181,-21600,iPhone
tv.danmaku.bilianime,10,1734634126,1734634136,1734634136,-21600,iPhone
com.apple.mobilenotes,24,1734634102,1734634126,1734634127,-21600,iPhone
tv.danmaku.bilianime,105,1734633997,1734634102,1734634103,-21600,iPhone
com.apple.mobilenotes,23,1734633974,1734633997,1734633998,-21600,iPhone
tv.danmaku.bilianime,1590,1734632383,1734633973,1734633974,-21600,iPhone
com.taobao.taobao4iphone,318,1734632064,1734632382,1734632384,-21600,iPhone
tv.danmaku.bilianime,7,1734632057,1734632064,1734632064,-21600,iPhone
com.taobao.taobao4iphone,140,1734631917,1734632057,1734632058,-21600,iPhone
tv.danmaku.bilianime,3,1734631914,1734631917,1734631917,-21600,iPhone
com.taobao.taobao4iphone,6,1734631908,1734631914,1734631915,-21600,iPhone
tv.danmaku.bilianime,3,1734631905,1734631908,1734631909,-21600,iPhone
com.taobao.taobao4iphone,9,1734631896,1734631905,1734631906,-21600,iPhone
tv.danmaku.bilianime,4,1734631892,1734631896,1734631897,-21600,iPhone
com.taobao.taobao4iphone,78,1734631814,1734631892,1734631893,-21600,iPhone
tv.danmaku.bilianime,8,1734631806,1734631814,1734631815,-21600,iPhone
com.taobao.taobao4iphone,34,1734631772,1734631806,1734631806,-21600,iPhone
tv.danmaku.bilianime,1,1734631771,1734631772,1734631773,-21600,iPhone
com.taobao.taobao4iphone,4,1734631767,1734631771,1734631772,-21600,iPhone
tv.danmaku.bilianime,5,1734631762,1734631767,1734631767,-21600,iPhone
com.taobao.taobao4iphone,4,1734631758,1734631762,1734631762,-21600,iPhone
tv.danmaku.bilianime,4,1734631754,1734631758,1734631759,-21600,iPhone
com.taobao.taobao4iphone,8,1734631746,1734631754,1734631754,-21600,iPhone
tv.danmaku.bilianime,7,1734631739,1734631746,1734631747,-21600,iPhone
com.taobao.taobao4iphone,56,1734631683,1734631739,1734631739,-21600,iPhone
tv.danmaku.bilianime,3,1734631680,1734631683,1734631683,-21600,iPhone
com.taobao.taobao4iphone,13,1734631667,1734631680,1734631680,-21600,iPhone
tv.danmaku.bilianime,2,1734631665,1734631667,1734631668,-21600,iPhone
com.taobao.taobao4iphone,18,1734631647,1734631665,1734631666,-21600,iPhone
tv.danmaku.bilianime,13,1734631634,1734631647,1734631647,-21600,iPhone
com.taobao.taobao4iphone,26,1734631607,1734631633,1734631634,-21600,iPhone
com.tencent.xin,29,1734631578,1734631607,1734631607,-21600,iPhone
com.apple.MobileSMS,4,1734631574,1734631578,1734631579,-21600,iPhone
com.tencent.xin,1,1734631571,1734631572,1734631573,-21600,iPhone
com.taobao.taobao4iphone,2,1734631568,1734631570,1734631570,-21600,iPhone
tv.danmaku.bilianime,10,1734631558,1734631568,1734631569,-21600,iPhone
com.microsoft.Office.Outlook,8,1734631550,1734631558,1734631559,-21600,iPhone
tv.danmaku.bilianime,2,1734631548,1734631550,1734631550,-21600,iPhone
com.google.chrome.ios,2,1734631544,1734631546,1734631547,-21600,iPhone
com.tencent.xin,76,1734631468,1734631544,1734631545,-21600,iPhone
com.google.chrome.ios,15,1734631453,1734631468,1734631469,-21600,iPhone
com.microsoft.Office.Outlook,71,1734631382,1734631453,1734631454,-21600,iPhone
com.tencent.xin,1,1734631381,1734631382,1734631382,-21600,iPhone
com.apple.mobiletimer,2,1734631376,1734631378,1734631379,-21600,iPhone
com.google.chrome.ios,2,1734631372,1734631374,1734631374,-21600,iPhone
tv.danmaku.bilianime,503,1734630869,1734631372,1734631372,-21600,iPhone
com.tencent.xin,123,1734630746,1734630869,1734630869,-21600,iPhone
com.tencent.xin,2,1734630743,1734630745,1734630746,-21600,iPhone
com.apple.Preferences,11,1734630732,1734630743,1734630744,-21600,iPhone
com.tencent.xin,98,1734630632,1734630730,1734630731,-21600,iPhone
tv.danmaku.bilianime,28,1734630604,1734630632,1734630633,-21600,iPhone
tv.danmaku.bilianime,28,1734625104,1734625132,1734625133,-21600,iPhone
tv.danmaku.bilianime,1,1734625102,1734625103,1734625103,-21600,iPhone
tv.danmaku.bilianime,512,1734603267,1734603779,1734603780,-21600,iPhone
com.google.chrome.ios,10,1734603401,1734603411,1734603411,-21600,iPhone
com.apple.mobilenotes,48,1734603353,1734603401,1734603402,-21600,iPhone
com.google.chrome.ios,18,1734603335,1734603353,1734603354,-21600,iPhone
com.apple.mobilenotes,2,1734603333,1734603335,1734603336,-21600,iPhone
com.google.chrome.ios,38,1734603295,1734603333,1734603334,-21600,iPhone
com.apple.mobilenotes,28,1734603265,1734603293,1734603293,-21600,iPhone
tv.danmaku.bilianime,23,1734603242,1734603265,1734603266,-21600,iPhone
com.apple.mobilenotes,14,1734603240,1734603254,1734603254,-21600,iPhone
tv.danmaku.bilianime,1655,1734601585,1734603240,1734603241,-21600,iPhone
com.apple.mobilenotes,68,1734603160,1734603228,1734603229,-21600,iPhone
tv.danmaku.bilianime,2773,1734598540,1734601313,1734601314,-21600,iPhone
com.taobao.taobao4iphone,72,1734598468,1734598540,1734598541,-21600,iPhone
tv.danmaku.bilianime,5,1734598463,1734598468,1734598469,-21600,iPhone
com.bilibili.bilicomic,1,1734598462,1734598463,1734598464,-21600,iPhone
com.tencent.xin,533,1734597923,1734598456,1734598457,-21600,iPhone
com.chase,3,1734597920,1734597923,1734597924,-21600,iPhone
com.apple.finder,3,1734597337,1734597340,1734597341,-21600,MacBook
com.google.Chrome,4,1734597333,1734597337,1734597337,-21600,MacBook
com.tencent.xinWeChat,27,1734597306,1734597333,1734597334,-21600,MacBook
com.apple.finder,1,1734597305,1734597306,1734597306,-21600,MacBook
com.google.Chrome,36,1734597269,1734597305,1734597305,-21600,MacBook
com.tencent.xinWeChat,4,1734597265,1734597269,1734597270,-21600,MacBook
com.apple.finder,2,1734597263,1734597265,1734597266,-21600,MacBook
com.tencent.xinWeChat,35,1734597228,1734597263,1734597263,-21600,MacBook
com.tencent.xinWeChat,405,1734596683,1734597088,1734597088,-21600,MacBook
com.google.Chrome,3,1734596680,1734596683,1734596684,-21600,MacBook
com.tencent.xinWeChat,23,1734596657,1734596680,1734596681,-21600,MacBook
com.google.Chrome,4,1734596653,1734596657,1734596658,-21600,MacBook
com.tencent.xinWeChat,263,1734596390,1734596653,1734596653,-21600,MacBook
com.apple.finder,0,1734596390,1734596390,1734596390,-21600,MacBook
com.tencent.xinWeChat,1,1734596389,1734596390,1734596390,-21600,MacBook
com.apple.finder,0,1734596389,1734596389,1734596390,-21600,MacBook
com.tencent.xinWeChat,1,1734596388,1734596389,1734596389,-21600,MacBook
com.apple.finder,1,1734596387,1734596388,1734596388,-21600,MacBook
com.tencent.xinWeChat,20,1734596367,1734596387,1734596388,-21600,MacBook
com.apple.finder,0,1734596367,1734596367,1734596368,-21600,MacBook
com.tencent.xinWeChat,2,1734596365,1734596367,1734596367,-21600,MacBook
com.apple.finder,1,1734596364,1734596365,1734596365,-21600,MacBook
com.tencent.xinWeChat,1,1734596363,1734596364,1734596365,-21600,MacBook
com.apple.finder,0,1734596363,1734596363,1734596364,-21600,MacBook
com.tencent.xinWeChat,2,1734596361,1734596363,1734596364,-21600,MacBook
com.apple.finder,1,1734596360,1734596361,1734596361,-21600,MacBook
com.tencent.xinWeChat,1,1734596359,1734596360,1734596361,-21600,MacBook
com.apple.finder,0,1734596359,1734596359,1734596360,-21600,MacBook
com.tencent.xinWeChat,10,1734596349,1734596359,1734596359,-21600,MacBook
com.apple.finder,0,1734596349,1734596349,1734596350,-21600,MacBook
com.tencent.xinWeChat,2,1734596347,1734596349,1734596350,-21600,MacBook
com.apple.finder,0,1734596347,1734596347,1734596348,-21600,MacBook
com.tencent.xinWeChat,12,1734596335,1734596347,1734596348,-21600,MacBook
com.apple.finder,0,1734596335,1734596335,1734596336,-21600,MacBook
com.tencent.xinWeChat,17,1734596318,1734596335,1734596335,-21600,MacBook
com.apple.finder,1,1734596300,1734596301,1734596301,-21600,MacBook
com.tencent.xinWeChat,3,1734596297,1734596300,1734596301,-21600,MacBook
com.apple.finder,1,1734596296,1734596297,1734596297,-21600,MacBook
com.tencent.xinWeChat,2,1734596294,1734596296,1734596297,-21600,MacBook
com.apple.finder,0,1734596294,1734596294,1734596295,-21600,MacBook
com.tencent.xinWeChat,1,1734596293,1734596294,1734596294,-21600,MacBook
com.apple.finder,0,1734596293,1734596293,1734596294,-21600,MacBook
com.tencent.xinWeChat,2,1734596291,1734596293,1734596294,-21600,MacBook
com.apple.finder,0,1734596291,1734596291,1734596292,-21600,MacBook
com.tencent.xinWeChat,15,1734596276,1734596291,1734596291,-21600,MacBook
com.apple.finder,1,1734596275,1734596276,1734596276,-21600,MacBook
com.tencent.xinWeChat,1,1734596274,1734596275,1734596276,-21600,MacBook
com.apple.finder,1,1734596273,1734596274,1734596274,-21600,MacBook
com.tencent.xinWeChat,1,1734596272,1734596273,1734596274,-21600,MacBook
com.apple.finder,0,1734596272,1734596272,1734596273,-21600,MacBook
com.tencent.xinWeChat,1,1734596271,1734596272,1734596273,-21600,MacBook
com.apple.finder,0,1734596271,1734596271,1734596272,-21600,MacBook
com.tencent.xinWeChat,1,1734596270,1734596271,1734596271,-21600,MacBook
com.apple.finder,0,1734596270,1734596270,1734596271,-21600,MacBook
com.tencent.xinWeChat,1,1734596269,1734596270,1734596270,-21600,MacBook
com.apple.finder,0,1734596269,1734596269,1734596270,-21600,MacBook
com.tencent.xinWeChat,1,1734596268,1734596269,1734596269,-21600,MacBook
com.apple.finder,0,1734596268,1734596268,1734596269,-21600,MacBook
com.tencent.xinWeChat,0,1734596268,1734596268,1734596269,-21600,MacBook
com.apple.finder,1,1734596267,1734596268,1734596268,-21600,MacBook
com.tencent.xinWeChat,1,1734596266,1734596267,1734596268,-21600,MacBook
com.apple.finder,0,1734596266,1734596266,1734596267,-21600,MacBook
com.tencent.xinWeChat,2,1734596264,1734596266,1734596266,-21600,MacBook
com.apple.finder,1,1734596263,1734596264,1734596264,-21600,MacBook
com.tencent.xinWeChat,64,1734596199,1734596263,1734596264,-21600,MacBook
com.apple.finder,0,1734596199,1734596199,1734596200,-21600,MacBook
com.tencent.xinWeChat,4,1734596195,1734596199,1734596200,-21600,MacBook
com.apple.finder,0,1734596195,1734596195,1734596196,-21600,MacBook
com.tencent.xinWeChat,21,1734596174,1734596195,1734596196,-21600,MacBook
com.apple.finder,1,1734596173,1734596174,1734596174,-21600,MacBook
com.tencent.xinWeChat,23,1734596150,1734596173,1734596174,-21600,MacBook
com.apple.finder,1,1734596149,1734596150,1734596150,-21600,MacBook
com.tencent.xinWeChat,4,1734596145,1734596149,1734596150,-21600,MacBook
com.apple.finder,0,1734596145,1734596145,1734596146,-21600,MacBook
com.tencent.xinWeChat,4,1734596141,1734596145,1734596146,-21600,MacBook
com.apple.finder,0,1734596141,1734596141,1734596141,-21600,MacBook
com.tencent.xinWeChat,4,1734596137,1734596141,1734596141,-21600,MacBook
com.apple.finder,1,1734596136,1734596137,1734596137,-21600,MacBook
com.tencent.xinWeChat,6,1734596130,1734596136,1734596137,-21600,MacBook
com.apple.finder,1,1734596129,1734596130,1734596130,-21600,MacBook
com.tencent.xinWeChat,1,1734596128,1734596129,1734596130,-21600,MacBook
com.apple.finder,1,1734596127,1734596128,1734596128,-21600,MacBook
com.tencent.xinWeChat,2,1734596125,1734596127,1734596128,-21600,MacBook
com.apple.finder,0,1734596125,1734596125,1734596126,-21600,MacBook
com.tencent.xinWeChat,1,1734596124,1734596125,1734596126,-21600,MacBook
com.apple.finder,1,1734596123,1734596124,1734596125,-21600,MacBook
com.tencent.xinWeChat,28,1734596095,1734596123,1734596124,-21600,MacBook
com.apple.finder,0,1734596095,1734596095,1734596096,-21600,MacBook
com.tencent.xinWeChat,5,1734596090,1734596095,1734596095,-21600,MacBook
com.apple.finder,0,1734596090,1734596090,1734596091,-21600,MacBook
com.tencent.xinWeChat,9,1734596081,1734596090,1734596091,-21600,MacBook
com.apple.finder,0,1734596081,1734596081,1734596082,-21600,MacBook
com.tencent.xinWeChat,29,1734596052,1734596081,1734596082,-21600,MacBook
com.apple.finder,1,1734596051,1734596052,1734596052,-21600,MacBook
com.tencent.xinWeChat,2,1734596049,1734596051,1734596052,-21600,MacBook
com.apple.finder,1,1734596048,1734596049,1734596049,-21600,MacBook
com.tencent.xinWeChat,52,1734595996,1734596048,1734596049,-21600,MacBook
com.apple.finder,0,1734595996,1734595996,1734595997,-21600,MacBook
com.tencent.xinWeChat,15,1734595981,1734595996,1734595997,-21600,MacBook
com.apple.finder,0,1734595981,1734595981,1734595982,-21600,MacBook
com.tencent.xinWeChat,9,1734595972,1734595981,1734595981,-21600,MacBook
com.apple.finder,0,1734595972,1734595972,1734595973,-21600,MacBook
com.tencent.xinWeChat,2,1734595970,1734595972,1734595973,-21600,MacBook
com.apple.finder,1,1734595969,1734595970,1734595970,-21600,MacBook
com.tencent.xinWeChat,10,1734595959,1734595969,1734595970,-21600,MacBook
com.apple.finder,0,1734595959,1734595959,1734595960,-21600,MacBook
com.tencent.xinWeChat,2,1734595957,1734595959,1734595959,-21600,MacBook
com.google.Chrome,4,1734595953,1734595957,1734595958,-21600,MacBook
com.tencent.xinWeChat,19,1734595934,1734595953,1734595953,-21600,MacBook
com.google.Chrome,7,1734595927,1734595934,1734595935,-21600,MacBook
com.tencent.xinWeChat,2,1734595925,1734595927,1734595928,-21600,MacBook
com.apple.finder,0,1734595925,1734595925,1734595926,-21600,MacBook
com.tencent.xinWeChat,26,1734595899,1734595925,1734595925,-21600,MacBook
com.google.Chrome,10,1734595889,1734595899,1734595900,-21600,MacBook
com.tencent.xinWeChat,1,1734595888,1734595889,1734595889,-21600,MacBook
com.apple.finder,0,1734595888,1734595888,1734595888,-21600,MacBook
com.tencent.xinWeChat,14,1734595874,1734595888,1734595888,-21600,MacBook
com.apple.finder,0,1734595874,1734595874,1734595875,-21600,MacBook
com.tencent.xinWeChat,3,1734595871,1734595874,1734595874,-21600,MacBook
com.apple.finder,0,1734595871,1734595871,1734595872,-21600,MacBook
com.tencent.xinWeChat,3,1734595868,1734595871,1734595872,-21600,MacBook
com.apple.finder,1,1734595867,1734595868,1734595868,-21600,MacBook
com.tencent.xinWeChat,45,1734595822,1734595867,1734595868,-21600,MacBook
com.apple.finder,1,1734595821,1734595822,1734595822,-21600,MacBook
com.tencent.xinWeChat,3,1734595818,1734595821,1734595822,-21600,MacBook
com.apple.finder,1,1734595817,1734595818,1734595818,-21600,MacBook
com.tencent.xinWeChat,13,1734595804,1734595817,1734595817,-21600,MacBook
com.google.Chrome,4,1734595800,1734595804,1734595805,-21600,MacBook
com.tencent.xinWeChat,1,1734595799,1734595800,1734595801,-21600,MacBook
com.apple.finder,0,1734595799,1734595799,1734595800,-21600,MacBook
com.tencent.xinWeChat,1,1734595798,1734595799,1734595799,-21600,MacBook
com.google.Chrome,34,1734595764,1734595798,1734595799,-21600,MacBook
com.tencent.xinWeChat,62,1734595702,1734595764,1734595765,-21600,MacBook
com.apple.finder,1,1734595701,1734595702,1734595703,-21600,MacBook
com.tencent.xinWeChat,2,1734595699,1734595701,1734595702,-21600,MacBook
com.apple.finder,0,1734595699,1734595699,1734595699,-21600,MacBook
com.tencent.xinWeChat,3,1734595696,1734595699,1734595699,-21600,MacBook
com.apple.finder,0,1734595696,1734595696,1734595697,-21600,MacBook
com.tencent.xinWeChat,2,1734595694,1734595696,1734595697,-21600,MacBook
com.apple.finder,1,1734595693,1734595694,1734595694,-21600,MacBook
com.tencent.xinWeChat,1,1734595692,1734595693,1734595694,-21600,MacBook
com.apple.finder,0,1734595692,1734595692,1734595693,-21600,MacBook
com.tencent.xinWeChat,1,1734595691,1734595692,1734595692,-21600,MacBook
com.apple.finder,1,1734595690,1734595691,1734595691,-21600,MacBook
com.tencent.xinWeChat,1,1734595689,1734595690,1734595691,-21600,MacBook
com.apple.finder,1,1734595688,1734595689,1734595689,-21600,MacBook
com.tencent.xinWeChat,3,1734595685,1734595688,1734595689,-21600,MacBook
com.apple.finder,0,1734595685,1734595685,1734595686,-21600,MacBook
com.tencent.xinWeChat,14,1734595671,1734595685,1734595685,-21600,MacBook
com.apple.finder,1,1734595670,1734595671,1734595671,-21600,MacBook
com.tencent.xinWeChat,3,1734595667,1734595670,1734595671,-21600,MacBook
com.apple.finder,0,1734595667,1734595667,1734595668,-21600,MacBook
com.tencent.xinWeChat,5,1734595662,1734595667,1734595667,-21600,MacBook
com.apple.finder,2,1734595660,1734595662,1734595662,-21600,MacBook
com.tencent.xinWeChat,1,1734595659,1734595660,1734595661,-21600,MacBook
com.apple.finder,3,1734595656,1734595659,1734595659,-21600,MacBook
com.tencent.xinWeChat,10,1734595646,1734595656,1734595657,-21600,MacBook
com.apple.finder,0,1734595646,1734595646,1734595647,-21600,MacBook
com.tencent.xinWeChat,4,1734595642,1734595646,1734595646,-21600,MacBook
com.apple.finder,1,1734595641,1734595642,1734595642,-21600,MacBook
com.tencent.xinWeChat,1,1734595640,1734595641,1734595642,-21600,MacBook
com.apple.finder,1,1734595639,1734595640,1734595640,-21600,MacBook
com.tencent.xinWeChat,7,1734595632,1734595639,1734595639,-21600,MacBook
com.google.Chrome,14,1734595618,1734595632,1734595633,-21600,MacBook
com.tencent.xinWeChat,1,1734595617,1734595618,1734595619,-21600,MacBook
com.google.Chrome,42,1734595575,1734595617,1734595618,-21600,MacBook
com.tencent.xinWeChat,9,1734595566,1734595575,1734595575,-21600,MacBook
com.tinyspeck.slackmacgap,8,1734595558,1734595566,1734595567,-21600,MacBook
com.apple.finder,2,1734595556,1734595558,1734595558,-21600,MacBook
com.tencent.xinWeChat,0,1734595556,1734595556,1734595557,-21600,MacBook
com.apple.finder,1,1734595555,1734595556,1734595556,-21600,MacBook
com.tencent.xinWeChat,6,1734595549,1734595555,1734595556,-21600,MacBook
com.apple.finder,1,1734595548,1734595549,1734595549,-21600,MacBook
com.tencent.xinWeChat,16,1734595532,1734595548,1734595549,-21600,MacBook
com.apple.finder,1,1734595531,1734595532,1734595532,-21600,MacBook
com.tencent.xinWeChat,1,1734595530,1734595531,1734595532,-21600,MacBook
com.apple.finder,1,1734595529,1734595530,1734595530,-21600,MacBook
com.tencent.xinWeChat,6,1734595523,1734595529,1734595530,-21600,MacBook
com.apple.finder,1,1734595522,1734595523,1734595524,-21600,MacBook
com.tencent.xinWeChat,15,1734595507,1734595522,1734595522,-21600,MacBook
com.apple.finder,1,1734595506,1734595507,1734595507,-21600,MacBook
com.tencent.xinWeChat,2,1734595504,1734595506,1734595506,-21600,MacBook
com.apple.finder,1,1734595503,1734595504,1734595504,-21600,MacBook
com.tencent.xinWeChat,5,1734595498,1734595503,1734595504,-21600,MacBook
com.apple.finder,0,1734595498,1734595498,1734595499,-21600,MacBook
com.tencent.xinWeChat,0,1734595498,1734595498,1734595499,-21600,MacBook
com.apple.finder,1,1734595497,1734595498,1734595498,-21600,MacBook
com.tencent.xinWeChat,5,1734595492,1734595497,1734595498,-21600,MacBook
com.apple.finder,40,1734595452,1734595492,1734595493,-21600,MacBook
com.tencent.xinWeChat,6,1734595446,1734595452,1734595452,-21600,MacBook
com.apple.finder,1,1734595445,1734595446,1734595446,-21600,MacBook
com.tencent.xinWeChat,3,1734595442,1734595445,1734595445,-21600,MacBook
com.apple.finder,1,1734595441,1734595442,1734595443,-21600,MacBook
com.tencent.xinWeChat,2,1734595439,1734595441,1734595441,-21600,MacBook
com.apple.finder,1,1734595438,1734595439,1734595440,-21600,MacBook
com.tencent.xinWeChat,1,1734595437,1734595438,1734595439,-21600,MacBook
com.apple.finder,4,1734595433,1734595437,1734595438,-21600,MacBook
com.tencent.xinWeChat,29,1734595404,1734595433,1734595434,-21600,MacBook
com.google.Chrome,12,1734595392,1734595404,1734595405,-21600,MacBook
com.tencent.xinWeChat,1,1734595391,1734595392,1734595393,-21600,MacBook
com.apple.finder,1,1734595390,1734595391,1734595391,-21600,MacBook
com.tencent.xinWeChat,7,1734595383,1734595390,1734595391,-21600,MacBook
com.apple.finder,0,1734595383,1734595383,1734595384,-21600,MacBook
com.tencent.xinWeChat,5,1734595378,1734595383,1734595383,-21600,MacBook
com.apple.finder,2,1734595376,1734595378,1734595379,-21600,MacBook
com.tencent.xinWeChat,69,1734595307,1734595376,1734595377,-21600,MacBook
com.microsoft.Outlook,1,1734595306,1734595307,1734595308,-21600,MacBook
com.google.Chrome,94,1734595212,1734595306,1734595307,-21600,MacBook
com.chase,93,1734595213,1734595306,1734595306,-21600,iPhone
com.apple.CoreAuthUI,1,1734595216,1734595217,1734595218,-21600,iPhone
com.microsoft.Outlook,15,1734595192,1734595207,1734595208,-21600,MacBook
com.microsoft.Office.Outlook,3,1734595202,1734595205,1734595205,-21600,iPhone
com.tencent.xinWeChat,11,1734595181,1734595192,1734595193,-21600,MacBook
com.microsoft.Outlook,4,1734595177,1734595181,1734595181,-21600,MacBook
com.apple.finder,0,1734595177,1734595177,1734595177,-21600,MacBook
com.google.Chrome,81,1734595096,1734595177,1734595177,-21600,MacBook
com.apple.mobiletimer,68,1734595081,1734595149,1734595150,-21600,iPhone
com.apple.PassbookUIService,67,1734595082,1734595149,1734595150,-21600,iPhone
com.apple.mobiletimer,10,1734595056,1734595066,1734595066,-21600,iPhone
com.apple.mobiletimer,0,1734595053,1734595053,1734595054,-21600,iPhone
com.apple.finder,8,1734594969,1734594977,1734594978,-21600,MacBook
com.tencent.xinWeChat,0,1734594969,1734594969,1734594970,-21600,MacBook
com.google.Chrome,2193,1734592776,1734594969,1734594970,-21600,MacBook
com.tencent.xinWeChat,11,1734592765,1734592776,1734592776,-21600,MacBook
com.microsoft.Outlook,2,1734592763,1734592765,1734592765,-21600,MacBook
com.tencent.xinWeChat,3,1734592760,1734592763,1734592764,-21600,MacBook
com.google.Chrome,1315,1734591445,1734592760,1734592761,-21600,MacBook
com.tencent.xinWeChat,2,1734591443,1734591445,1734591446,-21600,MacBook
com.microsoft.Outlook,0,1734591443,1734591443,1734591444,-21600,MacBook
com.google.Chrome,2,1734591441,1734591443,1734591444,-21600,MacBook
com.microsoft.Outlook,11,1734591430,1734591441,1734591442,-21600,MacBook
com.tencent.xinWeChat,0,1734591430,1734591430,1734591432,-21600,MacBook
com.google.Chrome,1763,1734589667,1734591430,1734591431,-21600,MacBook
com.tencent.xinWeChat,1,1734589666,1734589667,1734589667,-21600,MacBook
com.google.Chrome,590,1734589076,1734589666,1734589667,-21600,MacBook
com.apple.finder,1,1734589075,1734589076,1734589077,-21600,MacBook
com.tencent.xinWeChat,3,1734589072,1734589075,1734589076,-21600,MacBook
com.apple.finder,0,1734589072,1734589072,1734589073,-21600,MacBook
com.tencent.xinWeChat,1,1734589071,1734589072,1734589072,-21600,MacBook
com.apple.finder,0,1734589071,1734589071,1734589072,-21600,MacBook
com.tencent.xinWeChat,0,1734589071,1734589071,1734589072,-21600,MacBook
com.apple.finder,1,1734589070,1734589071,1734589071,-21600,MacBook
com.tencent.xinWeChat,3,1734589067,1734589070,1734589071,-21600,MacBook
com.apple.finder,0,1734589067,1734589067,1734589068,-21600,MacBook
com.google.Chrome,1860,1734587207,1734589067,1734589068,-21600,MacBook
com.apple.mobiletimer,18,1734587119,1734587137,1734587138,-21600,iPhone
com.google.Chrome,577,1734586546,1734587123,1734587123,-21600,MacBook
com.apple.finder,7,1734586539,1734586546,1734586547,-21600,MacBook
com.apple.mobiletimer,3,1734586517,1734586520,1734586521,-21600,iPhone
com.tencent.xin,2,1734586515,1734586517,1734586517,-21600,iPhone
com.tencent.xin,1,1734585978,1734585979,1734585980,-21600,iPhone
com.tencent.xin,2,1734585975,1734585977,1734585978,-21600,iPhone
com.tencent.xin,2,1734585967,1734585969,1734585969,-21600,iPhone
com.tencent.xin,7,1734585952,1734585959,1734585960,-21600,iPhone
com.tencent.xin,2,1734585949,1734585951,1734585951,-21600,iPhone
com.netease.cloudmusic,2,1734585946,1734585948,1734585949,-21600,iPhone
com.google.chrome.ios,3,1734585941,1734585944,1734585945,-21600,iPhone
com.tencent.xin,55,1734585886,1734585941,1734585942,-21600,iPhone
com.tencent.xin,2,1734585884,1734585886,1734585886,-21600,iPhone
tv.danmaku.bilianime,2824,1734583059,1734585883,1734585883,-21600,iPhone
com.openai.chat,57,1734583002,1734583059,1734583060,-21600,iPhone
com.tencent.xin,1,1734583000,1734583001,1734583002,-21600,iPhone
tv.danmaku.bilianime,6,1734582990,1734582996,1734582997,-21600,iPhone
tv.danmaku.bilianime,1682,1734581296,1734582978,1734582979,-21600,iPhone
com.google.chrome.ios,17,1734581294,1734581311,1734581312,-21600,iPhone
tv.danmaku.bilianime,4255,1734577039,1734581294,1734581295,-21600,iPhone
com.google.chrome.ios,11,1734581274,1734581285,1734581286,-21600,iPhone
com.tencent.xin,10,1734581263,1734581273,1734581273,-21600,iPhone
tv.danmaku.bilianime,131,1734576758,1734576889,1734576890,-21600,iPhone
com.netease.cloudmusic,6,1734576749,1734576755,1734576756,-21600,iPhone
com.apple.finder,15,1734576667,1734576682,1734576683,-21600,MacBook
com.naver.linewebtoon,19,1734576387,1734576406,1734576406,-21600,iPhone
com.bilibili.bilicomic,9,1734576378,1734576387,1734576387,-21600,iPhone
com.naver.linewebtoon,1,1734576377,1734576378,1734576379,-21600,iPhone
com.bilibili.bilicomic,1,1734576375,1734576376,1734576377,-21600,iPhone
com.naver.linewebtoon,1,1734576374,1734576375,1734576375,-21600,iPhone
com.bilibili.bilicomic,23,1734576343,1734576366,1734576366,-21600,iPhone
com.bilibili.bilicomic,1,1734576338,1734576339,1734576340,-21600,iPhone
com.tencent.xin,4,1734576330,1734576334,1734576335,-21600,iPhone
com.google.chrome.ios,145,1734576183,1734576328,1734576329,-21600,iPhone
com.microsoft.Office.Outlook,1,1734576182,1734576183,1734576184,-21600,iPhone
com.google.chrome.ios,2,1734576180,1734576182,1734576182,-21600,iPhone
com.microsoft.Office.Outlook,3,1734576177,1734576180,1734576181,-21600,iPhone
com.google.chrome.ios,2,1734576175,1734576177,1734576177,-21600,iPhone
com.microsoft.Office.Outlook,0,1734576175,1734576175,1734576176,-21600,iPhone
com.google.chrome.ios,13,1734576161,1734576174,1734576175,-21600,iPhone
com.microsoft.Office.Outlook,6,1734576155,1734576161,1734576161,-21600,iPhone
com.tencent.xin,1,1734576154,1734576155,1734576155,-21600,iPhone
com.bilibili.bilicomic,42,1734576111,1734576153,1734576154,-21600,iPhone
com.bilibili.bilicomic,1,1734576073,1734576074,1734576074,-21600,iPhone
com.bilibili.bilicomic,6,1734576054,1734576060,1734576061,-21600,iPhone
com.bilibili.bilicomic,4,1734576047,1734576051,1734576052,-21600,iPhone
com.tencent.xin,178,1734575656,1734575834,1734575835,-21600,iPhone
com.tencent.xin,1,1734575651,1734575652,1734575652,-21600,iPhone
com.tencent.xin,4,1734575646,1734575650,1734575651,-21600,iPhone
com.microsoft.Office.Outlook,2,1734575643,1734575645,1734575646,-21600,iPhone
com.microsoft.Office.Outlook,14,1734575629,1734575643,1734575643,-21600,iPhone
com.netease.cloudmusic,6,1734575622,1734575628,1734575629,-21600,iPhone
com.apple.mobiletimer,1,1734575621,1734575622,1734575622,-21600,iPhone
com.tencent.xin,33,1734575587,1734575620,1734575621,-21600,iPhone
com.google.chrome.ios,48,1734575539,1734575587,1734575587,-21600,iPhone
com.tencent.xin,28,1734575511,1734575539,1734575540,-21600,iPhone
com.google.chrome.ios,32,1734575479,1734575511,1734575512,-21600,iPhone
com.tencent.xin,1675,1734573803,1734575478,1734575479,-21600,iPhone
com.apple.mobiletimer,4,1734573799,1734573803,1734573803,-21600,iPhone
com.apple.finder,7,1734572470,1734572477,1734572478,-21600,MacBook
com.google.Chrome,18,1734572452,1734572470,1734572471,-21600,MacBook
com.apple.finder,10,1734572442,1734572452,1734572453,-21600,MacBook
com.tencent.xinWeChat,1,1734572441,1734572442,1734572443,-21600,MacBook
com.google.Chrome,55,1734572386,1734572441,1734572442,-21600,MacBook
com.tencent.xinWeChat,1,1734572385,1734572386,1734572387,-21600,MacBook
com.google.Chrome,33,1734572352,1734572385,1734572386,-21600,MacBook
com.apple.finder,2,1734572350,1734572352,1734572353,-21600,MacBook
com.tencent.xinWeChat,0,1734572350,1734572350,1734572351,-21600,MacBook
com.apple.finder,2,1734572348,1734572350,1734572350,-21600,MacBook
com.tencent.xinWeChat,0,1734572348,1734572348,1734572349,-21600,MacBook
com.apple.finder,1,1734572347,1734572348,1734572348,-21600,MacBook
com.google.Chrome,39,1734572308,1734572347,1734572347,-21600,MacBook
com.apple.finder,4,1734572304,1734572308,1734572309,-21600,MacBook
com.tencent.xinWeChat,21,1734572283,1734572304,1734572304,-21600,MacBook
com.apple.finder,1,1734572282,1734572283,1734572283,-21600,MacBook
com.tencent.xinWeChat,2,1734572280,1734572282,1734572283,-21600,MacBook
com.apple.finder,1,1734572279,1734572280,1734572280,-21600,MacBook
com.tencent.xinWeChat,8,1734572271,1734572279,1734572280,-21600,MacBook
com.apple.finder,0,1734572271,1734572271,1734572272,-21600,MacBook
com.tencent.xinWeChat,3,1734572268,1734572271,1734572271,-21600,MacBook
com.apple.finder,0,1734572268,1734572268,1734572269,-21600,MacBook
com.tencent.xinWeChat,2,1734572266,1734572268,1734572269,-21600,MacBook
com.apple.finder,1,1734572265,1734572266,1734572266,-21600,MacBook
com.tencent.xinWeChat,1,1734572264,1734572265,1734572266,-21600,MacBook
com.apple.finder,0,1734572264,1734572264,1734572265,-21600,MacBook
com.tencent.xinWeChat,1,1734572263,1734572264,1734572264,-21600,MacBook
com.apple.finder,0,1734572263,1734572263,1734572264,-21600,MacBook
com.tencent.xinWeChat,1,1734572262,1734572263,1734572263,-21600,MacBook
com.apple.finder,0,1734572262,1734572262,1734572263,-21600,MacBook
com.tencent.xinWeChat,1,1734572261,1734572262,1734572262,-21600,MacBook
com.apple.finder,0,1734572261,1734572261,1734572262,-21600,MacBook
com.tencent.xinWeChat,1,1734572260,1734572261,1734572261,-21600,MacBook
com.apple.finder,3,1734572257,1734572260,1734572261,-21600,MacBook
com.tencent.xinWeChat,1,1734572256,1734572257,1734572257,-21600,MacBook
com.apple.finder,0,1734572256,1734572256,1734572257,-21600,MacBook
com.tencent.xinWeChat,1,1734572255,1734572256,1734572256,-21600,MacBook
com.apple.finder,0,1734572255,1734572255,1734572256,-21600,MacBook
com.tencent.xinWeChat,2,1734572253,1734572255,1734572255,-21600,MacBook
com.apple.finder,0,1734572253,1734572253,1734572254,-21600,MacBook
com.tencent.xinWeChat,1,1734572252,1734572253,1734572254,-21600,MacBook
com.apple.finder,1,1734572251,1734572252,1734572252,-21600,MacBook
com.tencent.xinWeChat,9,1734572242,1734572251,1734572252,-21600,MacBook
com.apple.finder,1,1734572241,1734572242,1734572242,-21600,MacBook
com.tencent.xinWeChat,25,1734572216,1734572241,1734572242,-21600,MacBook
com.google.Chrome,10,1734572206,1734572216,1734572217,-21600,MacBook
com.apple.finder,3,1734572203,1734572206,1734572206,-21600,MacBook
com.tencent.xinWeChat,1,1734572202,1734572203,1734572204,-21600,MacBook
com.apple.finder,1,1734572201,1734572202,1734572202,-21600,MacBook
com.tencent.xinWeChat,0,1734572201,1734572201,1734572202,-21600,MacBook
com.google.Chrome,39,1734572162,1734572201,1734572202,-21600,MacBook
com.tencent.xinWeChat,1,1734572161,1734572162,1734572163,-21600,MacBook
com.google.Chrome,51,1734572110,1734572161,1734572161,-21600,MacBook
com.apple.finder,1,1734572109,1734572110,1734572110,-21600,MacBook
com.tencent.xinWeChat,7,1734572102,1734572109,1734572109,-21600,MacBook
com.apple.finder,1,1734572101,1734572102,1734572102,-21600,MacBook
com.tencent.xinWeChat,0,1734572101,1734572101,1734572102,-21600,MacBook
com.apple.finder,1,1734572100,1734572101,1734572102,-21600,MacBook
com.tencent.xinWeChat,7,1734572093,1734572100,1734572100,-21600,MacBook
com.apple.finder,1,1734572092,1734572093,1734572094,-21600,MacBook
com.tencent.xinWeChat,1,1734572091,1734572092,1734572093,-21600,MacBook
com.apple.finder,1,1734572090,1734572091,1734572092,-21600,MacBook
com.apple.Preview,3,1734572087,1734572090,1734572091,-21600,MacBook
com.apple.finder,1,1734572086,1734572087,1734572088,-21600,MacBook
com.tencent.xinWeChat,0,1734572086,1734572086,1734572087,-21600,MacBook
com.apple.finder,17,1734572069,1734572086,1734572086,-21600,MacBook
com.tencent.xinWeChat,4,1734572065,1734572069,1734572070,-21600,MacBook
com.apple.finder,0,1734572065,1734572065,1734572066,-21600,MacBook
com.tencent.xinWeChat,0,1734572065,1734572065,1734572065,-21600,MacBook
com.google.Chrome,139,1734571926,1734572065,1734572065,-21600,MacBook
com.tencent.xinWeChat,3,1734571923,1734571926,1734571927,-21600,MacBook
com.google.Chrome,3,1734571920,1734571923,1734571925,-21600,MacBook
com.tencent.xinWeChat,1,1734571919,1734571920,1734571921,-21600,MacBook
com.apple.finder,1,1734571918,1734571919,1734571920,-21600,MacBook
com.tencent.xinWeChat,0,1734571918,1734571918,1734571919,-21600,MacBook
com.google.Chrome,116,1734571802,1734571918,1734571919,-21600,MacBook
com.tencent.xinWeChat,34,1734571768,1734571802,1734571803,-21600,MacBook
com.apple.finder,1,1734571767,1734571768,1734571769,-21600,MacBook
com.tencent.xinWeChat,1,1734571766,1734571767,1734571767,-21600,MacBook
com.apple.finder,0,1734571766,1734571766,1734571767,-21600,MacBook
com.google.Chrome,37,1734571729,1734571766,1734571766,-21600,MacBook
com.apple.finder,2,1734571727,1734571729,1734571730,-21600,MacBook
com.apple.Preview,3,1734571724,1734571727,1734571727,-21600,MacBook
com.tencent.xinWeChat,1,1734571723,1734571724,1734571724,-21600,MacBook
com.apple.finder,86,1734571637,1734571723,1734571724,-21600,MacBook
com.apple.MobileSMS,77,1734571642,1734571719,1734571720,-21600,iPhone
com.amazon.Amazon,2,1734571639,1734571641,1734571642,-21600,iPhone
com.tencent.xinWeChat,4,1734571633,1734571637,1734571637,-21600,MacBook
com.apple.finder,3,1734571630,1734571633,1734571633,-21600,MacBook
com.tencent.xinWeChat,17,1734571613,1734571630,1734571631,-21600,MacBook
com.apple.finder,1,1734571612,1734571613,1734571613,-21600,MacBook
com.tencent.xinWeChat,1,1734571611,1734571612,1734571613,-21600,MacBook
com.apple.finder,4,1734571607,1734571611,1734571612,-21600,MacBook
com.apple.Preview,3,1734571604,1734571607,1734571607,-21600,MacBook
com.apple.finder,7,1734571597,1734571604,1734571605,-21600,MacBook
com.apple.Preview,3,1734571594,1734571597,1734571598,-21600,MacBook
com.apple.finder,16,1734571578,1734571594,1734571594,-21600,MacBook
com.tencent.xinWeChat,1,1734571577,1734571578,1734571579,-21600,MacBook
com.apple.finder,1,1734571576,1734571577,1734571578,-21600,MacBook
com.tencent.xinWeChat,7,1734571569,1734571576,1734571576,-21600,MacBook
com.apple.finder,2,1734571567,1734571569,1734571570,-21600,MacBook
com.tencent.xinWeChat,1,1734571566,1734571567,1734571568,-21600,MacBook
com.microsoft.Outlook,1,1734571565,1734571566,1734571567,-21600,MacBook
com.apple.Preview,2,1734571563,1734571565,1734571565,-21600,MacBook
com.tencent.xinWeChat,1,1734571562,1734571563,1734571563,-21600,MacBook
com.google.Chrome,760,1734570802,1734571562,1734571563,-21600,MacBook
com.tencent.xinWeChat,2,1734570800,1734570802,1734570802,-21600,MacBook
com.google.Chrome,6,1734570794,1734570800,1734570800,-21600,MacBook
com.tencent.xinWeChat,0,1734570794,1734570794,1734570795,-21600,MacBook
com.apple.Dictionary,2,1734570792,1734570794,1734570794,-21600,MacBook
com.google.Chrome,251,1734570541,1734570792,1734570792,-21600,MacBook
com.tencent.xinWeChat,1,1734570540,1734570541,1734570542,-21600,MacBook
com.google.Chrome,72,1734570468,1734570540,1734570541,-21600,MacBook
com.tencent.xinWeChat,21,1734570408,1734570429,1734570429,-21600,MacBook
com.google.Chrome,4032,1734566376,1734570408,1734570409,-21600,MacBook
com.apple.Preview,4,1734566372,1734566376,1734566377,-21600,MacBook
com.google.Chrome,1,1734566371,1734566372,1734566373,-21600,MacBook
com.apple.Preview,4,1734566367,1734566371,1734566371,-21600,MacBook
com.apple.finder,5,1734566362,1734566367,1734566368,-21600,MacBook
com.microsoft.Outlook,2,1734566360,1734566362,1734566362,-21600,MacBook
com.google.Chrome,302,1734566058,1734566360,1734566361,-21600,MacBook
com.amazon.Amazon,11,1734566088,1734566099,1734566100,-21600,iPhone
com.amazon.Amazon,1,1734566087,1734566088,1734566089,-21600,iPhone
com.discoverfinancial.mobile,7,1734566080,1734566087,1734566087,-21600,iPhone
com.apple.camera,3,1734566082,1734566085,1734566086,-21600,iPhone
com.apple.Preview,1,1734566057,1734566058,1734566059,-21600,MacBook
com.google.Chrome,5,1734566052,1734566057,1734566058,-21600,MacBook
com.apple.Preview,2,1734566050,1734566052,1734566053,-21600,MacBook
com.apple.finder,7,1734566043,1734566050,1734566050,-21600,MacBook
com.google.Chrome,359,1734565684,1734566043,1734566044,-21600,MacBook
com.discoverfinancial.mobile,17,1734565944,1734565961,1734565962,-21600,iPhone
com.apple.CoreAuthUI,2,1734565950,1734565952,1734565953,-21600,iPhone
com.netease.cloudmusic,2,1734565937,1734565939,1734565940,-21600,iPhone
com.microsoft.Outlook,3,1734565681,1734565684,1734565686,-21600,MacBook
com.apple.Dictionary,2,1734565679,1734565681,1734565682,-21600,MacBook
com.google.Chrome,98,1734565581,1734565679,1734565681,-21600,MacBook
com.microsoft.Outlook,11,1734565570,1734565581,1734565581,-21600,MacBook
com.apple.finder,1,1734565569,1734565570,1734565570,-21600,MacBook
com.google.Chrome,15,1734565554,1734565569,1734565569,-21600,MacBook
com.google.Chrome,440,1734562037,1734562477,1734562478,-21600,MacBook
com.apple.finder,30,1734562007,1734562037,1734562037,-21600,MacBook
com.netease.cloudmusic,8,1734562021,1734562029,1734562030,-21600,iPhone
com.tencent.xin,6,1734562014,1734562020,1734562021,-21600,iPhone
com.apple.finder,304,1734561535,1734561839,1734561840,-21600,MacBook
com.tencent.xin,1,1734561544,1734561545,1734561545,-21600,iPhone
com.tencent.xinWeChat,4,1734561531,1734561535,1734561536,-21600,MacBook
com.apple.finder,3,1734561528,1734561531,1734561531,-21600,MacBook
com.google.Chrome,767,1734560761,1734561528,1734561529,-21600,MacBook
com.tencent.xin,1,1734560691,1734560692,1734560693,-21600,iPhone
com.tencent.xin,7,1734560680,1734560687,1734560688,-21600,iPhone
com.microsoft.Office.Outlook,5,1734560675,1734560680,1734560681,-21600,iPhone
com.tencent.xin,2,1734560673,1734560675,1734560676,-21600,iPhone
com.microsoft.Office.Outlook,1,1734560672,1734560673,1734560674,-21600,iPhone
com.tencent.xin,1,1734560671,1734560672,1734560672,-21600,iPhone
com.apple.mobiletimer,5,1734560665,1734560670,1734560671,-21600,iPhone
com.google.Chrome,359,1734558980,1734559339,1734559339,-21600,MacBook
com.apple.mobiletimer,7,1734559035,1734559042,1734559043,-21600,iPhone
com.google.Chrome,409,1734557868,1734558277,1734558278,-21600,MacBook
com.apple.mobiletimer,3,1734557969,1734557972,1734557973,-21600,iPhone
com.tencent.xin,9,1734557957,1734557966,1734557966,-21600,iPhone
com.apple.mobiletimer,10,1734557946,1734557956,1734557956,-21600,iPhone
com.tencent.xin,1,1734557943,1734557944,1734557945,-21600,iPhone
com.google.Chrome,58,1734553943,1734554001,1734554001,-21600,MacBook
com.bilibili.bilicomic,19,1734552417,1734552436,1734552438,-21600,iPhone
com.apple.Preferences,27,1734552390,1734552417,1734552417,-21600,iPhone
com.bilibili.bilicomic,3,1734552383,1734552386,1734552386,-21600,iPhone
com.google.chrome.ios,116,1734552248,1734552364,1734552365,-21600,iPhone
com.netease.cloudmusic,52,1734552196,1734552248,1734552248,-21600,iPhone
com.netease.cloudmusic,139,1734552056,1734552195,1734552196,-21600,iPhone
com.tinyspeck.chatlyio,11,1734552045,1734552056,1734552056,-21600,iPhone
com.tencent.xin,2534,1734549511,1734552045,1734552045,-21600,iPhone
com.google.Chrome,301,1734551205,1734551506,1734551507,-21600,MacBook
com.apple.finder,1,1734551204,1734551205,1734551206,-21600,MacBook
com.apple.Notes,2,1734551202,1734551204,1734551205,-21600,MacBook
com.apple.finder,0,1734551202,1734551202,1734551202,-21600,MacBook
com.microsoft.Outlook,13,1734551189,1734551202,1734551202,-21600,MacBook
com.apple.Preview,2,1734551187,1734551189,1734551189,-21600,MacBook
com.microsoft.Outlook,2,1734551185,1734551187,1734551187,-21600,MacBook
com.apple.Preview,0,1734551185,1734551185,1734551185,-21600,MacBook
com.google.Chrome,2,1734551183,1734551185,1734551185,-21600,MacBook
com.xingin.discover,45,1734549466,1734549511,1734549512,-21600,iPhone
com.apple.Preferences,2,1734549464,1734549466,1734549466,-21600,iPhone
com.tencent.xin,6,1734549458,1734549464,1734549465,-21600,iPhone
com.apple.Preferences,18,1734549440,1734549458,1734549459,-21600,iPhone
com.tencent.xin,3,1734549436,1734549439,1734549440,-21600,iPhone
com.xingin.discover,17,1734549419,1734549436,1734549436,-21600,iPhone
com.tencent.xin,7,1734549412,1734549419,1734549420,-21600,iPhone
com.xingin.discover,18,1734549394,1734549412,1734549413,-21600,iPhone
com.tencent.xin,7,1734549387,1734549394,1734549394,-21600,iPhone
com.fobwifi.fobwifi,5,1734549382,1734549387,1734549388,-21600,iPhone
com.tencent.xin,10,1734549371,1734549381,1734549381,-21600,iPhone
com.xingin.discover,862,1734548509,1734549371,1734549372,-21600,iPhone
com.tencent.xin,16,1734548493,1734548509,1734548510,-21600,iPhone
com.xingin.discover,1,1734548492,1734548493,1734548493,-21600,iPhone
com.bilibili.bilicomic,44,1734548445,1734548489,1734548490,-21600,iPhone
com.google.Chrome,566,1734547922,1734548488,1734548488,-21600,MacBook
tv.danmaku.bilianime,1,1734548444,1734548445,1734548446,-21600,iPhone
com.bilibili.bilicomic,1,1734548442,1734548443,1734548444,-21600,iPhone
com.tencent.xin,46,1734548390,1734548436,1734548437,-21600,iPhone
com.tinyspeck.chatlyio,1,1734548389,1734548390,1734548391,-21600,iPhone
com.apple.Preview,3,1734547919,1734547922,1734547923,-21600,MacBook
com.google.Chrome,2,1734547917,1734547919,1734547920,-21600,MacBook
com.apple.Preview,5,1734547912,1734547917,1734547918,-21600,MacBook
com.google.Chrome,11,1734547901,1734547912,1734547913,-21600,MacBook
com.apple.Preview,12,1734547889,1734547901,1734547902,-21600,MacBook
com.google.Chrome,195,1734547694,1734547889,1734547890,-21600,MacBook
com.apple.Preview,2,1734547692,1734547694,1734547695,-21600,MacBook
com.google.Chrome,3,1734547689,1734547692,1734547692,-21600,MacBook
com.apple.Preview,31,1734547658,1734547689,1734547690,-21600,MacBook
com.microsoft.Outlook,2,1734547656,1734547658,1734547658,-21600,MacBook
com.apple.finder,1,1734547655,1734547656,1734547657,-21600,MacBook
com.apple.Preview,1,1734547654,1734547655,1734547656,-21600,MacBook
com.apple.finder,1,1734547653,1734547654,1734547654,-21600,MacBook
com.microsoft.Outlook,7,1734547646,1734547653,1734547654,-21600,MacBook
com.apple.finder,2,1734547644,1734547646,1734547647,-21600,MacBook
com.apple.Notes,1,1734547643,1734547644,1734547645,-21600,MacBook
com.google.Chrome,23,1734547620,1734547643,1734547644,-21600,MacBook
com.apple.Notes,6,1734547614,1734547620,1734547620,-21600,MacBook
com.apple.finder,1,1734547613,1734547614,1734547614,-21600,MacBook
com.microsoft.Outlook,3,1734547610,1734547613,1734547613,-21600,MacBook
com.google.Chrome,36,1734547574,1734547610,1734547611,-21600,MacBook
com.microsoft.Outlook,2,1734547572,1734547574,1734547575,-21600,MacBook
com.google.Chrome,10,1734547562,1734547572,1734547572,-21600,MacBook
com.microsoft.Outlook,4,1734547558,1734547562,1734547562,-21600,MacBook
com.google.Chrome,11,1734547547,1734547558,1734547559,-21600,MacBook
com.microsoft.Outlook,11,1734547536,1734547547,1734547548,-21600,MacBook
com.apple.finder,2,1734547534,1734547536,1734547536,-21600,MacBook
com.apple.Notes,2,1734547532,1734547534,1734547535,-21600,MacBook
com.google.Chrome,950,1734546582,1734547532,1734547533,-21600,MacBook
com.apple.Notes,9,1734546573,1734546582,1734546583,-21600,MacBook
com.google.Chrome,43,1734546530,1734546573,1734546574,-21600,MacBook
com.apple.Notes,9,1734546521,1734546530,1734546531,-21600,MacBook
com.apple.Preview,1,1734546520,1734546521,1734546522,-21600,MacBook
com.google.Chrome,27,1734546493,1734546520,1734546521,-21600,MacBook
com.google.Chrome,918,1734545561,1734546479,1734546479,-21600,MacBook
com.apple.Preview,6,1734545555,1734545561,1734545561,-21600,MacBook
com.google.Chrome,0,1734545555,1734545555,1734545556,-21600,MacBook
com.apple.Preview,3,1734545552,1734545555,1734545556,-21600,MacBook
com.google.Chrome,2,1734545550,1734545552,1734545553,-21600,MacBook
com.apple.Preview,2,1734545548,1734545550,1734545551,-21600,MacBook
com.apple.finder,1,1734545547,1734545548,1734545549,-21600,MacBook
com.apple.Preview,1,1734545546,1734545547,1734545548,-21600,MacBook
com.apple.finder,0,1734545546,1734545546,1734545547,-21600,MacBook
com.apple.Preview,1,1734545545,1734545546,1734545546,-21600,MacBook
com.apple.finder,1,1734545544,1734545545,1734545545,-21600,MacBook
com.apple.Preview,4,1734545540,1734545544,1734545545,-21600,MacBook
com.apple.finder,1,1734545539,1734545540,1734545540,-21600,MacBook
com.apple.Preview,13,1734545526,1734545539,1734545539,-21600,MacBook
com.apple.finder,1,1734545525,1734545526,1734545526,-21600,MacBook
com.apple.Preview,13,1734545512,1734545525,1734545526,-21600,MacBook
com.microsoft.Outlook,27,1734545485,1734545512,1734545512,-21600,MacBook
com.google.Chrome,0,1734545485,1734545485,1734545486,-21600,MacBook
com.microsoft.Outlook,8,1734545477,1734545485,1734545485,-21600,MacBook
com.apple.Preview,4,1734545473,1734545477,1734545477,-21600,MacBook
com.apple.finder,3,1734545470,1734545473,1734545474,-21600,MacBook
com.google.Chrome,2,1734545468,1734545470,1734545470,-21600,MacBook
com.apple.finder,2,1734545466,1734545468,1734545469,-21600,MacBook
com.google.Chrome,131,1734545335,1734545466,1734545467,-21600,MacBook
com.apple.finder,9,1734545326,1734545335,1734545336,-21600,MacBook
com.google.Chrome,257,1734545069,1734545326,1734545327,-21600,MacBook
com.apple.finder,6,1734545063,1734545069,1734545070,-21600,MacBook
com.microsoft.Outlook,3,1734545060,1734545063,1734545064,-21600,MacBook
com.google.Chrome,88,1734544972,1734545060,1734545060,-21600,MacBook
com.tinyspeck.chatlyio,6,1734545047,1734545053,1734545054,-21600,iPhone
com.tinyspeck.chatlyio,10,1734545028,1734545038,1734545038,-21600,iPhone
com.apple.sidecar,6,1734545028,1734545034,1734545034,-21600,iPhone
com.microsoft.Outlook,13,1734544959,1734544972,1734544973,-21600,MacBook
com.google.Chrome,1,1734544958,1734544959,1734544960,-21600,MacBook
com.microsoft.Outlook,14,1734544944,1734544958,1734544958,-21600,MacBook
com.google.Chrome,1,1734544943,1734544944,1734544945,-21600,MacBook
com.microsoft.Outlook,22,1734544921,1734544943,1734544944,-21600,MacBook
com.google.Chrome,21,1734544900,1734544921,1734544922,-21600,MacBook
com.microsoft.Outlook,4,1734544896,1734544900,1734544901,-21600,MacBook
com.google.Chrome,50,1734544846,1734544896,1734544896,-21600,MacBook
com.microsoft.Outlook,8,1734544838,1734544846,1734544846,-21600,MacBook
com.apple.finder,1,1734544837,1734544838,1734544838,-21600,MacBook
com.google.Chrome,12,1734544825,1734544837,1734544838,-21600,MacBook
com.google.Chrome,510,1734543641,1734544151,1734544151,-21600,MacBook
com.tinyspeck.chatlyio,8,1734543209,1734543217,1734543217,-21600,iPhone
com.tinyspeck.chatlyio,18,1734543070,1734543088,1734543089,-21600,iPhone
com.netease.cloudmusic,5,1734543062,1734543067,1734543068,-21600,iPhone
com.netease.cloudmusic,57,1734543001,1734543058,1734543058,-21600,iPhone
com.netease.cloudmusic,1,1734542235,1734542236,1734542237,-21600,iPhone
com.netease.cloudmusic,16,1734541132,1734541148,1734541149,-21600,iPhone
com.fobwifi.fobwifi,60,1734541072,1734541132,1734541133,-21600,iPhone
com.netease.cloudmusic,12,1734541060,1734541072,1734541072,-21600,iPhone
com.apple.Preferences,1,1734541059,1734541060,1734541061,-21600,iPhone
com.netease.cloudmusic,5,1734541054,1734541059,1734541059,-21600,iPhone
com.xingin.discover,1,1734541051,1734541052,1734541052,-21600,iPhone
com.xingin.discover,471,1734540541,1734541012,1734541013,-21600,iPhone
com.tencent.xin,106,1734540431,1734540537,1734540538,-21600,iPhone
tv.danmaku.bilianime,571,1734539860,1734540431,1734540432,-21600,iPhone
com.microsoft.Office.Outlook,36,1734539824,1734539860,1734539860,-21600,iPhone
tv.danmaku.bilianime,1223,1734538601,1734539824,1734539825,-21600,iPhone
tv.danmaku.bilianime,11,1734538585,1734538596,1734538597,-21600,iPhone
tv.danmaku.bilianime,9,1734538570,1734538579,1734538580,-21600,iPhone
com.tinyspeck.chatlyio,71,1734538499,1734538570,1734538571,-21600,iPhone
com.microsoft.Office.Outlook,12,1734538487,1734538499,1734538500,-21600,iPhone
com.tinyspeck.chatlyio,28,1734538459,1734538487,1734538488,-21600,iPhone
com.microsoft.Office.Outlook,14,1734538445,1734538459,1734538460,-21600,iPhone
com.tinyspeck.chatlyio,1,1734538444,1734538445,1734538446,-21600,iPhone
com.microsoft.Office.Outlook,39,1734538404,1734538443,1734538443,-21600,iPhone
com.google.chrome.ios,98,1734538306,1734538404,1734538406,-21600,iPhone
com.microsoft.Office.Outlook,72,1734538234,1734538306,1734538307,-21600,iPhone
tv.danmaku.bilianime,7,1734538227,1734538234,1734538235,-21600,iPhone
tv.danmaku.bilianime,850,1734507391,1734508241,1734508242,-21600,iPhone
tv.danmaku.bilianime,1,1734507390,1734507391,1734507391,-21600,iPhone
com.google.chrome.ios,1158,1734506227,1734507385,1734507386,-21600,iPhone
com.microsoft.Office.Outlook,2,1734506225,1734506227,1734506227,-21600,iPhone
com.netease.cloudmusic,4,1734506221,1734506225,1734506225,-21600,iPhone
com.google.chrome.ios,1,1734506220,1734506221,1734506221,-21600,iPhone
com.netease.cloudmusic,1,1734506215,1734506216,1734506217,-21600,iPhone
com.fobwifi.fobwifi,4,1734506209,1734506213,1734506213,-21600,iPhone
tv.danmaku.bilianime,5,1734506204,1734506209,1734506209,-21600,iPhone
com.fobwifi.fobwifi,1,1734506203,1734506204,1734506204,-21600,iPhone
tv.danmaku.bilianime,3,1734506199,1734506202,1734506203,-21600,iPhone
com.apple.Preferences,4,1734506195,1734506199,1734506200,-21600,iPhone
tv.danmaku.bilianime,18,1734506175,1734506193,1734506193,-21600,iPhone
com.fobwifi.fobwifi,10,1734506165,1734506175,1734506175,-21600,iPhone
tv.danmaku.bilianime,18,1734506145,1734506163,1734506164,-21600,iPhone
com.bilibili.bilicomic,2313,1734503832,1734506145,1734506145,-21600,iPhone
tv.danmaku.bilianime,1,1734503831,1734503832,1734503833,-21600,iPhone
com.bilibili.bilicomic,1,1734503830,1734503831,1734503831,-21600,iPhone
com.google.chrome.ios,4193,1734499634,1734503827,1734503828,-21600,iPhone
com.google.chrome.ios,8,1734499625,1734499633,1734499634,-21600,iPhone
com.tencent.xin,10,1734499615,1734499625,1734499626,-21600,iPhone
com.google.chrome.ios,28,1734499587,1734499615,1734499616,-21600,iPhone
com.tencent.xin,14,1734499573,1734499587,1734499588,-21600,iPhone
com.google.chrome.ios,2,1734499569,1734499571,1734499572,-21600,iPhone
com.tencent.xin,3,1734499566,1734499569,1734499570,-21600,iPhone
com.fobwifi.fobwifi,17,1734499547,1734499564,1734499564,-21600,iPhone
com.fobwifi.fobwifi,11,1734499534,1734499545,1734499546,-21600,iPhone
com.google.chrome.ios,11,1734499522,1734499533,1734499533,-21600,iPhone
com.tencent.xin,140,1734499380,1734499520,1734499521,-21600,iPhone
com.google.Chrome,303,1734498736,1734499039,1734499039,-21600,MacBook
com.google.Chrome,302,1734498015,1734498317,1734498317,-21600,MacBook
com.tencent.xin,1353,1734496667,1734498020,1734498022,-21600,iPhone
com.google.Chrome,311,1734497672,1734497983,1734497984,-21600,MacBook
com.google.Chrome,592,1734496359,1734496951,1734496951,-21600,MacBook
com.tencent.xin,2,1734496665,1734496667,1734496667,-21600,iPhone
com.microsoft.Office.Outlook,8,1734496657,1734496665,1734496666,-21600,iPhone
com.apple.finder,1,1734496358,1734496359,1734496360,-21600,MacBook
com.apple.Notes,3,1734496355,1734496358,1734496359,-21600,MacBook
com.google.Chrome,8,1734496347,1734496355,1734496355,-21600,MacBook
com.apple.Notes,4,1734496343,1734496347,1734496347,-21600,MacBook
com.google.Chrome,3,1734496340,1734496343,1734496343,-21600,MacBook
com.apple.Notes,5,1734496335,1734496340,1734496341,-21600,MacBook
com.apple.finder,0,1734496335,1734496335,1734496336,-21600,MacBook
com.google.Chrome,26,1734496309,1734496335,1734496336,-21600,MacBook
com.apple.finder,3,1734496297,1734496300,1734496300,-21600,MacBook
com.apple.Preview,10,1734496287,1734496297,1734496297,-21600,MacBook
com.apple.finder,2,1734496285,1734496287,1734496287,-21600,MacBook
com.google.Chrome,6,1734496279,1734496285,1734496285,-21600,MacBook
com.apple.Preview,10,1734496269,1734496279,1734496279,-21600,MacBook
com.apple.finder,2,1734496267,1734496269,1734496270,-21600,MacBook
com.google.Chrome,42,1734496225,1734496267,1734496268,-21600,MacBook
com.apple.finder,1,1734496224,1734496225,1734496226,-21600,MacBook
com.tencent.xinWeChat,14,1734496210,1734496224,1734496225,-21600,MacBook
com.apple.finder,0,1734496210,1734496210,1734496211,-21600,MacBook
com.tencent.xinWeChat,23,1734496187,1734496210,1734496210,-21600,MacBook
com.apple.finder,1,1734496186,1734496187,1734496188,-21600,MacBook
com.tencent.xinWeChat,2,1734496184,1734496186,1734496187,-21600,MacBook
com.apple.finder,0,1734496184,1734496184,1734496185,-21600,MacBook
com.tencent.xinWeChat,2,1734496182,1734496184,1734496184,-21600,MacBook
com.apple.finder,2,1734496180,1734496182,1734496182,-21600,MacBook
com.tencent.xinWeChat,1,1734496179,1734496180,1734496181,-21600,MacBook
com.google.Chrome,13,1734496166,1734496179,1734496180,-21600,MacBook
com.tencent.xinWeChat,2,1734496164,1734496166,1734496166,-21600,MacBook
com.apple.finder,6,1734496158,1734496164,1734496165,-21600,MacBook
com.tencent.xinWeChat,0,1734496158,1734496158,1734496159,-21600,MacBook
com.apple.Preview,27,1734496131,1734496158,1734496158,-21600,MacBook
com.tencent.xinWeChat,1,1734496130,1734496131,1734496132,-21600,MacBook
com.apple.finder,1,1734496129,1734496130,1734496130,-21600,MacBook
com.tencent.xinWeChat,2,1734496127,1734496129,1734496129,-21600,MacBook
com.apple.finder,1,1734496126,1734496127,1734496128,-21600,MacBook
com.tencent.xinWeChat,28,1734496098,1734496126,1734496127,-21600,MacBook
com.apple.finder,0,1734496098,1734496098,1734496099,-21600,MacBook
com.tencent.xinWeChat,1,1734496097,1734496098,1734496098,-21600,MacBook
com.apple.finder,3,1734496094,1734496097,1734496097,-21600,MacBook
com.tencent.xinWeChat,6,1734496088,1734496094,1734496095,-21600,MacBook
com.apple.finder,13,1734496075,1734496088,1734496088,-21600,MacBook
com.google.Chrome,7,1734496068,1734496075,1734496076,-21600,MacBook
com.apple.finder,2,1734496066,1734496068,1734496068,-21600,MacBook
com.microsoft.Outlook,2,1734496064,1734496066,1734496067,-21600,MacBook
com.apple.finder,0,1734496064,1734496064,1734496065,-21600,MacBook
com.microsoft.Outlook,1,1734496063,1734496064,1734496064,-21600,MacBook
com.apple.finder,52,1734496011,1734496063,1734496064,-21600,MacBook
com.apple.Preview,0,1734496011,1734496011,1734496012,-21600,MacBook
com.apple.finder,17,1734495994,1734496011,1734496011,-21600,MacBook
com.microsoft.Outlook,16,1734495978,1734495994,1734495995,-21600,MacBook
com.apple.Preview,10,1734495968,1734495978,1734495979,-21600,MacBook
com.apple.finder,1,1734495967,1734495968,1734495968,-21600,MacBook
com.apple.Preview,0,1734495967,1734495967,1734495968,-21600,MacBook
com.microsoft.Outlook,3,1734495964,1734495967,1734495967,-21600,MacBook
com.apple.finder,2,1734495962,1734495964,1734495964,-21600,MacBook
com.apple.Preview,1,1734495961,1734495962,1734495963,-21600,MacBook
com.apple.finder,4,1734495957,1734495961,1734495961,-21600,MacBook
com.apple.Preview,4,1734495953,1734495957,1734495957,-21600,MacBook
com.apple.finder,3,1734495950,1734495953,1734495953,-21600,MacBook
com.microsoft.Outlook,4,1734495946,1734495950,1734495951,-21600,MacBook
com.tencent.xinWeChat,274,1734495672,1734495946,1734495947,-21600,MacBook
com.apple.Notes,10,1734495662,1734495672,1734495673,-21600,MacBook
com.tencent.xinWeChat,10,1734495652,1734495662,1734495662,-21600,MacBook
com.apple.Notes,493,1734495159,1734495652,1734495653,-21600,MacBook
com.tencent.xinWeChat,131,1734495028,1734495159,1734495160,-21600,MacBook
com.apple.finder,4,1734495024,1734495028,1734495028,-21600,MacBook
us.zoom.xos,6,1734495018,1734495024,1734495025,-21600,MacBook
com.apple.finder,0,1734495018,1734495018,1734495019,-21600,MacBook
us.zoom.xos,2,1734495016,1734495018,1734495018,-21600,MacBook
com.apple.finder,0,1734495016,1734495016,1734495017,-21600,MacBook
us.zoom.xos,16,1734495000,1734495016,1734495017,-21600,MacBook
com.apple.finder,1,1734494999,1734495000,1734495000,-21600,MacBook
us.zoom.xos,22,1734494977,1734494999,1734494999,-21600,MacBook
com.apple.finder,1,1734494976,1734494977,1734494977,-21600,MacBook
us.zoom.xos,1,1734494975,1734494976,1734494976,-21600,MacBook
com.apple.finder,1,1734494974,1734494975,1734494975,-21600,MacBook
us.zoom.xos,1,1734494973,1734494974,1734494975,-21600,MacBook
com.apple.finder,1,1734494972,1734494973,1734494973,-21600,MacBook
us.zoom.xos,0,1734494972,1734494972,1734494973,-21600,MacBook
com.apple.Preview,13,1734494959,1734494972,1734494972,-21600,MacBook
com.apple.finder,1,1734494958,1734494959,1734494959,-21600,MacBook
com.apple.Preview,6,1734494952,1734494958,1734494959,-21600,MacBook
com.apple.finder,1,1734494951,1734494952,1734494953,-21600,MacBook
com.apple.Preview,2,1734494949,1734494951,1734494952,-21600,MacBook
com.apple.finder,1,1734494948,1734494949,1734494949,-21600,MacBook
com.apple.Preview,5,1734494943,1734494948,1734494949,-21600,MacBook
com.apple.finder,1,1734494942,1734494943,1734494943,-21600,MacBook
com.apple.Preview,1,1734494941,1734494942,1734494943,-21600,MacBook
com.apple.finder,2,1734494939,1734494941,1734494941,-21600,MacBook
us.zoom.xos,10,1734494929,1734494939,1734494940,-21600,MacBook
com.apple.Notes,1,1734494928,1734494929,1734494930,-21600,MacBook
us.zoom.xos,3,1734494925,1734494928,1734494929,-21600,MacBook
com.apple.finder,1,1734494924,1734494925,1734494926,-21600,MacBook
com.apple.Preview,9,1734494915,1734494924,1734494924,-21600,MacBook
com.apple.finder,1,1734494914,1734494915,1734494916,-21600,MacBook
com.apple.Preview,2,1734494912,1734494914,1734494915,-21600,MacBook
com.apple.finder,3,1734494909,1734494912,1734494913,-21600,MacBook
com.apple.Notes,2,1734494907,1734494909,1734494910,-21600,MacBook
com.google.Chrome,10,1734494897,1734494907,1734494908,-21600,MacBook
com.apple.Notes,1,1734494896,1734494897,1734494898,-21600,MacBook
us.zoom.xos,4,1734494892,1734494896,1734494897,-21600,MacBook
com.apple.Notes,1,1734494891,1734494892,1734494892,-21600,MacBook
us.zoom.xos,11,1734494880,1734494891,1734494891,-21600,MacBook
com.google.Chrome,6,1734494874,1734494880,1734494881,-21600,MacBook
us.zoom.xos,2,1734494872,1734494874,1734494875,-21600,MacBook
com.apple.Notes,1,1734494871,1734494872,1734494872,-21600,MacBook
us.zoom.xos,6,1734494865,1734494871,1734494872,-21600,MacBook
com.google.Chrome,10,1734494855,1734494865,1734494866,-21600,MacBook
us.zoom.xos,2,1734494853,1734494855,1734494856,-21600,MacBook
com.google.Chrome,44,1734494809,1734494853,1734494854,-21600,MacBook
us.zoom.xos,11,1734494798,1734494809,1734494810,-21600,MacBook
com.apple.Preview,203,1734494595,1734494798,1734494799,-21600,MacBook
us.zoom.xos,5,1734494590,1734494595,1734494595,-21600,MacBook
com.apple.Preview,13,1734494577,1734494590,1734494590,-21600,MacBook
com.apple.finder,2,1734494575,1734494577,1734494577,-21600,MacBook
com.apple.Preview,59,1734494516,1734494575,1734494576,-21600,MacBook
com.apple.finder,3,1734494513,1734494516,1734494516,-21600,MacBook
us.zoom.xos,53,1734494460,1734494513,1734494513,-21600,MacBook
com.apple.finder,2,1734494458,1734494460,1734494461,-21600,MacBook
us.zoom.xos,3,1734494455,1734494458,1734494458,-21600,MacBook
com.apple.Preview,3,1734494452,1734494455,1734494456,-21600,MacBook
us.zoom.xos,0,1734494452,1734494452,1734494453,-21600,MacBook
us.zoom.xos,301,1734494077,1734494378,1734494378,-21600,MacBook
com.microsoft.Office.Outlook,22,1734494216,1734494238,1734494238,-21600,iPhone
com.apple.MobileSMS,20,1734494196,1734494216,1734494217,-21600,iPhone
com.apple.MobileSMS,12,1734494184,1734494196,1734494197,-21600,iPhone
com.netease.cloudmusic,3,1734494180,1734494183,1734494184,-21600,iPhone
com.apple.Preview,4,1734494073,1734494077,1734494077,-21600,MacBook
us.zoom.xos,19,1734494054,1734494073,1734494073,-21600,MacBook
com.apple.Preview,6,1734494048,1734494054,1734494055,-21600,MacBook
com.google.Chrome,8,1734494040,1734494048,1734494049,-21600,MacBook
com.apple.Preview,1,1734494039,1734494040,1734494040,-21600,MacBook
com.tencent.xinWeChat,6,1734494033,1734494039,1734494039,-21600,MacBook
com.apple.Preview,40,1734493993,1734494033,1734494034,-21600,MacBook
us.zoom.xos,1,1734493992,1734493993,1734493994,-21600,MacBook
com.apple.Preview,1,1734493991,1734493992,1734493993,-21600,MacBook
us.zoom.xos,1,1734493990,1734493991,1734493992,-21600,MacBook
com.apple.Preview,112,1734493878,1734493990,1734493991,-21600,MacBook
us.zoom.xos,4,1734493874,1734493878,1734493878,-21600,MacBook
com.apple.Preview,12,1734493862,1734493874,1734493875,-21600,MacBook
com.google.Chrome,5,1734493857,1734493862,1734493863,-21600,MacBook
com.apple.Preview,3,1734493854,1734493857,1734493857,-21600,MacBook
us.zoom.xos,1,1734493853,1734493854,1734493855,-21600,MacBook
com.apple.Preview,2,1734493851,1734493853,1734493853,-21600,MacBook
com.tencent.xinWeChat,33,1734493818,1734493851,1734493852,-21600,MacBook
com.apple.Preview,153,1734493665,1734493818,1734493818,-21600,MacBook
us.zoom.xos,10,1734493655,1734493665,1734493666,-21600,MacBook
com.apple.Preview,138,1734493517,1734493655,1734493656,-21600,MacBook
us.zoom.xos,4,1734493513,1734493517,1734493517,-21600,MacBook
com.apple.Preview,688,1734492825,1734493513,1734493513,-21600,MacBook
us.zoom.xos,5,1734492820,1734492825,1734492825,-21600,MacBook
com.apple.Preview,8,1734492812,1734492820,1734492821,-21600,MacBook
us.zoom.xos,77,1734492735,1734492812,1734492812,-21600,MacBook
com.apple.Preview,8,1734492727,1734492735,1734492736,-21600,MacBook
us.zoom.xos,0,1734492727,1734492727,1734492728,-21600,MacBook
com.apple.Preview,10,1734492717,1734492727,1734492727,-21600,MacBook
us.zoom.xos,38,1734492679,1734492717,1734492717,-21600,MacBook
com.apple.Preview,19,1734492660,1734492679,1734492680,-21600,MacBook
us.zoom.xos,2,1734492658,1734492660,1734492660,-21600,MacBook
com.apple.Preview,4,1734492654,1734492658,1734492659,-21600,MacBook
us.zoom.xos,33,1734492621,1734492654,1734492654,-21600,MacBook
com.apple.Preview,5,1734492616,1734492621,1734492621,-21600,MacBook
us.zoom.xos,4,1734492612,1734492616,1734492616,-21600,MacBook
com.apple.Preview,2,1734492610,1734492612,1734492613,-21600,MacBook
us.zoom.xos,9,1734492601,1734492610,1734492611,-21600,MacBook
com.apple.Preview,80,1734492521,1734492601,1734492602,-21600,MacBook
us.zoom.xos,2,1734492519,1734492521,1734492521,-21600,MacBook
com.apple.Preview,3,1734492516,1734492519,1734492519,-21600,MacBook
us.zoom.xos,8,1734492508,1734492516,1734492516,-21600,MacBook
com.apple.Preview,33,1734492475,1734492508,1734492509,-21600,MacBook
us.zoom.xos,8,1734492467,1734492475,1734492475,-21600,MacBook
com.apple.Preview,23,1734492444,1734492467,1734492468,-21600,MacBook
com.apple.finder,3,1734492441,1734492444,1734492445,-21600,MacBook
us.zoom.xos,4,1734492437,1734492441,1734492442,-21600,MacBook
com.apple.Notes,8,1734492429,1734492437,1734492438,-21600,MacBook
com.apple.Notes,337,1734491965,1734492302,1734492302,-21600,MacBook
com.apple.Preview,10,1734491955,1734491965,1734491966,-21600,MacBook
com.apple.Notes,18,1734491937,1734491955,1734491955,-21600,MacBook
com.apple.Preview,12,1734491925,1734491937,1734491938,-21600,MacBook
com.apple.Notes,29,1734491896,1734491925,1734491926,-21600,MacBook
com.apple.Preview,603,1734491293,1734491896,1734491897,-21600,MacBook
us.zoom.xos,7,1734491286,1734491293,1734491293,-21600,MacBook
com.apple.Notes,2,1734491284,1734491286,1734491287,-21600,MacBook
com.apple.Preview,11,1734491273,1734491284,1734491285,-21600,MacBook
com.apple.finder,1,1734491272,1734491273,1734491274,-21600,MacBook
com.apple.Preview,4,1734491268,1734491272,1734491273,-21600,MacBook
com.apple.finder,2,1734491266,1734491268,1734491268,-21600,MacBook
com.apple.Preview,5,1734491261,1734491266,1734491267,-21600,MacBook
us.zoom.xos,5,1734491256,1734491261,1734491262,-21600,MacBook
com.apple.Preview,52,1734491204,1734491256,1734491257,-21600,MacBook
us.zoom.xos,9,1734491195,1734491204,1734491205,-21600,MacBook
com.apple.Preview,2,1734491193,1734491195,1734491196,-21600,MacBook
us.zoom.xos,3,1734491190,1734491193,1734491193,-21600,MacBook
com.apple.Preview,5,1734491185,1734491190,1734491190,-21600,MacBook
com.apple.finder,1,1734491184,1734491185,1734491186,-21600,MacBook
us.zoom.xos,4,1734491180,1734491184,1734491184,-21600,MacBook
com.apple.finder,3,1734491177,1734491180,1734491180,-21600,MacBook
us.zoom.xos,3,1734491174,1734491177,1734491178,-21600,MacBook
com.apple.finder,1,1734491173,1734491174,1734491175,-21600,MacBook
us.zoom.xos,3,1734491170,1734491173,1734491173,-21600,MacBook
com.apple.finder,8,1734491162,1734491170,1734491171,-21600,MacBook
us.zoom.xos,1,1734491161,1734491162,1734491163,-21600,MacBook
com.apple.Preview,1,1734491160,1734491161,1734491161,-21600,MacBook
com.apple.finder,2,1734491158,1734491160,1734491161,-21600,MacBook
com.google.Chrome,24,1734491134,1734491158,1734491159,-21600,MacBook
com.apple.finder,1,1734491133,1734491134,1734491135,-21600,MacBook
com.google.Chrome,323,1734490810,1734491133,1734491134,-21600,MacBook
com.apple.finder,1,1734490809,1734490810,1734490811,-21600,MacBook
com.apple.Preview,36,1734490773,1734490809,1734490810,-21600,MacBook
com.apple.finder,1,1734490772,1734490773,1734490774,-21600,MacBook
com.apple.Preview,36,1734490736,1734490772,1734490772,-21600,MacBook
com.apple.finder,2,1734490734,1734490736,1734490737,-21600,MacBook
com.apple.Preview,21,1734490713,1734490734,1734490735,-21600,MacBook
com.apple.finder,2,1734490711,1734490713,1734490714,-21600,MacBook
com.apple.Preview,27,1734490684,1734490711,1734490711,-21600,MacBook
com.apple.finder,4,1734490680,1734490684,1734490684,-21600,MacBook
com.apple.Preview,101,1734490579,1734490680,1734490681,-21600,MacBook
com.apple.finder,2,1734490577,1734490579,1734490580,-21600,MacBook
com.apple.Preview,2,1734490575,1734490577,1734490577,-21600,MacBook
com.apple.finder,3,1734490572,1734490575,1734490575,-21600,MacBook
com.apple.Preview,51,1734490521,1734490572,1734490573,-21600,MacBook
com.apple.Notes,152,1734490369,1734490521,1734490521,-21600,MacBook
com.apple.Preview,23,1734490346,1734490369,1734490370,-21600,MacBook
com.apple.Notes,1,1734490345,1734490346,1734490347,-21600,MacBook
com.apple.Preview,0,1734490345,1734490345,1734490346,-21600,MacBook
com.apple.Notes,2,1734490343,1734490345,1734490345,-21600,MacBook
com.apple.finder,32,1734490311,1734490343,1734490344,-21600,MacBook
us.zoom.xos,0,1734490311,1734490311,1734490312,-21600,MacBook
com.apple.finder,2,1734490309,1734490311,1734490311,-21600,MacBook
us.zoom.xos,1,1734490308,1734490309,1734490310,-21600,MacBook
com.apple.finder,6,1734490302,1734490308,1734490309,-21600,MacBook
com.apple.Preview,2,1734490300,1734490302,1734490302,-21600,MacBook
com.google.Chrome,21,1734490279,1734490300,1734490301,-21600,MacBook
com.apple.Preview,5,1734490274,1734490279,1734490280,-21600,MacBook
com.google.Chrome,78,1734490196,1734490274,1734490275,-21600,MacBook
com.apple.Preview,417,1734489779,1734490196,1734490197,-21600,MacBook
com.apple.Notes,4,1734489775,1734489779,1734489779,-21600,MacBook
com.apple.Preview,1,1734489774,1734489775,1734489776,-21600,MacBook
com.apple.Notes,1,1734489773,1734489774,1734489774,-21600,MacBook
com.apple.Preview,8,1734489765,1734489773,1734489773,-21600,MacBook
com.apple.Notes,2,1734489763,1734489765,1734489766,-21600,MacBook
com.apple.Preview,247,1734489516,1734489763,1734489764,-21600,MacBook
com.apple.Notes,3,1734489513,1734489516,1734489517,-21600,MacBook
com.apple.Preview,6,1734489507,1734489513,1734489513,-21600,MacBook
com.apple.Notes,23,1734489484,1734489507,1734489507,-21600,MacBook
com.apple.Preview,36,1734489448,1734489484,1734489484,-21600,MacBook
com.microsoft.Outlook,19,1734489429,1734489448,1734489448,-21600,MacBook
com.apple.Notes,6,1734489423,1734489429,1734489430,-21600,MacBook
com.apple.Preview,3,1734489420,1734489423,1734489424,-21600,MacBook
com.apple.Notes,3,1734489417,1734489420,1734489420,-21600,MacBook
com.microsoft.Outlook,28,1734489389,1734489417,1734489418,-21600,MacBook
com.apple.Preview,191,1734489198,1734489389,1734489390,-21600,MacBook
com.apple.Notes,3,1734489195,1734489198,1734489198,-21600,MacBook
com.apple.Preview,1,1734489194,1734489195,1734489196,-21600,MacBook
com.apple.Notes,2,1734489192,1734489194,1734489195,-21600,MacBook
com.apple.Preview,82,1734489110,1734489192,1734489193,-21600,MacBook
com.apple.Notes,18,1734489092,1734489110,1734489110,-21600,MacBook
com.apple.Preview,1,1734489091,1734489092,1734489093,-21600,MacBook
com.apple.Notes,1,1734489090,1734489091,1734489091,-21600,MacBook
com.apple.Preview,12,1734489078,1734489090,1734489091,-21600,MacBook
com.apple.Notes,23,1734489055,1734489078,1734489078,-21600,MacBook
com.apple.Preview,69,1734488986,1734489055,1734489056,-21600,MacBook
com.apple.Notes,13,1734488973,1734488986,1734488987,-21600,MacBook
com.apple.Preview,1,1734488972,1734488973,1734488974,-21600,MacBook
com.apple.Notes,23,1734488949,1734488972,1734488973,-21600,MacBook
com.apple.Preview,6,1734488943,1734488949,1734488950,-21600,MacBook
com.apple.Notes,25,1734488918,1734488943,1734488944,-21600,MacBook
com.apple.Preview,34,1734488884,1734488918,1734488919,-21600,MacBook
com.apple.Notes,40,1734488844,1734488884,1734488885,-21600,MacBook
com.apple.Preview,7,1734488837,1734488844,1734488844,-21600,MacBook
com.apple.Notes,36,1734488801,1734488837,1734488837,-21600,MacBook
com.apple.Preview,13,1734488788,1734488801,1734488802,-21600,MacBook
com.apple.Notes,18,1734488770,1734488788,1734488788,-21600,MacBook
com.apple.Preview,37,1734488733,1734488770,1734488770,-21600,MacBook
com.apple.Notes,20,1734488713,1734488733,1734488734,-21600,MacBook
com.apple.Preview,3,1734488710,1734488713,1734488713,-21600,MacBook
com.apple.Notes,1,1734488709,1734488710,1734488711,-21600,MacBook
com.apple.Preview,1,1734488708,1734488709,1734488709,-21600,MacBook
com.apple.finder,0,1734488708,1734488708,1734488709,-21600,MacBook
com.apple.Preview,6,1734488702,1734488708,1734488708,-21600,MacBook
com.apple.Notes,1,1734488701,1734488702,1734488702,-21600,MacBook
com.apple.Preview,2,1734488699,1734488701,1734488701,-21600,MacBook
com.apple.Notes,7,1734488692,1734488699,1734488699,-21600,MacBook
com.apple.Preview,4,1734488688,1734488692,1734488692,-21600,MacBook
com.apple.Notes,2,1734488686,1734488688,1734488689,-21600,MacBook
com.apple.Preview,78,1734488608,1734488686,1734488687,-21600,MacBook
com.apple.Notes,3,1734488605,1734488608,1734488609,-21600,MacBook
com.apple.Preview,9,1734488596,1734488605,1734488605,-21600,MacBook
us.zoom.xos,3,1734488593,1734488596,1734488597,-21600,MacBook
com.apple.Preview,20,1734488573,1734488593,1734488593,-21600,MacBook
us.zoom.xos,5,1734488568,1734488573,1734488574,-21600,MacBook
com.apple.Preview,4,1734488564,1734488568,1734488569,-21600,MacBook
us.zoom.xos,1,1734488563,1734488564,1734488565,-21600,MacBook
com.apple.Preview,1,1734488562,1734488563,1734488564,-21600,MacBook
us.zoom.xos,2,1734488560,1734488562,1734488563,-21600,MacBook
com.apple.Preview,2,1734488558,1734488560,1734488561,-21600,MacBook
us.zoom.xos,6,1734488552,1734488558,1734488559,-21600,MacBook
com.apple.Preview,3,1734488549,1734488552,1734488552,-21600,MacBook
us.zoom.xos,6,1734488543,1734488549,1734488549,-21600,MacBook
com.apple.Preview,154,1734488389,1734488543,1734488544,-21600,MacBook
com.apple.Notes,13,1734488376,1734488389,1734488390,-21600,MacBook
com.apple.finder,1,1734488375,1734488376,1734488377,-21600,MacBook
com.apple.Notes,3,1734488372,1734488375,1734488376,-21600,MacBook
com.apple.finder,1,1734488371,1734488372,1734488373,-21600,MacBook
com.apple.Preview,1,1734488370,1734488371,1734488372,-21600,MacBook
us.zoom.xos,2,1734488368,1734488370,1734488370,-21600,MacBook
com.apple.Preview,21,1734488347,1734488368,1734488368,-21600,MacBook
us.zoom.xos,2,1734488345,1734488347,1734488347,-21600,MacBook
com.apple.Preview,4,1734488341,1734488345,1734488345,-21600,MacBook
us.zoom.xos,15,1734488326,1734488341,1734488342,-21600,MacBook
com.apple.Preview,4,1734488322,1734488326,1734488327,-21600,MacBook
us.zoom.xos,9,1734488313,1734488322,1734488322,-21600,MacBook
com.apple.Preview,13,1734488300,1734488313,1734488314,-21600,MacBook
us.zoom.xos,263,1734488037,1734488300,1734488300,-21600,MacBook
com.apple.Preview,13,1734488024,1734488037,1734488038,-21600,MacBook
us.zoom.xos,3,1734488021,1734488024,1734488025,-21600,MacBook
com.apple.Preview,10,1734488011,1734488021,1734488022,-21600,MacBook
us.zoom.xos,7,1734488004,1734488011,1734488011,-21600,MacBook
com.apple.Preview,4,1734488000,1734488004,1734488005,-21600,MacBook
us.zoom.xos,21,1734487979,1734488000,1734488001,-21600,MacBook
com.apple.Preview,8,1734487971,1734487979,1734487980,-21600,MacBook
com.apple.finder,1,1734487970,1734487971,1734487972,-21600,MacBook
us.zoom.xos,7,1734487963,1734487970,1734487971,-21600,MacBook
com.apple.finder,6,1734487957,1734487963,1734487964,-21600,MacBook
us.zoom.xos,32,1734487925,1734487957,1734487957,-21600,MacBook
com.google.Chrome,1,1734487924,1734487925,1734487926,-21600,MacBook
us.zoom.xos,77,1734487847,1734487924,1734487924,-21600,MacBook
com.google.Chrome,4,1734487843,1734487847,1734487847,-21600,MacBook
us.zoom.xos,543,1734487300,1734487843,1734487844,-21600,MacBook
com.netease.cloudmusic,2,1734487555,1734487557,1734487557,-21600,iPhone
com.netease.cloudmusic,79,1734487394,1734487473,1734487474,-21600,iPhone
com.google.chrome.ios,8,1734487385,1734487393,1734487394,-21600,iPhone
com.netease.cloudmusic,9,1734487375,1734487384,1734487385,-21600,iPhone
com.microsoft.Outlook,2,1734487298,1734487300,1734487301,-21600,MacBook
us.zoom.xos,125,1734487173,1734487298,1734487299,-21600,MacBook
com.google.Chrome,2,1734487171,1734487173,1734487173,-21600,MacBook
us.zoom.xos,1,1734487170,1734487171,1734487172,-21600,MacBook
com.google.Chrome,0,1734487170,1734487170,1734487170,-21600,MacBook
com.microsoft.Outlook,5,1734487165,1734487170,1734487170,-21600,MacBook
us.zoom.xos,4,1734487161,1734487165,1734487166,-21600,MacBook
com.microsoft.Outlook,1,1734487160,1734487161,1734487162,-21600,MacBook
com.google.Chrome,1,1734487159,1734487160,1734487161,-21600,MacBook
com.microsoft.Outlook,18,1734487141,1734487159,1734487160,-21600,MacBook
com.apple.finder,1,1734487140,1734487141,1734487141,-21600,MacBook
com.google.Chrome,9,1734487131,1734487140,1734487140,-21600,MacBook
com.google.Chrome,31,1734486926,1734486957,1734486957,-21600,MacBook
com.apple.finder,60,1734486558,1734486618,1734486619,-21600,MacBook
com.apple.mobiletimer,7,1734486531,1734486538,1734486539,-21600,iPhone
com.apple.mobiletimer,2,1734486447,1734486449,1734486449,-21600,iPhone
com.apple.mobiletimer,7,1734486013,1734486020,1734486021,-21600,iPhone
com.microsoft.Office.Outlook,4,1734486009,1734486013,1734486013,-21600,iPhone
com.apple.mobiletimer,6,1734486003,1734486009,1734486009,-21600,iPhone
com.microsoft.Office.Outlook,1,1734486000,1734486001,1734486002,-21600,iPhone
com.apple.mobiletimer,4,1734485996,1734486000,1734486001,-21600,iPhone
com.apple.mobiletimer,10,1734485711,1734485721,1734485721,-21600,iPhone
com.apple.mobiletimer,10,1734485400,1734485410,1734485411,-21600,iPhone
com.apple.mobiletimer,5,1734485168,1734485173,1734485173,-21600,iPhone
com.netease.cloudmusic,2,1734484376,1734484378,1734484379,-21600,iPhone
com.netease.cloudmusic,51,1734483004,1734483055,1734483056,-21600,iPhone
com.netease.cloudmusic,2,1734482861,1734482863,1734482863,-21600,iPhone
com.netease.cloudmusic,1,1734482857,1734482858,1734482859,-21600,iPhone
com.netease.cloudmusic,177,1734482679,1734482856,1734482856,-21600,iPhone
com.netease.cloudmusic,4,1734482674,1734482678,1734482678,-21600,iPhone
com.netease.cloudmusic,5,1734482659,1734482664,1734482665,-21600,iPhone
com.netease.cloudmusic,33,1734482421,1734482454,1734482455,-21600,iPhone
com.microsoft.Office.Outlook,4,1734482413,1734482417,1734482418,-21600,iPhone
com.microsoft.Office.Outlook,22,1734482389,1734482411,1734482412,-21600,iPhone
com.apple.mobiletimer,6,1734482383,1734482389,1734482390,-21600,iPhone
com.apple.finder,2,1734481592,1734481594,1734481595,-21600,MacBook
com.tencent.xinWeChat,10,1734481582,1734481592,1734481593,-21600,MacBook
com.google.Chrome,505,1734481077,1734481582,1734481583,-21600,MacBook
com.google.Chrome,1258,1734479709,1734480967,1734480968,-21600,MacBook
com.google.Chrome,1418,1734477900,1734479318,1734479318,-21600,MacBook
com.apple.mobiletimer,5,1734478170,1734478175,1734478176,-21600,iPhone
com.apple.mobiletimer,4,1734477626,1734477630,1734477631,-21600,iPhone
com.tencent.xin,12,1734476828,1734476840,1734476841,-21600,iPhone
com.netease.cloudmusic,41,1734476784,1734476825,1734476826,-21600,iPhone
com.google.Chrome,303,1734476510,1734476813,1734476814,-21600,MacBook
com.tencent.weread,13,1734476769,1734476782,1734476783,-21600,iPhone
com.microsoft.Office.Outlook,1,1734476768,1734476769,1734476770,-21600,iPhone
com.apple.AppStore,9,1734476759,1734476768,1734476768,-21600,iPhone
com.apple.Preferences,16,1734476743,1734476759,1734476760,-21600,iPhone
com.tencent.xin,25,1734476715,1734476740,1734476741,-21600,iPhone
com.tencent.xin,197,1734476518,1734476715,1734476716,-21600,iPhone
com.apple.mobiletimer,2,1734476515,1734476517,1734476518,-21600,iPhone
com.apple.mobiletimer,13,1734476428,1734476441,1734476441,-21600,iPhone
com.google.Chrome,377,1734476058,1734476435,1734476435,-21600,MacBook
com.apple.mobiletimer,25,1734476400,1734476425,1734476426,-21600,iPhone
com.apple.finder,1,1734476057,1734476058,1734476059,-21600,MacBook
com.tencent.xinWeChat,0,1734476057,1734476057,1734476058,-21600,MacBook
com.apple.finder,1,1734476056,1734476057,1734476057,-21600,MacBook
com.tencent.xinWeChat,5,1734476051,1734476056,1734476057,-21600,MacBook
com.google.Chrome,344,1734475707,1734476051,1734476051,-21600,MacBook
com.tencent.xinWeChat,13,1734475694,1734475707,1734475708,-21600,MacBook
com.google.Chrome,48,1734475646,1734475694,1734475695,-21600,MacBook
com.google.Chrome,303,1734475094,1734475397,1734475397,-21600,MacBook
com.google.Chrome,413,1734474600,1734475013,1734475013,-21600,MacBook
com.apple.mobiletimer,3,1734474629,1734474632,1734474633,-21600,iPhone
com.tencent.xinWeChat,27,1734474573,1734474600,1734474601,-21600,MacBook
com.apple.finder,1,1734474572,1734474573,1734474573,-21600,MacBook
com.tencent.xinWeChat,4,1734474568,1734474572,1734474572,-21600,MacBook
com.google.Chrome,12,1734474556,1734474568,1734474568,-21600,MacBook
com.tencent.xinWeChat,27,1734474529,1734474556,1734474557,-21600,MacBook
com.apple.finder,1,1734474528,1734474529,1734474530,-21600,MacBook
com.google.Chrome,2,1734474526,1734474528,1734474529,-21600,MacBook
com.adobe.acc.AdobeCreativeCloud,1,1734474525,1734474526,1734474527,-21600,MacBook
com.google.Chrome,1,1734474524,1734474525,1734474525,-21600,MacBook
com.adobe.acc.AdobeCreativeCloud,0,1734474524,1734474524,1734474525,-21600,MacBook
com.google.Chrome,17,1734474507,1734474524,1734474525,-21600,MacBook
com.apple.finder,236,1734474271,1734474507,1734474507,-21600,MacBook
com.microsoft.Outlook,16,1734474255,1734474271,1734474272,-21600,MacBook
com.google.Chrome,533,1734473722,1734474255,1734474255,-21600,MacBook
com.google.Chrome,309,1734473141,1734473450,1734473450,-21600,MacBook
com.netease.cloudmusic,4,1734473274,1734473278,1734473279,-21600,iPhone
com.google.Chrome,459,1734472114,1734472573,1734472573,-21600,MacBook
com.netease.cloudmusic,10,1734471894,1734471904,1734471904,-21600,iPhone
com.google.Chrome,336,1734471538,1734471874,1734471875,-21600,MacBook
com.google.Chrome,304,1734470099,1734470403,1734470404,-21600,MacBook
com.google.Chrome,312,1734469710,1734470022,1734470023,-21600,MacBook
com.netease.cloudmusic,8,1734469846,1734469854,1734469855,-21600,iPhone
com.apple.mobiletimer,3,1734469841,1734469844,1734469845,-21600,iPhone
com.google.chrome.ios,3,1734469837,1734469840,1734469840,-21600,iPhone
com.apple.finder,309,1734469401,1734469710,1734469711,-21600,MacBook
com.google.Chrome,3,1734469398,1734469401,1734469401,-21600,MacBook
com.google.Chrome,413,1734468169,1734468582,1734468582,-21600,MacBook
com.google.Chrome,683,1734466472,1734467155,1734467156,-21600,MacBook
com.google.Chrome,917,1734465052,1734465969,1734465969,-21600,MacBook
com.apple.finder,43,1734465009,1734465052,1734465053,-21600,MacBook
com.google.chrome.ios,18,1734463621,1734463639,1734463641,-21600,iPhone
com.microsoft.Office.Outlook,7,1734463614,1734463621,1734463622,-21600,iPhone
com.google.chrome.ios,2,1734463612,1734463614,1734463615,-21600,iPhone
com.microsoft.Office.Outlook,10,1734463602,1734463612,1734463613,-21600,iPhone
com.microsoft.Office.Outlook,9,1734463592,1734463601,1734463602,-21600,iPhone
com.microsoft.Office.Outlook,1,1734463590,1734463591,1734463591,-21600,iPhone
com.naver.linewebtoon,7,1734463583,1734463590,1734463591,-21600,iPhone
com.naver.linewebtoon,10,1734462242,1734462252,1734462253,-21600,iPhone
com.naver.linewebtoon,10,1734456681,1734456691,1734456692,-21600,iPhone
com.naver.linewebtoon,10,1734456600,1734456610,1734456611,-21600,iPhone
com.naver.linewebtoon,10,1734456433,1734456443,1734456443,-21600,iPhone
com.naver.linewebtoon,32,1734456138,1734456170,1734456171,-21600,iPhone
com.bilibili.bilicomic,1,1734456137,1734456138,1734456138,-21600,iPhone
com.apple.mobiletimer,33,1734456098,1734456131,1734456131,-21600,iPhone
com.xingin.discover,3,1734456072,1734456075,1734456075,-21600,iPhone
com.xingin.discover,1,1734456068,1734456069,1734456069,-21600,iPhone
com.xingin.discover,3,1734456058,1734456061,1734456061,-21600,iPhone
com.xingin.discover,10,1734456011,1734456021,1734456022,-21600,iPhone
com.apple.mobiletimer,10,1734456001,1734456011,1734456012,-21600,iPhone
com.xingin.discover,292,1734455709,1734456001,1734456002,-21600,iPhone
com.microsoft.Office.Outlook,4,1734455705,1734455709,1734455709,-21600,iPhone
com.tencent.xin,60,1734455644,1734455704,1734455706,-21600,iPhone
com.apple.Preferences,10,1734455634,1734455644,1734455644,-21600,iPhone
com.tencent.xin,105,1734455527,1734455632,1734455633,-21600,iPhone
com.microsoft.Office.Outlook,38,1734455489,1734455527,1734455528,-21600,iPhone
com.apple.MobileSMS,5,1734455483,1734455488,1734455489,-21600,iPhone
com.tencent.xin,9,1734455471,1734455480,1734455481,-21600,iPhone
com.google.chrome.ios,4,1734455466,1734455470,1734455471,-21600,iPhone
com.tencent.xin,176,1734455290,1734455466,1734455467,-21600,iPhone
com.xfinity.digitalhome,27,1734455262,1734455289,1734455290,-21600,iPhone
com.fobwifi.fobwifi,9,1734455246,1734455255,1734455256,-21600,iPhone
com.google.chrome.ios,37,1734455208,1734455245,1734455245,-21600,iPhone
com.microsoft.Office.Outlook,16,1734455192,1734455208,1734455209,-21600,iPhone
com.google.calendar,7,1734455185,1734455192,1734455193,-21600,iPhone
com.microsoft.Office.Outlook,2,1734455183,1734455185,1734455185,-21600,iPhone
com.tencent.xin,47,1734455135,1734455182,1734455183,-21600,iPhone
com.microsoft.Office.Outlook,49,1734455086,1734455135,1734455136,-21600,iPhone
com.tencent.xin,18,1734455068,1734455086,1734455087,-21600,iPhone
com.tencent.xin,49,1734454800,1734454849,1734454850,-21600,iPhone
com.tencent.xin,13,1734450291,1734450304,1734450304,-21600,iPhone
com.tencent.xin,421,1734443477,1734443898,1734443899,-21600,iPhone
com.microsoft.Office.Outlook,2,1734443475,1734443477,1734443477,-21600,iPhone
com.tencent.xin,1,1734443474,1734443475,1734443476,-21600,iPhone
com.microsoft.Office.Outlook,13,1734443459,1734443472,1734443473,-21600,iPhone
com.xingin.discover,3,1734443456,1734443459,1734443460,-21600,iPhone
com.xingin.discover,1332,1734430515,1734431847,1734431848,-21600,iPhone
com.tencent.xin,192,1734430323,1734430515,1734430516,-21600,iPhone
com.xingin.discover,57,1734430265,1734430322,1734430323,-21600,iPhone
com.xingin.discover,2,1734430251,1734430253,1734430254,-21600,iPhone
com.xingin.discover,6,1734430231,1734430237,1734430237,-21600,iPhone
com.xingin.discover,687,1734429542,1734430229,1734430230,-21600,iPhone
com.apple.mobiletimer,55,1734429482,1734429537,1734429537,-21600,iPhone
com.apple.mobilenotes,2,1734429465,1734429467,1734429467,-21600,iPhone
com.apple.mobilenotes,142,1734429322,1734429464,1734429465,-21600,iPhone
com.tencent.xin,45,1734429275,1734429320,1734429321,-21600,iPhone
com.tencent.xin,143,1734429128,1734429271,1734429272,-21600,iPhone
tv.danmaku.bilianime,10,1734429118,1734429128,1734429128,-21600,iPhone
tv.danmaku.bilianime,100,1734428536,1734428636,1734428637,-21600,iPhone
com.chase,47,1734428489,1734428536,1734428536,-21600,iPhone
com.apple.CoreAuthUI,2,1734428491,1734428493,1734428493,-21600,iPhone
com.microsoft.Office.Outlook,7,1734428481,1734428488,1734428488,-21600,iPhone
tv.danmaku.bilianime,963,1734427518,1734428481,1734428482,-21600,iPhone
com.tencent.xin,69,1734427449,1734427518,1734427518,-21600,iPhone
com.tencent.xin,45,1734427404,1734427449,1734427450,-21600,iPhone
tv.danmaku.bilianime,1267,1734426135,1734427402,1734427403,-21600,iPhone
com.tencent.xin,123,1734426010,1734426133,1734426134,-21600,iPhone
com.netease.cloudmusic,85,1734425921,1734426006,1734426007,-21600,iPhone
com.tencent.xin,2,1734425915,1734425917,1734425918,-21600,iPhone
com.openai.chat,18,1734425897,1734425915,1734425915,-21600,iPhone
com.tencent.xin,18,1734425879,1734425897,1734425898,-21600,iPhone
com.openai.chat,13,1734425866,1734425879,1734425879,-21600,iPhone
com.tencent.xin,16,1734425850,1734425866,1734425866,-21600,iPhone
com.openai.chat,10,1734425840,1734425850,1734425851,-21600,iPhone
com.tencent.xin,24,1734425815,1734425839,1734425840,-21600,iPhone
tv.danmaku.bilianime,72,1734425743,1734425815,1734425816,-21600,iPhone
com.tencent.xin,60,1734425683,1734425743,1734425744,-21600,iPhone
tv.danmaku.bilianime,18,1734425665,1734425683,1734425683,-21600,iPhone
com.tencent.xin,317,1734425345,1734425662,1734425662,-21600,iPhone
com.xingin.discover,406,1734424939,1734425345,1734425345,-21600,iPhone
com.tencent.xin,5,1734424932,1734424937,1734424937,-21600,iPhone
com.tencent.xin,12,1734424920,1734424932,1734424933,-21600,iPhone
com.apple.mobilenotes,33,1734424886,1734424919,1734424920,-21600,iPhone
com.microsoft.Office.Outlook,3,1734424883,1734424886,1734424887,-21600,iPhone
com.microsoft.Office.Outlook,67,1734424816,1734424883,1734424884,-21600,iPhone
com.google.calendar,3,1734424813,1734424816,1734424816,-21600,iPhone
com.microsoft.Office.Outlook,16,1734424797,1734424813,1734424814,-21600,iPhone
com.google.calendar,2,1734424795,1734424797,1734424798,-21600,iPhone
com.bilibili.bilicomic,1,1734424794,1734424795,1734424796,-21600,iPhone
com.microsoft.Office.Outlook,123,1734424671,1734424794,1734424794,-21600,iPhone
com.microsoft.Office.Outlook,39,1734424632,1734424671,1734424671,-21600,iPhone
com.google.calendar,7,1734424623,1734424630,1734424631,-21600,iPhone
com.microsoft.Office.Outlook,4,1734424618,1734424622,1734424623,-21600,iPhone
com.bilibili.bilicomic,9,1734424606,1734424615,1734424615,-21600,iPhone
com.netease.cloudmusic,6,1734424600,1734424606,1734424606,-21600,iPhone
com.apple.mobilenotes,1,1734424595,1734424596,1734424597,-21600,iPhone
com.apple.mobiletimer,3,1734424592,1734424595,1734424595,-21600,iPhone
com.apple.finder,26,1734424545,1734424571,1734424571,-21600,MacBook
com.tencent.xinWeChat,33,1734424512,1734424545,1734424546,-21600,MacBook
com.apple.finder,0,1734424512,1734424512,1734424513,-21600,MacBook
com.google.Chrome,4,1734424508,1734424512,1734424512,-21600,MacBook
com.apple.finder,2,1734424506,1734424508,1734424509,-21600,MacBook
com.tencent.xinWeChat,37,1734424469,1734424506,1734424507,-21600,MacBook
com.apple.finder,1,1734424468,1734424469,1734424469,-21600,MacBook
com.tencent.xinWeChat,13,1734424455,1734424468,1734424469,-21600,MacBook
com.apple.finder,1,1734424454,1734424455,1734424456,-21600,MacBook
com.tencent.xinWeChat,4,1734424450,1734424454,1734424455,-21600,MacBook
com.apple.finder,0,1734424450,1734424450,1734424451,-21600,MacBook
com.tencent.xinWeChat,7,1734424443,1734424450,1734424450,-21600,MacBook
com.apple.finder,0,1734424443,1734424443,1734424444,-21600,MacBook
com.tencent.xinWeChat,6,1734424437,1734424443,1734424443,-21600,MacBook
com.apple.finder,1,1734424436,1734424437,1734424437,-21600,MacBook
com.tencent.xinWeChat,4,1734424432,1734424436,1734424437,-21600,MacBook
com.apple.finder,0,1734424432,1734424432,1734424433,-21600,MacBook
com.tencent.xinWeChat,12,1734424420,1734424432,1734424432,-21600,MacBook
com.apple.finder,1,1734424419,1734424420,1734424421,-21600,MacBook
com.tencent.xinWeChat,2,1734424417,1734424419,1734424420,-21600,MacBook
com.apple.finder,1,1734424416,1734424417,1734424417,-21600,MacBook
com.tencent.xinWeChat,16,1734424400,1734424416,1734424417,-21600,MacBook
com.google.Chrome,37,1734424363,1734424400,1734424400,-21600,MacBook
com.apple.finder,7,1734424356,1734424363,1734424363,-21600,MacBook
com.tencent.xinWeChat,5,1734424351,1734424356,1734424357,-21600,MacBook
com.apple.Notes,5,1734424346,1734424351,1734424352,-21600,MacBook
com.tencent.xinWeChat,3,1734424343,1734424346,1734424346,-21600,MacBook
com.apple.Notes,2,1734424341,1734424343,1734424343,-21600,MacBook
com.tencent.xinWeChat,2,1734424339,1734424341,1734424342,-21600,MacBook
com.apple.Notes,7,1734424332,1734424339,1734424340,-21600,MacBook
com.tencent.xinWeChat,2,1734424330,1734424332,1734424333,-21600,MacBook
com.apple.Notes,3,1734424327,1734424330,1734424331,-21600,MacBook
com.tencent.xinWeChat,3,1734424324,1734424327,1734424328,-21600,MacBook
com.apple.Notes,2,1734424322,1734424324,1734424325,-21600,MacBook
com.tencent.xinWeChat,1,1734424321,1734424322,1734424323,-21600,MacBook
com.apple.Notes,30,1734424291,1734424321,1734424321,-21600,MacBook
com.tencent.xinWeChat,11,1734424280,1734424291,1734424292,-21600,MacBook
com.apple.finder,1,1734424279,1734424280,1734424281,-21600,MacBook
com.tencent.xinWeChat,10,1734424269,1734424279,1734424280,-21600,MacBook
com.apple.Notes,0,1734424269,1734424269,1734424269,-21600,MacBook
com.google.Chrome,2,1734424267,1734424269,1734424269,-21600,MacBook
com.apple.Notes,113,1734424154,1734424267,1734424268,-21600,MacBook
com.apple.finder,0,1734424154,1734424154,1734424155,-21600,MacBook
com.google.Chrome,12,1734424142,1734424154,1734424155,-21600,MacBook
com.apple.finder,1,1734424141,1734424142,1734424143,-21600,MacBook
com.tencent.xinWeChat,11,1734424130,1734424141,1734424141,-21600,MacBook
com.google.Chrome,15,1734424115,1734424130,1734424131,-21600,MacBook
com.tencent.xinWeChat,13,1734424102,1734424115,1734424116,-21600,MacBook
com.apple.finder,1,1734424101,1734424102,1734424102,-21600,MacBook
com.google.Chrome,18,1734424083,1734424101,1734424102,-21600,MacBook
com.tencent.xinWeChat,27,1734424056,1734424083,1734424084,-21600,MacBook
com.apple.finder,0,1734424056,1734424056,1734424057,-21600,MacBook
com.tencent.xinWeChat,3,1734424053,1734424056,1734424056,-21600,MacBook
com.apple.finder,1,1734424052,1734424053,1734424054,-21600,MacBook
com.tencent.xinWeChat,2,1734424050,1734424052,1734424053,-21600,MacBook
com.apple.finder,0,1734424050,1734424050,1734424051,-21600,MacBook
com.tencent.xinWeChat,6,1734424044,1734424050,1734424050,-21600,MacBook
com.apple.finder,0,1734424044,1734424044,1734424045,-21600,MacBook
com.tencent.xinWeChat,3,1734424041,1734424044,1734424044,-21600,MacBook
com.apple.finder,1,1734424040,1734424041,1734424041,-21600,MacBook
com.tencent.xinWeChat,3,1734424037,1734424040,1734424041,-21600,MacBook
com.apple.finder,1,1734424036,1734424037,1734424038,-21600,MacBook
com.tencent.xinWeChat,7,1734424029,1734424036,1734424037,-21600,MacBook
com.apple.finder,0,1734424029,1734424029,1734424030,-21600,MacBook
com.tencent.xinWeChat,6,1734424023,1734424029,1734424029,-21600,MacBook
com.apple.finder,0,1734424023,1734424023,1734424024,-21600,MacBook
com.tencent.xinWeChat,2,1734424021,1734424023,1734424024,-21600,MacBook
com.apple.finder,1,1734424020,1734424021,1734424021,-21600,MacBook
com.tencent.xinWeChat,62,1734423958,1734424020,1734424021,-21600,MacBook
com.apple.finder,1,1734423957,1734423958,1734423958,-21600,MacBook
com.tencent.xinWeChat,31,1734423926,1734423957,1734423958,-21600,MacBook
com.apple.finder,0,1734423926,1734423926,1734423927,-21600,MacBook
com.tencent.xinWeChat,6,1734423920,1734423926,1734423926,-21600,MacBook
com.apple.finder,1,1734423919,1734423920,1734423920,-21600,MacBook
com.tencent.xinWeChat,3,1734423916,1734423919,1734423920,-21600,MacBook
com.apple.finder,1,1734423915,1734423916,1734423916,-21600,MacBook
com.tencent.xinWeChat,32,1734423883,1734423915,1734423916,-21600,MacBook
com.google.Chrome,30,1734423853,1734423883,1734423884,-21600,MacBook
com.tencent.xinWeChat,41,1734423812,1734423853,1734423853,-21600,MacBook
com.google.Chrome,8,1734423804,1734423812,1734423812,-21600,MacBook
com.tencent.xinWeChat,2,1734423802,1734423804,1734423804,-21600,MacBook
com.google.Chrome,17,1734423785,1734423802,1734423803,-21600,MacBook
com.apple.finder,1,1734423784,1734423785,1734423785,-21600,MacBook
com.tencent.xinWeChat,5,1734423779,1734423784,1734423784,-21600,MacBook
com.apple.finder,1,1734423778,1734423779,1734423779,-21600,MacBook
com.tencent.xinWeChat,18,1734423760,1734423778,1734423779,-21600,MacBook
com.google.Chrome,7,1734423753,1734423760,1734423761,-21600,MacBook
com.tencent.xinWeChat,14,1734423739,1734423753,1734423754,-21600,MacBook
com.google.Chrome,66,1734423673,1734423739,1734423740,-21600,MacBook
com.tencent.xinWeChat,1,1734423672,1734423673,1734423674,-21600,MacBook
com.google.Chrome,13,1734423659,1734423672,1734423672,-21600,MacBook
com.tencent.xinWeChat,6,1734423653,1734423659,1734423660,-21600,MacBook
com.apple.finder,5,1734423648,1734423653,1734423654,-21600,MacBook
com.tencent.xinWeChat,6,1734423642,1734423648,1734423649,-21600,MacBook
com.apple.finder,1,1734423641,1734423642,1734423642,-21600,MacBook
com.tencent.xinWeChat,2,1734423639,1734423641,1734423642,-21600,MacBook
com.apple.finder,1,1734423638,1734423639,1734423639,-21600,MacBook
com.tencent.xinWeChat,2,1734423636,1734423638,1734423639,-21600,MacBook
com.apple.finder,10,1734423626,1734423636,1734423636,-21600,MacBook
com.tencent.xinWeChat,10,1734423616,1734423626,1734423627,-21600,MacBook
com.apple.finder,1,1734423615,1734423616,1734423616,-21600,MacBook
com.tencent.xinWeChat,2,1734423613,1734423615,1734423616,-21600,MacBook
com.apple.finder,0,1734423613,1734423613,1734423614,-21600,MacBook
com.tencent.xinWeChat,14,1734423599,1734423613,1734423613,-21600,MacBook
com.apple.finder,1,1734423598,1734423599,1734423600,-21600,MacBook
com.tencent.xinWeChat,3,1734423595,1734423598,1734423599,-21600,MacBook
com.apple.finder,0,1734423595,1734423595,1734423596,-21600,MacBook
com.tencent.xinWeChat,2,1734423593,1734423595,1734423595,-21600,MacBook
com.apple.finder,1,1734423592,1734423593,1734423594,-21600,MacBook
com.tencent.xinWeChat,6,1734423586,1734423592,1734423593,-21600,MacBook
com.apple.finder,1,1734423585,1734423586,1734423587,-21600,MacBook
com.tencent.xinWeChat,8,1734423577,1734423585,1734423586,-21600,MacBook
com.apple.finder,1,1734423576,1734423577,1734423577,-21600,MacBook
com.tencent.xinWeChat,5,1734423571,1734423576,1734423576,-21600,MacBook
com.apple.finder,0,1734423571,1734423571,1734423572,-21600,MacBook
com.tencent.xinWeChat,5,1734423566,1734423571,1734423571,-21600,MacBook
com.apple.finder,1,1734423565,1734423566,1734423567,-21600,MacBook
com.tencent.xinWeChat,4,1734423561,1734423565,1734423566,-21600,MacBook
com.apple.finder,1,1734423560,1734423561,1734423562,-21600,MacBook
com.tencent.xinWeChat,36,1734423524,1734423560,1734423561,-21600,MacBook
com.apple.finder,0,1734423524,1734423524,1734423525,-21600,MacBook
com.tencent.xinWeChat,18,1734423506,1734423524,1734423525,-21600,MacBook
com.apple.finder,1,1734423505,1734423506,1734423506,-21600,MacBook
com.tencent.xinWeChat,20,1734423485,1734423505,1734423506,-21600,MacBook
com.tinyspeck.slackmacgap,21,1734423464,1734423485,1734423486,-21600,MacBook
com.tencent.xinWeChat,2,1734423462,1734423464,1734423464,-21600,MacBook
com.tinyspeck.slackmacgap,1,1734423461,1734423462,1734423463,-21600,MacBook
com.tencent.xinWeChat,1,1734423460,1734423461,1734423462,-21600,MacBook
com.tinyspeck.slackmacgap,1,1734423459,1734423460,1734423460,-21600,MacBook
com.tencent.xinWeChat,1,1734423458,1734423459,1734423460,-21600,MacBook
com.google.Chrome,5,1734423453,1734423458,1734423458,-21600,MacBook
com.tencent.xinWeChat,5,1734423448,1734423453,1734423453,-21600,MacBook
com.microsoft.Outlook,9,1734423439,1734423448,1734423448,-21600,MacBook
com.apple.mobiletimer,10,1734423430,1734423440,1734423441,-21600,iPhone
com.tencent.xinWeChat,48,1734423391,1734423439,1734423440,-21600,MacBook
com.apple.finder,1,1734423390,1734423391,1734423391,-21600,MacBook
com.tencent.xinWeChat,72,1734423318,1734423390,1734423391,-21600,MacBook
com.apple.finder,1,1734423317,1734423318,1734423318,-21600,MacBook
com.tencent.xinWeChat,45,1734423272,1734423317,1734423318,-21600,MacBook
com.apple.finder,1,1734423271,1734423272,1734423272,-21600,MacBook
com.tencent.xinWeChat,1,1734423270,1734423271,1734423272,-21600,MacBook
com.apple.finder,1,1734423269,1734423270,1734423271,-21600,MacBook
com.tencent.xinWeChat,28,1734423241,1734423269,1734423269,-21600,MacBook
com.apple.finder,0,1734423241,1734423241,1734423242,-21600,MacBook
com.tencent.xinWeChat,8,1734423233,1734423241,1734423241,-21600,MacBook
com.apple.finder,0,1734423233,1734423233,1734423234,-21600,MacBook
com.tencent.xinWeChat,2,1734423231,1734423233,1734423233,-21600,MacBook
com.apple.finder,1,1734423230,1734423231,1734423231,-21600,MacBook
com.tencent.xinWeChat,133,1734423097,1734423230,1734423231,-21600,MacBook
com.apple.finder,1,1734423096,1734423097,1734423097,-21600,MacBook
com.tencent.xinWeChat,28,1734423068,1734423096,1734423096,-21600,MacBook
com.apple.finder,0,1734423068,1734423068,1734423069,-21600,MacBook
com.tencent.xinWeChat,1,1734423067,1734423068,1734423068,-21600,MacBook
com.apple.finder,0,1734423067,1734423067,1734423068,-21600,MacBook
com.tencent.xinWeChat,2,1734423065,1734423067,1734423067,-21600,MacBook
com.apple.finder,0,1734423065,1734423065,1734423066,-21600,MacBook
com.tencent.xinWeChat,10,1734423055,1734423065,1734423065,-21600,MacBook
com.apple.finder,0,1734423055,1734423055,1734423056,-21600,MacBook
com.tencent.xinWeChat,0,1734423055,1734423055,1734423055,-21600,MacBook
com.apple.finder,1,1734423054,1734423055,1734423055,-21600,MacBook
com.tencent.xinWeChat,1,1734423053,1734423054,1734423055,-21600,MacBook
com.apple.finder,0,1734423053,1734423053,1734423054,-21600,MacBook
com.tencent.xinWeChat,2,1734423051,1734423053,1734423053,-21600,MacBook
com.apple.finder,1,1734423050,1734423051,1734423051,-21600,MacBook
com.tencent.xinWeChat,1,1734423049,1734423050,1734423051,-21600,MacBook
com.apple.finder,1,1734423048,1734423049,1734423049,-21600,MacBook
com.tencent.xinWeChat,2,1734423046,1734423048,1734423049,-21600,MacBook
com.apple.finder,0,1734423046,1734423046,1734423046,-21600,MacBook
com.tencent.xinWeChat,1,1734423045,1734423046,1734423046,-21600,MacBook
com.apple.finder,0,1734423045,1734423045,1734423046,-21600,MacBook
com.tencent.xinWeChat,1,1734423044,1734423045,1734423045,-21600,MacBook
com.apple.finder,0,1734423044,1734423044,1734423045,-21600,MacBook
com.tencent.xinWeChat,2,1734423042,1734423044,1734423045,-21600,MacBook
com.apple.finder,5,1734423037,1734423042,1734423043,-21600,MacBook
com.apple.finder,1,1734423019,1734423020,1734423020,-21600,MacBook
com.tencent.xinWeChat,3,1734423016,1734423019,1734423019,-21600,MacBook
com.apple.finder,1,1734423015,1734423016,1734423016,-21600,MacBook
com.tencent.xinWeChat,1,1734423014,1734423015,1734423016,-21600,MacBook
com.apple.finder,0,1734423014,1734423014,1734423015,-21600,MacBook
com.tencent.xinWeChat,5,1734423009,1734423014,1734423015,-21600,MacBook
com.apple.finder,1,1734423008,1734423009,1734423009,-21600,MacBook
com.tencent.xinWeChat,2,1734423006,1734423008,1734423009,-21600,MacBook
com.apple.finder,0,1734423006,1734423006,1734423007,-21600,MacBook
com.tencent.xinWeChat,1,1734423005,1734423006,1734423007,-21600,MacBook
com.apple.finder,0,1734423005,1734423005,1734423006,-21600,MacBook
com.tencent.xinWeChat,7,1734422998,1734423005,1734423006,-21600,MacBook
com.apple.finder,1,1734422997,1734422998,1734422998,-21600,MacBook
com.tencent.xinWeChat,0,1734422997,1734422997,1734422998,-21600,MacBook
com.apple.finder,1,1734422996,1734422997,1734422997,-21600,MacBook
com.tencent.xinWeChat,0,1734422996,1734422996,1734422997,-21600,MacBook
com.apple.finder,0,1734422996,1734422996,1734422997,-21600,MacBook
com.tencent.xinWeChat,1,1734422995,1734422996,1734422996,-21600,MacBook
com.apple.finder,1,1734422994,1734422995,1734422995,-21600,MacBook
com.tencent.xinWeChat,1,1734422993,1734422994,1734422995,-21600,MacBook
com.apple.finder,0,1734422993,1734422993,1734422994,-21600,MacBook
com.tencent.xinWeChat,2,1734422991,1734422993,1734422993,-21600,MacBook
com.apple.finder,0,1734422991,1734422991,1734422992,-21600,MacBook
com.tencent.xinWeChat,3,1734422988,1734422991,1734422991,-21600,MacBook
com.apple.finder,0,1734422988,1734422988,1734422989,-21600,MacBook
com.tencent.xinWeChat,2,1734422986,1734422988,1734422988,-21600,MacBook
com.apple.finder,1,1734422985,1734422986,1734422987,-21600,MacBook
com.tencent.xinWeChat,3,1734422982,1734422985,1734422986,-21600,MacBook
com.apple.finder,0,1734422982,1734422982,1734422983,-21600,MacBook
com.tencent.xinWeChat,52,1734422930,1734422982,1734422982,-21600,MacBook
com.apple.finder,0,1734422930,1734422930,1734422931,-21600,MacBook
com.tencent.xinWeChat,2,1734422928,1734422930,1734422931,-21600,MacBook
com.apple.finder,1,1734422927,1734422928,1734422928,-21600,MacBook
com.tencent.xinWeChat,18,1734422909,1734422927,1734422928,-21600,MacBook
com.apple.finder,1,1734422908,1734422909,1734422909,-21600,MacBook
com.tencent.xinWeChat,16,1734422892,1734422908,1734422909,-21600,MacBook
com.apple.finder,1,1734422891,1734422892,1734422892,-21600,MacBook
com.tencent.xinWeChat,4,1734422887,1734422891,1734422892,-21600,MacBook
com.google.Chrome,14,1734422873,1734422887,1734422888,-21600,MacBook
com.tencent.xinWeChat,9,1734422864,1734422873,1734422873,-21600,MacBook
com.apple.finder,0,1734422864,1734422864,1734422865,-21600,MacBook
com.tencent.xinWeChat,2,1734422862,1734422864,1734422864,-21600,MacBook
com.apple.finder,0,1734422862,1734422862,1734422863,-21600,MacBook
com.tencent.xinWeChat,2,1734422860,1734422862,1734422862,-21600,MacBook
com.apple.finder,1,1734422859,1734422860,1734422861,-21600,MacBook
com.tencent.xinWeChat,11,1734422848,1734422859,1734422860,-21600,MacBook
com.apple.finder,1,1734422847,1734422848,1734422849,-21600,MacBook
com.tencent.xinWeChat,17,1734422830,1734422847,1734422848,-21600,MacBook
com.apple.finder,0,1734422830,1734422830,1734422830,-21600,MacBook
com.tencent.xinWeChat,3,1734422827,1734422830,1734422830,-21600,MacBook
com.apple.finder,3,1734422824,1734422827,1734422828,-21600,MacBook
com.tencent.xinWeChat,5,1734422819,1734422824,1734422825,-21600,MacBook
com.apple.finder,0,1734422819,1734422819,1734422819,-21600,MacBook
com.tencent.xinWeChat,3,1734422816,1734422819,1734422819,-21600,MacBook
com.apple.finder,0,1734422816,1734422816,1734422817,-21600,MacBook
com.tencent.xinWeChat,3,1734422813,1734422816,1734422816,-21600,MacBook
com.apple.finder,0,1734422813,1734422813,1734422814,-21600,MacBook
com.tencent.xinWeChat,4,1734422809,1734422813,1734422814,-21600,MacBook
com.apple.finder,1,1734422808,1734422809,1734422809,-21600,MacBook
com.tencent.xinWeChat,3,1734422805,1734422808,1734422809,-21600,MacBook
com.apple.finder,2,1734422803,1734422805,1734422805,-21600,MacBook
com.tencent.xinWeChat,10,1734422793,1734422803,1734422804,-21600,MacBook
com.apple.finder,0,1734422793,1734422793,1734422794,-21600,MacBook
com.tencent.xinWeChat,1,1734422792,1734422793,1734422794,-21600,MacBook
com.apple.finder,0,1734422792,1734422792,1734422793,-21600,MacBook
com.tencent.xinWeChat,1,1734422791,1734422792,1734422793,-21600,MacBook
com.apple.finder,0,1734422791,1734422791,1734422792,-21600,MacBook
com.tencent.xinWeChat,1,1734422790,1734422791,1734422792,-21600,MacBook
com.apple.finder,1,1734422789,1734422790,1734422791,-21600,MacBook
com.tencent.xinWeChat,4,1734422785,1734422789,1734422790,-21600,MacBook
com.apple.finder,0,1734422785,1734422785,1734422786,-21600,MacBook
com.tencent.xinWeChat,7,1734422778,1734422785,1734422786,-21600,MacBook
com.apple.finder,0,1734422778,1734422778,1734422779,-21600,MacBook
com.tencent.xinWeChat,1,1734422777,1734422778,1734422778,-21600,MacBook
com.apple.finder,0,1734422777,1734422777,1734422778,-21600,MacBook
com.tencent.xinWeChat,8,1734422769,1734422777,1734422777,-21600,MacBook
com.apple.finder,0,1734422769,1734422769,1734422770,-21600,MacBook
com.tencent.xinWeChat,1,1734422768,1734422769,1734422769,-21600,MacBook
com.apple.finder,0,1734422768,1734422768,1734422769,-21600,MacBook
com.tencent.xinWeChat,3,1734422765,1734422768,1734422769,-21600,MacBook
com.apple.finder,1,1734422764,1734422765,1734422765,-21600,MacBook
com.tencent.xinWeChat,1,1734422763,1734422764,1734422765,-21600,MacBook
com.apple.finder,0,1734422763,1734422763,1734422764,-21600,MacBook
com.tencent.xinWeChat,3,1734422760,1734422763,1734422763,-21600,MacBook
com.apple.finder,0,1734422760,1734422760,1734422761,-21600,MacBook
com.tencent.xinWeChat,2,1734422758,1734422760,1734422760,-21600,MacBook
com.apple.finder,1,1734422757,1734422758,1734422759,-21600,MacBook
com.tencent.xinWeChat,18,1734422739,1734422757,1734422758,-21600,MacBook
com.apple.finder,1,1734422738,1734422739,1734422739,-21600,MacBook
com.tencent.xinWeChat,9,1734422729,1734422738,1734422739,-21600,MacBook
com.apple.finder,1,1734422728,1734422729,1734422729,-21600,MacBook
com.tencent.xinWeChat,3,1734422725,1734422728,1734422729,-21600,MacBook
com.apple.finder,0,1734422725,1734422725,1734422726,-21600,MacBook
com.tencent.xinWeChat,4,1734422721,1734422725,1734422725,-21600,MacBook
com.apple.finder,0,1734422721,1734422721,1734422722,-21600,MacBook
com.tencent.xinWeChat,2,1734422719,1734422721,1734422721,-21600,MacBook
com.apple.finder,0,1734422719,1734422719,1734422720,-21600,MacBook
com.tencent.xinWeChat,1,1734422718,1734422719,1734422719,-21600,MacBook
com.apple.finder,0,1734422718,1734422718,1734422718,-21600,MacBook
com.tencent.xinWeChat,1,1734422717,1734422718,1734422718,-21600,MacBook
com.apple.finder,1,1734422716,1734422717,1734422717,-21600,MacBook
com.tencent.xinWeChat,0,1734422716,1734422716,1734422717,-21600,MacBook
com.apple.finder,0,1734422716,1734422716,1734422717,-21600,MacBook
com.tencent.xinWeChat,1,1734422715,1734422716,1734422716,-21600,MacBook
com.apple.finder,0,1734422715,1734422715,1734422716,-21600,MacBook
com.tencent.xinWeChat,2,1734422713,1734422715,1734422715,-21600,MacBook
com.apple.finder,1,1734422712,1734422713,1734422713,-21600,MacBook
com.tencent.xinWeChat,30,1734422682,1734422712,1734422713,-21600,MacBook
com.apple.finder,2,1734422680,1734422682,1734422683,-21600,MacBook
com.tencent.xinWeChat,3,1734422677,1734422680,1734422680,-21600,MacBook
com.apple.finder,1,1734422676,1734422677,1734422677,-21600,MacBook
com.tencent.xinWeChat,5,1734422671,1734422676,1734422677,-21600,MacBook
com.apple.finder,0,1734422671,1734422671,1734422672,-21600,MacBook
com.tencent.xinWeChat,1,1734422670,1734422671,1734422672,-21600,MacBook
com.apple.finder,0,1734422670,1734422670,1734422671,-21600,MacBook
com.tencent.xinWeChat,2,1734422668,1734422670,1734422670,-21600,MacBook
com.apple.finder,1,1734422667,1734422668,1734422668,-21600,MacBook
com.tencent.xinWeChat,1,1734422666,1734422667,1734422668,-21600,MacBook
com.apple.finder,0,1734422666,1734422666,1734422667,-21600,MacBook
com.tencent.xinWeChat,3,1734422663,1734422666,1734422666,-21600,MacBook
com.apple.finder,0,1734422663,1734422663,1734422664,-21600,MacBook
com.tencent.xinWeChat,2,1734422661,1734422663,1734422664,-21600,MacBook
com.apple.finder,0,1734422661,1734422661,1734422662,-21600,MacBook
com.tencent.xinWeChat,4,1734422657,1734422661,1734422661,-21600,MacBook
com.apple.finder,1,1734422656,1734422657,1734422657,-21600,MacBook
com.tencent.xinWeChat,25,1734422631,1734422656,1734422657,-21600,MacBook
com.apple.finder,0,1734422631,1734422631,1734422632,-21600,MacBook
com.tencent.xinWeChat,1,1734422630,1734422631,1734422631,-21600,MacBook
com.apple.finder,0,1734422630,1734422630,1734422631,-21600,MacBook
com.tencent.xinWeChat,2,1734422628,1734422630,1734422631,-21600,MacBook
com.apple.finder,0,1734422628,1734422628,1734422629,-21600,MacBook
com.tencent.xinWeChat,17,1734422611,1734422628,1734422629,-21600,MacBook
com.apple.finder,1,1734422610,1734422611,1734422611,-21600,MacBook
com.tencent.xinWeChat,4,1734422606,1734422610,1734422611,-21600,MacBook
com.apple.finder,0,1734422606,1734422606,1734422607,-21600,MacBook
com.tencent.xinWeChat,9,1734422597,1734422606,1734422606,-21600,MacBook
com.apple.finder,4,1734422593,1734422597,1734422597,-21600,MacBook
com.tencent.xinWeChat,0,1734422593,1734422593,1734422594,-21600,MacBook
com.apple.finder,1,1734422592,1734422593,1734422593,-21600,MacBook
com.tencent.xinWeChat,1,1734422591,1734422592,1734422593,-21600,MacBook
com.apple.finder,0,1734422591,1734422591,1734422592,-21600,MacBook
com.tencent.xinWeChat,2,1734422589,1734422591,1734422592,-21600,MacBook
com.apple.finder,0,1734422589,1734422589,1734422590,-21600,MacBook
com.tencent.xinWeChat,2,1734422587,1734422589,1734422590,-21600,MacBook
com.apple.finder,0,1734422587,1734422587,1734422588,-21600,MacBook
com.tencent.xinWeChat,0,1734422587,1734422587,1734422588,-21600,MacBook
com.apple.finder,1,1734422586,1734422587,1734422587,-21600,MacBook
com.tencent.xinWeChat,4,1734422582,1734422586,1734422587,-21600,MacBook
com.apple.finder,0,1734422582,1734422582,1734422583,-21600,MacBook
com.tencent.xinWeChat,8,1734422574,1734422582,1734422582,-21600,MacBook
com.apple.finder,0,1734422574,1734422574,1734422575,-21600,MacBook
com.tencent.xinWeChat,1,1734422573,1734422574,1734422574,-21600,MacBook
com.apple.finder,0,1734422573,1734422573,1734422574,-21600,MacBook
com.tencent.xinWeChat,1,1734422572,1734422573,1734422573,-21600,MacBook
com.apple.finder,0,1734422572,1734422572,1734422573,-21600,MacBook
com.tencent.xinWeChat,12,1734422560,1734422572,1734422572,-21600,MacBook
com.apple.finder,1,1734422551,1734422552,1734422552,-21600,MacBook
com.tencent.xinWeChat,10,1734422541,1734422551,1734422552,-21600,MacBook
com.apple.finder,1,1734422540,1734422541,1734422541,-21600,MacBook
com.tencent.xinWeChat,0,1734422540,1734422540,1734422541,-21600,MacBook
com.apple.finder,1,1734422539,1734422540,1734422540,-21600,MacBook
com.tencent.xinWeChat,1,1734422538,1734422539,1734422540,-21600,MacBook
com.apple.finder,1,1734422537,1734422538,1734422538,-21600,MacBook
com.tencent.xinWeChat,0,1734422537,1734422537,1734422538,-21600,MacBook
com.apple.finder,1,1734422536,1734422537,1734422537,-21600,MacBook
com.tencent.xinWeChat,0,1734422536,1734422536,1734422537,-21600,MacBook
com.apple.finder,1,1734422535,1734422536,1734422536,-21600,MacBook
com.tencent.xinWeChat,1,1734422534,1734422535,1734422536,-21600,MacBook
com.apple.finder,0,1734422534,1734422534,1734422535,-21600,MacBook
com.tencent.xinWeChat,1,1734422533,1734422534,1734422535,-21600,MacBook
com.apple.finder,0,1734422533,1734422533,1734422534,-21600,MacBook
com.tencent.xinWeChat,1,1734422532,1734422533,1734422534,-21600,MacBook
com.apple.finder,1,1734422531,1734422532,1734422532,-21600,MacBook
com.tencent.xinWeChat,3,1734422528,1734422531,1734422532,-21600,MacBook
com.apple.finder,0,1734422528,1734422528,1734422529,-21600,MacBook
com.tencent.xinWeChat,1,1734422527,1734422528,1734422528,-21600,MacBook
com.apple.finder,1,1734422526,1734422527,1734422527,-21600,MacBook
com.tencent.xinWeChat,1,1734422525,1734422526,1734422526,-21600,MacBook
com.apple.finder,1,1734422524,1734422525,1734422525,-21600,MacBook
com.tencent.xinWeChat,2,1734422522,1734422524,1734422524,-21600,MacBook
com.apple.finder,0,1734422522,1734422522,1734422523,-21600,MacBook
com.tencent.xinWeChat,2,1734422520,1734422522,1734422522,-21600,MacBook
com.apple.finder,1,1734422519,1734422520,1734422521,-21600,MacBook
com.tencent.xinWeChat,11,1734422508,1734422519,1734422520,-21600,MacBook
com.apple.finder,1,1734422507,1734422508,1734422509,-21600,MacBook
com.tencent.xinWeChat,0,1734422507,1734422507,1734422508,-21600,MacBook
com.apple.finder,1,1734422506,1734422507,1734422507,-21600,MacBook
com.tencent.xinWeChat,1,1734422505,1734422506,1734422507,-21600,MacBook
com.apple.finder,0,1734422505,1734422505,1734422506,-21600,MacBook
com.tencent.xinWeChat,1,1734422504,1734422505,1734422505,-21600,MacBook
com.apple.finder,0,1734422504,1734422504,1734422505,-21600,MacBook
com.tencent.xinWeChat,1,1734422503,1734422504,1734422504,-21600,MacBook
com.apple.finder,0,1734422503,1734422503,1734422504,-21600,MacBook
com.tencent.xinWeChat,1,1734422502,1734422503,1734422503,-21600,MacBook
com.apple.finder,0,1734422502,1734422502,1734422502,-21600,MacBook
com.tencent.xinWeChat,1,1734422501,1734422502,1734422502,-21600,MacBook
com.apple.finder,1,1734422500,1734422501,1734422501,-21600,MacBook
com.tencent.xinWeChat,0,1734422500,1734422500,1734422501,-21600,MacBook
com.apple.finder,1,1734422499,1734422500,1734422500,-21600,MacBook
com.tencent.xinWeChat,29,1734422470,1734422499,1734422499,-21600,MacBook
com.apple.finder,1,1734422469,1734422470,1734422470,-21600,MacBook
com.tencent.xinWeChat,20,1734422449,1734422469,1734422470,-21600,MacBook
com.apple.Notes,2,1734422447,1734422449,1734422450,-21600,MacBook
com.google.Chrome,39,1734422408,1734422447,1734422448,-21600,MacBook
com.apple.mobiletimer,6,1734422428,1734422434,1734422434,-21600,iPhone
com.apple.mobiletimer,8,1734422295,1734422303,1734422303,-21600,iPhone
com.apple.mobiletimer,0,1734422294,1734422294,1734422295,-21600,iPhone
com.apple.mobiletimer,9,1734421956,1734421965,1734421965,-21600,iPhone
com.apple.mobiletimer,4,1734421653,1734421657,1734421658,-21600,iPhone
com.apple.mobilenotes,3,1734421650,1734421653,1734421654,-21600,iPhone
com.apple.mobilenotes,2,1734421379,1734421381,1734421381,-21600,iPhone
com.apple.mobilenotes,6,1734421122,1734421128,1734421128,-21600,iPhone
com.apple.mobilenotes,85,1734421009,1734421094,1734421095,-21600,iPhone
com.apple.mobilenotes,3,1734420997,1734421000,1734421000,-21600,iPhone
com.netease.cloudmusic,1,1734420995,1734420996,1734420997,-21600,iPhone
com.netease.cloudmusic,132,1734420811,1734420943,1734420944,-21600,iPhone
com.bilibili.bilicomic,245,1734420566,1734420811,1734420812,-21600,iPhone
com.bilibili.bilicomic,2,1734420560,1734420562,1734420562,-21600,iPhone
com.google.Chrome,16,1734420541,1734420557,1734420558,-21600,MacBook
com.bilibili.bilicomic,38,1734420359,1734420397,1734420398,-21600,iPhone
com.bilibili.bilicomic,2,1734420356,1734420358,1734420359,-21600,iPhone
com.netease.cloudmusic,2,1734420338,1734420340,1734420341,-21600,iPhone
com.tencent.xin,3,1734420333,1734420336,1734420336,-21600,iPhone
com.google.Chrome,10,1734420309,1734420319,1734420320,-21600,MacBook
com.apple.Notes,120,1734420189,1734420309,1734420310,-21600,MacBook
com.tencent.xinWeChat,0,1734420189,1734420189,1734420190,-21600,MacBook
com.google.Chrome,33,1734420156,1734420189,1734420190,-21600,MacBook
com.tencent.xinWeChat,6,1734420150,1734420156,1734420157,-21600,MacBook
com.microsoft.Outlook,3,1734420147,1734420150,1734420151,-21600,MacBook
com.tencent.xinWeChat,1,1734420146,1734420147,1734420148,-21600,MacBook
com.google.Chrome,1308,1734418838,1734420146,1734420146,-21600,MacBook
com.tencent.xin,75,1734419971,1734420046,1734420047,-21600,iPhone
com.google.Chrome,314,1734418325,1734418639,1734418639,-21600,MacBook
com.google.Chrome,301,1734417851,1734418152,1734418153,-21600,MacBook
com.google.Chrome,814,1734416711,1734417525,1734417525,-21600,MacBook
com.netease.cloudmusic,3,1734416694,1734416697,1734416698,-21600,iPhone
com.google.Chrome,765,1734415842,1734416607,1734416607,-21600,MacBook
com.tencent.xinWeChat,125,1734415717,1734415842,1734415842,-21600,MacBook
com.microsoft.Outlook,1,1734415716,1734415717,1734415718,-21600,MacBook
com.google.Chrome,14,1734415702,1734415716,1734415717,-21600,MacBook
com.google.Chrome,360,1734414275,1734414635,1734414635,-21600,MacBook
com.netease.cloudmusic,12,1734413991,1734414003,1734414004,-21600,iPhone
com.fobwifi.fobwifi,84,1734413907,1734413991,1734413991,-21600,iPhone
com.google.Chrome,19,1734413901,1734413920,1734413921,-21600,MacBook
com.apple.Preferences,4,1734413903,1734413907,1734413907,-21600,iPhone
com.netease.cloudmusic,11,1734413386,1734413397,1734413398,-21600,iPhone
com.netease.cloudmusic,0,1734413383,1734413383,1734413384,-21600,iPhone
com.tencent.xin,51,1734413330,1734413381,1734413382,-21600,iPhone
com.tencent.xin,25,1734413305,1734413330,1734413331,-21600,iPhone
com.microsoft.Office.Outlook,3,1734413302,1734413305,1734413306,-21600,iPhone
com.ridewithvia.UCA.UniversityOfChicagoRider,7,1734413295,1734413302,1734413303,-21600,iPhone
com.ridewithvia.UCA.UniversityOfChicagoRider,12,1734413270,1734413282,1734413282,-21600,iPhone
com.ridewithvia.UCA.UniversityOfChicagoRider,16,1734413012,1734413028,1734413028,-21600,iPhone
com.ridewithvia.UCA.UniversityOfChicagoRider,1,1734412980,1734412981,1734412981,-21600,iPhone
com.ridewithvia.UCA.UniversityOfChicagoRider,26,1734412936,1734412962,1734412962,-21600,iPhone
com.ridewithvia.UCA.UniversityOfChicagoRider,1,1734412908,1734412909,1734412909,-21600,iPhone
com.ridewithvia.UCA.UniversityOfChicagoRider,1,1734412712,1734412713,1734412714,-21600,iPhone
com.ridewithvia.UCA.UniversityOfChicagoRider,13,1734412686,1734412699,1734412699,-21600,iPhone
com.ridewithvia.UCA.UniversityOfChicagoRider,28,1734412645,1734412673,1734412674,-21600,iPhone
com.ridewithvia.UCA.UniversityOfChicagoRider,176,1734412339,1734412515,1734412515,-21600,iPhone
com.ridewithvia.UCA.UniversityOfChicagoRider,6,1734412271,1734412277,1734412277,-21600,iPhone
com.ridewithvia.UCA.UniversityOfChicagoRider,7,1734412261,1734412268,1734412269,-21600,iPhone
com.ridewithvia.UCA.UniversityOfChicagoRider,15,1734412190,1734412205,1734412206,-21600,iPhone
com.ridewithvia.UCA.UniversityOfChicagoRider,2,1734412150,1734412152,1734412153,-21600,iPhone
com.ridewithvia.UCA.UniversityOfChicagoRider,13,1734412136,1734412149,1734412150,-21600,iPhone
com.tencent.xin,3,1734412132,1734412135,1734412136,-21600,iPhone
com.tencent.xin,70,1734411998,1734412068,1734412069,-21600,iPhone
com.ridewithvia.UCA.UniversityOfChicagoRider,56,1734411940,1734411996,1734411996,-21600,iPhone
com.ridewithvia.UCA.UniversityOfChicagoRider,31,1734411854,1734411885,1734411886,-21600,iPhone
com.ridewithvia.UCA.UniversityOfChicagoRider,64,1734411723,1734411787,1734411787,-21600,iPhone
com.ridewithvia.UCA.UniversityOfChicagoRider,9,1734411714,1734411723,1734411723,-21600,iPhone
com.ridewithvia.UCA.UniversityOfChicagoRider,49,1734411094,1734411143,1734411144,-21600,iPhone
com.ridewithvia.UCA.UniversityOfChicagoRider,5,1734411088,1734411093,1734411094,-21600,iPhone
com.ridewithvia.UCA.UniversityOfChicagoRider,6,1734410089,1734410095,1734410095,-21600,iPhone
com.ridewithvia.UCA.UniversityOfChicagoRider,31,1734410046,1734410077,1734410078,-21600,iPhone
com.ridewithvia.UCA.UniversityOfChicagoRider,54,1734409987,1734410041,1734410042,-21600,iPhone
com.ridewithvia.UCA.UniversityOfChicagoRider,72,1734409915,1734409987,1734409987,-21600,iPhone
com.tencent.weread,4,1734409910,1734409914,1734409915,-21600,iPhone
com.tencent.weread,13,1734409895,1734409908,1734409909,-21600,iPhone
com.naver.linewebtoon,1,1734409894,1734409895,1734409895,-21600,iPhone
com.tencent.weread,1,1734409892,1734409893,1734409894,-21600,iPhone
com.bilibili.bilicomic,33,1734409856,1734409889,1734409889,-21600,iPhone
com.bilibili.bilicomic,1,1734409855,1734409856,1734409856,-21600,iPhone
com.bilibili.bilicomic,2,1734409852,1734409854,1734409854,-21600,iPhone
com.tencent.xin,21,1734409829,1734409850,1734409850,-21600,iPhone
com.microsoft.Office.Outlook,10,1734409819,1734409829,1734409830,-21600,iPhone
com.tencent.xin,1,1734409818,1734409819,1734409820,-21600,iPhone
com.microsoft.Office.Outlook,2,1734409815,1734409817,1734409817,-21600,iPhone
com.apple.mobiletimer,3,1734409811,1734409814,1734409814,-21600,iPhone
com.apple.mobiletimer,8,1734409800,1734409808,1734409808,-21600,iPhone
com.apple.mobiletimer,5,1734409790,1734409795,1734409795,-21600,iPhone
com.apple.mobiletimer,3,1734407488,1734407491,1734407492,-21600,iPhone
com.apple.mobilenotes,4,1734407483,1734407487,1734407488,-21600,iPhone
com.apple.mobilenotes,12,1734406710,1734406722,1734406723,-21600,iPhone
com.tencent.xin,2,1734406706,1734406708,1734406708,-21600,iPhone
com.tencent.xin,10,1734404982,1734404992,1734404993,-21600,iPhone
com.tencent.xin,32,1734403962,1734403994,1734403995,-21600,iPhone
com.apple.camera,5,1734403743,1734403748,1734403749,-21600,iPhone
com.google.Chrome,31,1734400294,1734400325,1734400325,-21600,MacBook
com.tencent.xin,5,1734400282,1734400287,1734400289,-21600,iPhone
com.microsoft.Office.Outlook,4,1734400277,1734400281,1734400282,-21600,iPhone
com.microsoft.Office.Outlook,7,1734400188,1734400195,1734400195,-21600,iPhone
com.google.Chrome,9,1734400080,1734400089,1734400090,-21600,MacBook
com.microsoft.Office.Outlook,2,1734400085,1734400087,1734400088,-21600,iPhone
com.microsoft.Outlook,15,1734400065,1734400080,1734400080,-21600,MacBook
com.apple.finder,1,1734400064,1734400065,1734400065,-21600,MacBook
com.microsoft.Outlook,330,1734399734,1734400064,1734400065,-21600,MacBook
com.apple.finder,3,1734399731,1734399734,1734399735,-21600,MacBook
com.microsoft.Outlook,43,1734399688,1734399731,1734399732,-21600,MacBook
com.apple.finder,1,1734399687,1734399688,1734399689,-21600,MacBook
com.microsoft.Outlook,12,1734399675,1734399687,1734399688,-21600,MacBook
com.google.Chrome,2,1734399673,1734399675,1734399676,-21600,MacBook
com.microsoft.Outlook,1,1734399672,1734399673,1734399673,-21600,MacBook
com.google.Chrome,55,1734399617,1734399672,1734399672,-21600,MacBook
com.microsoft.Office.Outlook,15,1734399622,1734399637,1734399638,-21600,iPhone
com.apple.MobileSMS,3,1734399619,1734399622,1734399622,-21600,iPhone
com.microsoft.Outlook,8,1734399609,1734399617,1734399618,-21600,MacBook
com.apple.MobileSMS,4,1734399606,1734399610,1734399611,-21600,iPhone
com.apple.finder,0,1734399609,1734399609,1734399609,-21600,MacBook
com.google.Chrome,68,1734399541,1734399609,1734399609,-21600,MacBook
com.apple.MobileSMS,5,1734399591,1734399596,1734399597,-21600,iPhone
com.apple.mobiletimer,5,1734399585,1734399590,1734399591,-21600,iPhone
com.apple.finder,1,1734399540,1734399541,1734399541,-21600,MacBook
com.microsoft.Outlook,7,1734399533,1734399540,1734399541,-21600,MacBook
com.google.Chrome,1,1734399532,1734399533,1734399534,-21600,MacBook
com.microsoft.Outlook,22,1734399510,1734399532,1734399532,-21600,MacBook
com.apple.Notes,80,1734399430,1734399510,1734399511,-21600,MacBook
com.tencent.xin,10,1734399468,1734399478,1734399479,-21600,iPhone
com.duosecurity.DuoMobile,2,1734399464,1734399466,1734399467,-21600,iPhone
com.microsoft.Outlook,17,1734399413,1734399430,1734399430,-21600,MacBook
com.google.Chrome,348,1734399065,1734399413,1734399414,-21600,MacBook
com.duosecurity.DuoMobile,31,1734399150,1734399181,1734399181,-21600,iPhone
com.apple.mobilephone,5,1734399145,1734399150,1734399150,-21600,iPhone
com.duosecurity.DuoMobile,8,1734399136,1734399144,1734399144,-21600,iPhone
com.duosecurity.DuoMobile,11,1734399124,1734399135,1734399136,-21600,iPhone
com.duosecurity.DuoMobile,20,1734399103,1734399123,1734399124,-21600,iPhone
com.tencent.xin,4,1734399098,1734399102,1734399102,-21600,iPhone
com.microsoft.Outlook,13,1734399052,1734399065,1734399066,-21600,MacBook
com.apple.finder,0,1734399052,1734399052,1734399052,-21600,MacBook
com.google.Chrome,246,1734398806,1734399052,1734399052,-21600,MacBook
com.tencent.xinWeChat,182,1734398624,1734398806,1734398807,-21600,MacBook
com.google.Chrome,7,1734398617,1734398624,1734398624,-21600,MacBook
com.apple.finder,1,1734398616,1734398617,1734398618,-21600,MacBook
com.tencent.xinWeChat,1,1734398615,1734398616,1734398617,-21600,MacBook
com.apple.finder,0,1734398615,1734398615,1734398615,-21600,MacBook
com.google.Chrome,5,1734398610,1734398615,1734398615,-21600,MacBook
com.tencent.xinWeChat,14,1734398583,1734398597,1734398597,-21600,MacBook
com.apple.finder,0,1734398583,1734398583,1734398584,-21600,MacBook
com.tencent.xinWeChat,13,1734398570,1734398583,1734398583,-21600,MacBook
com.apple.finder,2,1734398568,1734398570,1734398570,-21600,MacBook
com.tencent.xinWeChat,10,1734398558,1734398568,1734398569,-21600,MacBook
com.apple.finder,1,1734398557,1734398558,1734398559,-21600,MacBook
com.tencent.xinWeChat,5,1734398552,1734398557,1734398558,-21600,MacBook
com.apple.finder,0,1734398552,1734398552,1734398553,-21600,MacBook
com.tencent.xinWeChat,8,1734398544,1734398552,1734398552,-21600,MacBook
com.apple.finder,1,1734398543,1734398544,1734398544,-21600,MacBook
com.tencent.xinWeChat,5,1734398538,1734398543,1734398543,-21600,MacBook
com.apple.finder,1,1734398537,1734398538,1734398539,-21600,MacBook
com.tencent.xinWeChat,2,1734398535,1734398537,1734398538,-21600,MacBook
com.apple.finder,1,1734398534,1734398535,1734398535,-21600,MacBook
com.tencent.xinWeChat,3,1734398531,1734398534,1734398535,-21600,MacBook
com.apple.finder,0,1734398531,1734398531,1734398532,-21600,MacBook
com.tencent.xinWeChat,16,1734398515,1734398531,1734398531,-21600,MacBook
com.apple.finder,1,1734398514,1734398515,1734398515,-21600,MacBook
com.tencent.xinWeChat,24,1734398490,1734398514,1734398515,-21600,MacBook
com.apple.finder,1,1734398489,1734398490,1734398490,-21600,MacBook
com.tencent.xinWeChat,3,1734398486,1734398489,1734398490,-21600,MacBook
com.apple.finder,1,1734398485,1734398486,1734398486,-21600,MacBook
com.tencent.xinWeChat,10,1734398475,1734398485,1734398485,-21600,MacBook
com.google.Chrome,84,1734398391,1734398475,1734398476,-21600,MacBook
com.tencent.xinWeChat,57,1734398334,1734398391,1734398392,-21600,MacBook
com.apple.finder,1,1734398333,1734398334,1734398334,-21600,MacBook
com.tencent.xinWeChat,2,1734398331,1734398333,1734398334,-21600,MacBook
com.google.Chrome,6,1734398325,1734398331,1734398331,-21600,MacBook
com.tencent.xinWeChat,31,1734398294,1734398325,1734398325,-21600,MacBook
com.apple.finder,1,1734398293,1734398294,1734398294,-21600,MacBook
com.tencent.xinWeChat,1,1734398292,1734398293,1734398294,-21600,MacBook
com.apple.finder,3,1734398289,1734398292,1734398293,-21600,MacBook
com.tencent.xinWeChat,51,1734398238,1734398289,1734398289,-21600,MacBook
com.apple.finder,0,1734398238,1734398238,1734398239,-21600,MacBook
com.tencent.xinWeChat,36,1734398202,1734398238,1734398238,-21600,MacBook
com.apple.finder,0,1734398202,1734398202,1734398203,-21600,MacBook
com.tencent.xinWeChat,4,1734398198,1734398202,1734398202,-21600,MacBook
com.apple.finder,0,1734398198,1734398198,1734398200,-21600,MacBook
com.google.Chrome,7,1734398191,1734398198,1734398200,-21600,MacBook
com.tencent.xin,8,1734395782,1734395790,1734395791,-21600,iPhone
com.tencent.xin,1,1734395767,1734395768,1734395769,-21600,iPhone
com.tencent.xin,8,1734395749,1734395757,1734395758,-21600,iPhone
com.tencent.xin,85,1734395537,1734395622,1734395623,-21600,iPhone
com.ubercab.UberEats,15,1734395521,1734395536,1734395537,-21600,iPhone
com.ubercab.UberEats,12,1734395441,1734395453,1734395454,-21600,iPhone
com.ubercab.UberEats,198,1734395242,1734395440,1734395441,-21600,iPhone
com.ubercab.UberEats,199,1734395040,1734395239,1734395240,-21600,iPhone
com.apple.mobiletimer,5,1734395035,1734395040,1734395041,-21600,iPhone
com.apple.mobiletimer,3,1734394433,1734394436,1734394437,-21600,iPhone
com.ubercab.UberEats,25,1734394406,1734394431,1734394432,-21600,iPhone
com.ubercab.UberEats,8,1734393146,1734393154,1734393155,-21600,iPhone
com.google.Chrome,59,1734392778,1734392837,1734392837,-21600,MacBook
com.apple.finder,1,1734392777,1734392778,1734392779,-21600,MacBook
com.apple.Notes,3,1734392774,1734392777,1734392777,-21600,MacBook
com.apple.finder,0,1734392774,1734392774,1734392775,-21600,MacBook
com.apple.Notes,2,1734392772,1734392774,1734392774,-21600,MacBook
com.apple.finder,1,1734392771,1734392772,1734392772,-21600,MacBook
com.apple.Notes,3,1734392768,1734392771,1734392772,-21600,MacBook
com.apple.finder,2,1734392766,1734392768,1734392769,-21600,MacBook
com.apple.Notes,1,1734392765,1734392766,1734392767,-21600,MacBook
com.google.Chrome,23,1734392742,1734392765,1734392766,-21600,MacBook
com.apple.Notes,1,1734392741,1734392742,1734392743,-21600,MacBook
com.apple.finder,1,1734392740,1734392741,1734392741,-21600,MacBook
com.apple.Notes,23,1734392717,1734392740,1734392741,-21600,MacBook
com.apple.finder,1,1734392716,1734392717,1734392717,-21600,MacBook
com.apple.Notes,2,1734392714,1734392716,1734392717,-21600,MacBook
com.apple.finder,1,1734392713,1734392714,1734392714,-21600,MacBook
com.apple.Notes,8,1734392705,1734392713,1734392714,-21600,MacBook
com.apple.finder,1,1734392704,1734392705,1734392705,-21600,MacBook
com.apple.Notes,18,1734392686,1734392704,1734392705,-21600,MacBook
com.apple.finder,0,1734392686,1734392686,1734392687,-21600,MacBook
com.apple.Notes,25,1734392661,1734392686,1734392686,-21600,MacBook
com.apple.finder,1,1734392660,1734392661,1734392661,-21600,MacBook
com.apple.Notes,2,1734392658,1734392660,1734392661,-21600,MacBook
com.google.Chrome,1,1734392657,1734392658,1734392658,-21600,MacBook
com.apple.Notes,1,1734392656,1734392657,1734392658,-21600,MacBook
com.google.Chrome,7,1734392649,1734392656,1734392657,-21600,MacBook
com.apple.Notes,63,1734392586,1734392649,1734392650,-21600,MacBook
com.apple.finder,5,1734392581,1734392586,1734392587,-21600,MacBook
com.apple.Notes,2,1734392579,1734392581,1734392581,-21600,MacBook
com.apple.finder,0,1734392579,1734392579,1734392580,-21600,MacBook
com.google.Chrome,65,1734392514,1734392579,1734392579,-21600,MacBook
com.tencent.xinWeChat,6,1734392508,1734392514,1734392514,-21600,MacBook
com.tinyspeck.slackmacgap,4,1734392504,1734392508,1734392509,-21600,MacBook
com.tencent.xinWeChat,4,1734392500,1734392504,1734392505,-21600,MacBook
com.tinyspeck.slackmacgap,1,1734392499,1734392500,1734392500,-21600,MacBook
com.tencent.xinWeChat,2,1734392497,1734392499,1734392499,-21600,MacBook
com.tinyspeck.slackmacgap,0,1734392497,1734392497,1734392497,-21600,MacBook
com.apple.finder,2,1734392495,1734392497,1734392497,-21600,MacBook
com.tencent.xinWeChat,3,1734392492,1734392495,1734392496,-21600,MacBook
com.google.Chrome,348,1734392144,1734392492,1734392492,-21600,MacBook
com.ubercab.UberEats,56,1734392149,1734392205,1734392206,-21600,iPhone
com.tencent.xinWeChat,34,1734392110,1734392144,1734392144,-21600,MacBook
com.ubercab.UberEats,176,1734391965,1734392141,1734392142,-21600,iPhone
com.apple.finder,0,1734392110,1734392110,1734392111,-21600,MacBook
com.google.Chrome,205,1734391905,1734392110,1734392111,-21600,MacBook
com.apple.PassbookUIService,9,1734392078,1734392087,1734392088,-21600,iPhone
com.tencent.xin,19,1734391946,1734391965,1734391966,-21600,iPhone
com.apple.ScreenshotServicesService,21,1734391931,1734391952,1734391953,-21600,iPhone
com.ubercab.UberEats,30,1734391916,1734391946,1734391947,-21600,iPhone
com.apple.finder,1,1734391896,1734391897,1734391898,-21600,MacBook
com.tencent.xinWeChat,5,1734391891,1734391896,1734391896,-21600,MacBook
com.microsoft.Outlook,0,1734391891,1734391891,1734391892,-21600,MacBook
com.google.Chrome,26,1734391865,1734391891,1734391892,-21600,MacBook
com.ubercab.UberEats,136,1734391717,1734391853,1734391854,-21600,iPhone
com.apple.calculator,6,1734391711,1734391717,1734391717,-21600,iPhone
com.ubercab.UberEats,32,1734391677,1734391709,1734391710,-21600,iPhone
com.ubercab.UberEats,6,1734391662,1734391668,1734391669,-21600,iPhone
com.ubercab.UberEats,2,1734391660,1734391662,1734391662,-21600,iPhone
com.ubercab.UberEats,159,1734391414,1734391573,1734391574,-21600,iPhone
com.google.Chrome,269,1734391302,1734391571,1734391572,-21600,MacBook
com.google.chrome.ios,31,1734391383,1734391414,1734391415,-21600,iPhone
com.ubercab.UberEats,439,1734390944,1734391383,1734391384,-21600,iPhone
com.tencent.xin,6,1734390926,1734390932,1734390932,-21600,iPhone
com.tencent.xin,12,1734390903,1734390915,1734390916,-21600,iPhone
com.microsoft.Office.Outlook,2,1734390901,1734390903,1734390904,-21600,iPhone
com.ubercab.UberEats,3,1734390898,1734390901,1734390901,-21600,iPhone
com.apple.Preferences,9,1734390889,1734390898,1734390898,-21600,iPhone
com.ubercab.UberEats,12,1734390877,1734390889,1734390890,-21600,iPhone
com.microsoft.Office.Outlook,3,1734390873,1734390876,1734390876,-21600,iPhone
com.tencent.xin,7,1734390358,1734390365,1734390365,-21600,iPhone
com.ridewithvia.UCA.UniversityOfChicagoRider,3,1734390355,1734390358,1734390359,-21600,iPhone
com.instructure.icanvas,42,1734390313,1734390355,1734390356,-21600,iPhone
com.ridewithvia.UCA.UniversityOfChicagoRider,4,1734390309,1734390313,1734390313,-21600,iPhone
com.ridewithvia.UCA.UniversityOfChicagoRider,6,1734390297,1734390303,1734390304,-21600,iPhone
com.ridewithvia.UCA.UniversityOfChicagoRider,32,1734390254,1734390286,1734390287,-21600,iPhone
com.tencent.xin,18,1734390230,1734390248,1734390249,-21600,iPhone
com.tencent.xin,35,1734390191,1734390226,1734390227,-21600,iPhone
com.ridewithvia.UCA.UniversityOfChicagoRider,6,1734390185,1734390191,1734390192,-21600,iPhone
com.apple.camera,0,1734390186,1734390186,1734390186,-21600,iPhone
com.ridewithvia.UCA.UniversityOfChicagoRider,2,1734390151,1734390153,1734390153,-21600,iPhone
com.ridewithvia.UCA.UniversityOfChicagoRider,223,1734389927,1734390150,1734390151,-21600,iPhone
com.tencent.xin,38,1734389889,1734389927,1734389927,-21600,iPhone
com.ridewithvia.UCA.UniversityOfChicagoRider,35,1734389854,1734389889,1734389889,-21600,iPhone
com.tencent.xin,33,1734389820,1734389853,1734389853,-21600,iPhone
com.tencent.xin,2,1734389816,1734389818,1734389818,-21600,iPhone
com.instructure.icanvas,7,1734389809,1734389816,1734389816,-21600,iPhone
com.apple.Preferences,7,1734389802,1734389809,1734389810,-21600,iPhone
com.apple.camera,10,1734389791,1734389801,1734389801,-21600,iPhone
com.tencent.xin,6,1734389790,1734389796,1734389797,-21600,iPhone
com.tencent.xin,3,1734389748,1734389751,1734389752,-21600,iPhone
com.instructure.icanvas,18,1734389730,1734389748,1734389748,-21600,iPhone
com.google.chrome.ios,1,1734389729,1734389730,1734389731,-21600,iPhone
com.tencent.xin,5,1734389724,1734389729,1734389729,-21600,iPhone
com.google.chrome.ios,40,1734389684,1734389724,1734389725,-21600,iPhone
com.google.chrome.ios,7,1734389677,1734389684,1734389684,-21600,iPhone
com.google.chrome.ios,3,1734389673,1734389676,1734389676,-21600,iPhone
com.tencent.xin,5,1734389668,1734389673,1734389673,-21600,iPhone
com.google.chrome.ios,64,1734389601,1734389665,1734389665,-21600,iPhone
com.microsoft.Office.Outlook,209,1734389392,1734389601,1734389601,-21600,iPhone
com.google.chrome.ios,38,1734389354,1734389392,1734389393,-21600,iPhone
com.instructure.icanvas,12,1734389342,1734389354,1734389355,-21600,iPhone
com.microsoft.Office.Outlook,62,1734389279,1734389341,1734389342,-21600,iPhone
com.tencent.xin,21,1734389258,1734389279,1734389279,-21600,iPhone
com.microsoft.Office.Outlook,15,1734389243,1734389258,1734389258,-21600,iPhone
com.tencent.xin,5,1734389238,1734389243,1734389244,-21600,iPhone
com.tencent.xin,71,1734389136,1734389207,1734389208,-21600,iPhone
com.tencent.xin,3,1734389118,1734389121,1734389122,-21600,iPhone
com.tencent.xin,1,1734389109,1734389110,1734389111,-21600,iPhone
com.tencent.xin,15,1734389060,1734389075,1734389076,-21600,iPhone
com.microsoft.Office.Outlook,9,1734389051,1734389060,1734389060,-21600,iPhone
com.tencent.xin,42,1734389009,1734389051,1734389052,-21600,iPhone
com.microsoft.Office.Outlook,30,1734388978,1734389008,1734389009,-21600,iPhone
com.tencent.xin,117,1734388860,1734388977,1734388978,-21600,iPhone
com.tencent.xin,13,1734388681,1734388694,1734388695,-21600,iPhone
com.google.Maps,13,1734388668,1734388681,1734388681,-21600,iPhone
com.tencent.xin,26,1734388642,1734388668,1734388668,-21600,iPhone
com.tencent.xin,1,1734388478,1734388479,1734388479,-21600,iPhone
com.tencent.xin,41,1734388436,1734388477,1734388477,-21600,iPhone
com.tencent.xin,4,1734388271,1734388275,1734388276,-21600,iPhone
com.tencent.xin,5,1734388241,1734388246,1734388247,-21600,iPhone
com.tencent.xin,1,1734388240,1734388241,1734388241,-21600,iPhone
com.tencent.xin,7,1734388117,1734388124,1734388124,-21600,iPhone
com.ubercab.UberClient,36,1734388081,1734388117,1734388118,-21600,iPhone
com.tencent.xin,14,1734388067,1734388081,1734388081,-21600,iPhone
com.google.Maps,1,1734388066,1734388067,1734388070,-21600,iPhone
com.ubercab.UberClient,8,1734388058,1734388066,1734388068,-21600,iPhone
com.google.Maps,2,1734388056,1734388058,1734388059,-21600,iPhone
com.ubercab.UberClient,2,1734388054,1734388056,1734388056,-21600,iPhone
com.tencent.xin,5,1734388049,1734388054,1734388055,-21600,iPhone
com.ubercab.UberClient,1,1734388048,1734388049,1734388053,-21600,iPhone
com.tencent.xin,17,1734388029,1734388046,1734388053,-21600,iPhone
com.tencent.xin,184,1734387774,1734387958,1734387959,-21600,iPhone
com.tencent.xin,8,1734387200,1734387208,1734387209,-21600,iPhone
com.tencent.xin,18,1734387180,1734387198,1734387199,-21600,iPhone
com.tencent.xin,2,1734387174,1734387176,1734387176,-21600,iPhone
com.tencent.xin,14,1734387150,1734387164,1734387164,-21600,iPhone
com.tencent.xin,2,1734387144,1734387146,1734387146,-21600,iPhone
com.tencent.xin,21,1734387117,1734387138,1734387139,-21600,iPhone
tv.danmaku.bilianime,3,1734387114,1734387117,1734387117,-21600,iPhone
com.xingin.discover,489,1734386625,1734387114,1734387115,-21600,iPhone
tv.danmaku.bilianime,933,1734385690,1734386623,1734386623,-21600,iPhone
tv.danmaku.bilianime,690,1734384941,1734385631,1734385632,-21600,iPhone
com.tencent.xin,22,1734384919,1734384941,1734384941,-21600,iPhone
tv.danmaku.bilianime,336,1734384580,1734384916,1734384916,-21600,iPhone
com.xingin.discover,87,1734384492,1734384579,1734384579,-21600,iPhone
com.tencent.xin,10,1734384482,1734384492,1734384492,-21600,iPhone
com.xingin.discover,204,1734384278,1734384482,1734384483,-21600,iPhone
com.tencent.xin,1,1734384277,1734384278,1734384279,-21600,iPhone
com.xingin.discover,47,1734384229,1734384276,1734384276,-21600,iPhone
com.microsoft.Office.Outlook,7,1734384222,1734384229,1734384229,-21600,iPhone
com.xingin.discover,992,1734383230,1734384222,1734384222,-21600,iPhone
com.xingin.discover,12,1734383208,1734383220,1734383221,-21600,iPhone
com.xingin.discover,828,1734382372,1734383200,1734383201,-21600,iPhone
tv.danmaku.bilianime,9,1734382358,1734382367,1734382367,-21600,iPhone
tv.danmaku.bilianime,8,1734382343,1734382351,1734382351,-21600,iPhone
tv.danmaku.bilianime,2,1734382317,1734382319,1734382320,-21600,iPhone
com.xingin.discover,75,1734382229,1734382304,1734382305,-21600,iPhone
com.tencent.xin,11,1734382218,1734382229,1734382230,-21600,iPhone
com.xingin.discover,2701,1734379517,1734382218,1734382219,-21600,iPhone
com.microsoft.Office.Outlook,7,1734379510,1734379517,1734379518,-21600,iPhone
com.tencent.xin,25,1734379485,1734379510,1734379511,-21600,iPhone
com.microsoft.Office.Outlook,1,1734379484,1734379485,1734379486,-21600,iPhone
com.tencent.xin,1,1734379483,1734379484,1734379485,-21600,iPhone
com.xingin.discover,1,1734379478,1734379479,1734379480,-21600,iPhone
tv.danmaku.bilianime,3444,1734376033,1734379477,1734379477,-21600,iPhone
com.microsoft.Office.Outlook,4,1734376027,1734376031,1734376031,-21600,iPhone
com.bilibili.bilicomic,1,1734376026,1734376027,1734376028,-21600,iPhone
com.instructure.icanvas,48,1734375976,1734376024,1734376025,-21600,iPhone
com.apple.MobileSMS,5,1734375971,1734375976,1734375977,-21600,iPhone
com.instructure.icanvas,32,1734375939,1734375971,1734375972,-21600,iPhone
com.microsoft.Office.Outlook,9,1734375930,1734375939,1734375940,-21600,iPhone
com.google.chrome.ios,1100,1734374041,1734375141,1734375141,-21600,iPhone
com.apple.mobilenotes,3,1734374036,1734374039,1734374040,-21600,iPhone
com.apple.mobilenotes,1,1734373584,1734373585,1734373586,-21600,iPhone
com.apple.mobilenotes,80,1734373503,1734373583,1734373584,-21600,iPhone
com.google.chrome.ios,175,1734373328,1734373503,1734373504,-21600,iPhone
com.microsoft.Office.Outlook,42,1734373286,1734373328,1734373328,-21600,iPhone
com.tencent.xin,13,1734373273,1734373286,1734373287,-21600,iPhone
com.microsoft.Office.Outlook,1,1734373272,1734373273,1734373274,-21600,iPhone
com.apple.mobilenotes,2,1734373269,1734373271,1734373271,-21600,iPhone
com.microsoft.Office.Outlook,40,1734373229,1734373269,1734373270,-21600,iPhone
com.apple.mobilenotes,22,1734373207,1734373229,1734373229,-21600,iPhone
com.microsoft.Office.Outlook,7,1734373200,1734373207,1734373207,-21600,iPhone
com.apple.mobilenotes,332,1734372868,1734373200,1734373201,-21600,iPhone
com.tencent.xin,3,1734372865,1734372868,1734372868,-21600,iPhone
com.apple.mobilenotes,679,1734372185,1734372864,1734372865,-21600,iPhone
com.google.chrome.ios,2,1734372180,1734372182,1734372183,-21600,iPhone
com.apple.mobilenotes,3,1734372177,1734372180,1734372181,-21600,iPhone
com.google.chrome.ios,76,1734372099,1734372175,1734372176,-21600,iPhone
com.microsoft.Office.Outlook,17,1734372082,1734372099,1734372100,-21600,iPhone
com.openai.chat,9,1734372073,1734372082,1734372082,-21600,iPhone
com.microsoft.Office.Outlook,42,1734372031,1734372073,1734372074,-21600,iPhone
com.apple.camera,0,1734372031,1734372031,1734372032,-21600,iPhone
com.google.Chrome,4,1734372001,1734372005,1734372006,-21600,MacBook
com.microsoft.Outlook,35,1734371966,1734372001,1734372001,-21600,MacBook
com.apple.finder,0,1734371966,1734371966,1734371967,-21600,MacBook
com.microsoft.Outlook,2,1734371964,1734371966,1734371966,-21600,MacBook
com.apple.finder,1,1734371963,1734371964,1734371965,-21600,MacBook
com.microsoft.Outlook,2,1734371961,1734371963,1734371964,-21600,MacBook
com.apple.finder,0,1734371961,1734371961,1734371962,-21600,MacBook
com.microsoft.Outlook,96,1734371865,1734371961,1734371961,-21600,MacBook
com.apple.finder,1,1734371864,1734371865,1734371865,-21600,MacBook
com.apple.Preview,11,1734371853,1734371864,1734371864,-21600,MacBook
com.apple.finder,0,1734371853,1734371853,1734371854,-21600,MacBook
com.apple.Preview,5,1734371848,1734371853,1734371853,-21600,MacBook
com.apple.finder,1,1734371847,1734371848,1734371848,-21600,MacBook
com.microsoft.Outlook,7,1734371840,1734371847,1734371848,-21600,MacBook
com.apple.finder,1,1734371839,1734371840,1734371840,-21600,MacBook
com.microsoft.Outlook,6,1734371833,1734371839,1734371840,-21600,MacBook
com.microsoft.Office.Outlook,81,1734371755,1734371836,1734371837,-21600,iPhone
com.apple.finder,1,1734371832,1734371833,1734371833,-21600,MacBook
com.microsoft.Outlook,12,1734371820,1734371832,1734371832,-21600,MacBook
com.openai.chat,29,1734371726,1734371755,1734371756,-21600,iPhone
com.microsoft.Office.Outlook,46,1734371680,1734371726,1734371726,-21600,iPhone
com.google.chrome.ios,32,1734371648,1734371680,1734371682,-21600,iPhone
com.microsoft.Office.Outlook,11,1734371637,1734371648,1734371648,-21600,iPhone
com.google.chrome.ios,31,1734371606,1734371637,1734371638,-21600,iPhone
com.microsoft.Office.Outlook,6,1734371600,1734371606,1734371607,-21600,iPhone
com.google.chrome.ios,1,1734371599,1734371600,1734371601,-21600,iPhone
com.microsoft.Office.Outlook,76,1734371523,1734371599,1734371599,-21600,iPhone
com.google.chrome.ios,29,1734371494,1734371523,1734371524,-21600,iPhone
com.apple.mobilenotes,28,1734371460,1734371488,1734371489,-21600,iPhone
com.microsoft.Office.Outlook,82,1734371377,1734371459,1734371460,-21600,iPhone
com.apple.mobilenotes,644,1734370733,1734371377,1734371378,-21600,iPhone
com.microsoft.Outlook,192,1734370518,1734370710,1734370711,-21600,MacBook
com.apple.mobilenotes,137,1734370572,1734370709,1734370710,-21600,iPhone
com.apple.mobiletimer,5,1734370566,1734370571,1734370571,-21600,iPhone
com.microsoft.Office.Outlook,14,1734370549,1734370563,1734370564,-21600,iPhone
com.apple.finder,0,1734370518,1734370518,1734370519,-21600,MacBook
com.microsoft.Outlook,4,1734370514,1734370518,1734370518,-21600,MacBook
com.apple.finder,0,1734370514,1734370514,1734370515,-21600,MacBook
com.microsoft.Outlook,3,1734370511,1734370514,1734370514,-21600,MacBook
com.apple.finder,1,1734370510,1734370511,1734370511,-21600,MacBook
com.microsoft.Outlook,1,1734370509,1734370510,1734370511,-21600,MacBook
com.apple.finder,1,1734370508,1734370509,1734370510,-21600,MacBook
com.microsoft.Outlook,14,1734370494,1734370508,1734370509,-21600,MacBook
com.apple.finder,1,1734370493,1734370494,1734370494,-21600,MacBook
com.microsoft.Outlook,11,1734370482,1734370493,1734370493,-21600,MacBook
com.apple.finder,3,1734370479,1734370482,1734370482,-21600,MacBook
com.microsoft.Outlook,13,1734370466,1734370479,1734370479,-21600,MacBook
com.google.Chrome,4,1734370462,1734370466,1734370467,-21600,MacBook
com.microsoft.Outlook,36,1734370426,1734370462,1734370463,-21600,MacBook
com.apple.Preview,4,1734370422,1734370426,1734370426,-21600,MacBook
com.apple.finder,2,1734370420,1734370422,1734370422,-21600,MacBook
com.apple.Preview,1,1734370419,1734370420,1734370421,-21600,MacBook
com.tencent.xinWeChat,2,1734370417,1734370419,1734370419,-21600,MacBook
com.apple.Preview,2,1734370415,1734370417,1734370417,-21600,MacBook
com.microsoft.Outlook,2,1734370413,1734370415,1734370416,-21600,MacBook
com.apple.Preview,18,1734370395,1734370413,1734370413,-21600,MacBook
com.apple.finder,3,1734370392,1734370395,1734370396,-21600,MacBook
com.microsoft.Outlook,12,1734370380,1734370392,1734370393,-21600,MacBook
com.tencent.xinWeChat,3,1734370377,1734370380,1734370381,-21600,MacBook
com.microsoft.Outlook,6,1734370371,1734370377,1734370378,-21600,MacBook
com.apple.finder,2,1734370369,1734370371,1734370372,-21600,MacBook
com.google.Chrome,8,1734370361,1734370369,1734370369,-21600,MacBook
com.apple.finder,1,1734370360,1734370361,1734370362,-21600,MacBook
com.microsoft.Outlook,3,1734370357,1734370360,1734370360,-21600,MacBook
com.apple.finder,10,1734370347,1734370357,1734370357,-21600,MacBook
com.microsoft.Outlook,29,1734370318,1734370347,1734370348,-21600,MacBook
com.google.Chrome,28,1734370290,1734370318,1734370319,-21600,MacBook
com.microsoft.Outlook,12,1734370278,1734370290,1734370290,-21600,MacBook
com.google.Chrome,312,1734369966,1734370278,1734370279,-21600,MacBook
com.microsoft.Office.Outlook,14,1734369955,1734369969,1734369970,-21600,iPhone
com.microsoft.Outlook,7,1734369959,1734369966,1734369966,-21600,MacBook
com.google.Chrome,121,1734369838,1734369959,1734369959,-21600,MacBook
com.microsoft.Outlook,4,1734369834,1734369838,1734369838,-21600,MacBook
com.google.Chrome,6,1734369828,1734369834,1734369834,-21600,MacBook
com.microsoft.Outlook,74,1734369754,1734369828,1734369828,-21600,MacBook
com.google.Chrome,102,1734369652,1734369754,1734369754,-21600,MacBook
com.microsoft.Office.Outlook,10,1734369724,1734369734,1734369735,-21600,iPhone
com.microsoft.Outlook,2,1734369575,1734369577,1734369578,-21600,MacBook
com.apple.finder,0,1734369575,1734369575,1734369577,-21600,MacBook
com.google.Chrome,2,1734369573,1734369575,1734369577,-21600,MacBook
com.apple.finder,2,1734369571,1734369573,1734369574,-21600,MacBook
com.microsoft.Office.Outlook,7,1734369522,1734369529,1734369530,-21600,iPhone
com.microsoft.Office.Outlook,22,1734369467,1734369489,1734369491,-21600,iPhone
tv.danmaku.bilianime,50,1734369417,1734369467,1734369468,-21600,iPhone
com.tencent.xin,17,1734369400,1734369417,1734369417,-21600,iPhone
tv.danmaku.bilianime,1,1734369398,1734369399,1734369399,-21600,iPhone
com.apple.MobileSMS,11,1734369384,1734369395,1734369395,-21600,iPhone
com.tencent.xin,237,1734369144,1734369381,1734369382,-21600,iPhone
com.microsoft.Office.Outlook,4,1734369140,1734369144,1734369145,-21600,iPhone
com.microsoft.Office.Outlook,1,1734369138,1734369139,1734369139,-21600,iPhone
com.tencent.xin,21,1734369115,1734369136,1734369137,-21600,iPhone
com.tencent.xin,17,1734369090,1734369107,1734369108,-21600,iPhone
net.whatsapp.WhatsApp,10,1734369080,1734369090,1734369091,-21600,iPhone
com.tencent.xin,2,1734369078,1734369080,1734369080,-21600,iPhone
com.microsoft.Office.Outlook,23,1734369053,1734369076,1734369077,-21600,iPhone
com.apple.mobilenotes,15,1734369038,1734369053,1734369055,-21600,iPhone
com.apple.mobilenotes,10,1734368928,1734368938,1734368939,-21600,iPhone
com.apple.mobilenotes,2,1734344817,1734344819,1734344819,-21600,iPhone
com.apple.mobilenotes,472,1734344327,1734344799,1734344800,-21600,iPhone
com.apple.mobilenotes,30,1734344296,1734344326,1734344327,-21600,iPhone
com.apple.mobilenotes,1,1734344293,1734344294,1734344294,-21600,iPhone
com.apple.mobilenotes,98,1734344193,1734344291,1734344292,-21600,iPhone
com.apple.mobilenotes,24,1734344165,1734344189,1734344190,-21600,iPhone
com.tencent.xin,109,1734344033,1734344142,1734344143,-21600,iPhone
com.google.calendar,24,1734344007,1734344031,1734344032,-21600,iPhone
com.tencent.xin,3,1734344003,1734344006,1734344007,-21600,iPhone
com.apple.mobileslideshow,10,1734343992,1734344002,1734344003,-21600,iPhone
com.tencent.xin,6,1734343986,1734343992,1734343992,-21600,iPhone
com.tencent.xin,10,1734343956,1734343966,1734343967,-21600,iPhone
com.tencent.xin,86,1734343868,1734343954,1734343955,-21600,iPhone
com.apple.finder,21,1734343882,1734343903,1734343903,-21600,MacBook
com.tencent.xin,7,1734343597,1734343604,1734343604,-21600,iPhone
com.microsoft.Office.Outlook,2,1734343595,1734343597,1734343598,-21600,iPhone
com.microsoft.Office.Outlook,9,1734343566,1734343575,1734343576,-21600,iPhone
com.tencent.xin,18,1734343548,1734343566,1734343566,-21600,iPhone
com.ridewithvia.UCA.UniversityOfChicagoRider,4,1734343540,1734343544,1734343544,-21600,iPhone
com.ridewithvia.UCA.UniversityOfChicagoRider,19,1734343129,1734343148,1734343148,-21600,iPhone
com.ridewithvia.UCA.UniversityOfChicagoRider,9,1734343098,1734343107,1734343108,-21600,iPhone
com.netease.cloudmusic,12,1734343086,1734343098,1734343098,-21600,iPhone
com.ridewithvia.UCA.UniversityOfChicagoRider,28,1734343043,1734343071,1734343071,-21600,iPhone
com.ridewithvia.UCA.UniversityOfChicagoRider,15,1734343009,1734343024,1734343025,-21600,iPhone
com.ridewithvia.UCA.UniversityOfChicagoRider,5,1734342899,1734342904,1734342905,-21600,iPhone
com.ridewithvia.UCA.UniversityOfChicagoRider,87,1734342752,1734342839,1734342840,-21600,iPhone
com.tencent.xin,17,1734342581,1734342598,1734342598,-21600,iPhone
com.tencent.xin,4,1734341784,1734341788,1734341788,-21600,iPhone
com.apple.mobilenotes,2,1734341780,1734341782,1734341783,-21600,iPhone
com.bilibili.bilicomic,15,1734340924,1734340939,1734340940,-21600,iPhone
com.naver.linewebtoon,16,1734340908,1734340924,1734340925,-21600,iPhone
com.bilibili.bilicomic,3,1734340904,1734340907,1734340907,-21600,iPhone
com.tencent.xin,27,1734340874,1734340901,1734340901,-21600,iPhone
com.netease.cloudmusic,2,1734340871,1734340873,1734340874,-21600,iPhone
com.netease.cloudmusic,2,1734340532,1734340534,1734340534,-21600,iPhone
com.netease.cloudmusic,6,1734340056,1734340062,1734340063,-21600,iPhone
com.apple.MobileSMS,1,1734340055,1734340056,1734340057,-21600,iPhone
com.google.chrome.ios,4,1734340051,1734340055,1734340055,-21600,iPhone
com.google.chrome.ios,49,1734339681,1734339730,1734339731,-21600,iPhone
com.google.chrome.ios,13,1734339667,1734339680,1734339681,-21600,iPhone
com.apple.MobileSMS,4,1734338997,1734339001,1734339001,-21600,iPhone
com.microsoft.Office.Outlook,5,1734338991,1734338996,1734338997,-21600,iPhone
com.microsoft.Office.Outlook,4,1734338986,1734338990,1734338991,-21600,iPhone
com.netease.cloudmusic,3,1734338983,1734338986,1734338987,-21600,iPhone
com.netease.cloudmusic,10,1734338251,1734338261,1734338262,-21600,iPhone
com.netease.cloudmusic,662,1734337176,1734337838,1734337838,-21600,iPhone
com.google.chrome.ios,13,1734337163,1734337176,1734337177,-21600,iPhone
com.netease.cloudmusic,24,1734337137,1734337161,1734337162,-21600,iPhone
com.netease.cloudmusic,3,1734337110,1734337113,1734337114,-21600,iPhone
com.google.ios.youtube,2,1734337038,1734337040,1734337040,-21600,iPhone
com.apple.MobileSMS,3,1734336939,1734336942,1734336942,-21600,iPhone
com.netease.cloudmusic,2,1734336934,1734336936,1734336937,-21600,iPhone
com.netease.cloudmusic,1,1734336666,1734336667,1734336668,-21600,iPhone
com.netease.cloudmusic,11,1734336586,1734336597,1734336598,-21600,iPhone
com.apple.Preferences,63,1734336521,1734336584,1734336584,-21600,iPhone
com.tencent.xin,9,1734336511,1734336520,1734336521,-21600,iPhone
com.tencent.xin,10,1734336061,1734336071,1734336072,-21600,iPhone
com.microsoft.Office.Outlook,7,1734336052,1734336059,1734336060,-21600,iPhone
com.apple.mobiletimer,6,1734336046,1734336052,1734336052,-21600,iPhone
com.apple.finder,3,1734336000,1734336003,1734336004,-21600,MacBook
com.google.Chrome,147,1734335853,1734336000,1734336000,-21600,MacBook
com.apple.finder,1,1734335697,1734335698,1734335699,-21600,MacBook
com.google.Chrome,1009,1734334688,1734335697,1734335698,-21600,MacBook
com.apple.mobiletimer,16,1734335366,1734335382,1734335382,-21600,iPhone
com.apple.mobiletimer,3,1734334764,1734334767,1734334768,-21600,iPhone
com.google.calendar,5,1734334758,1734334763,1734334764,-21600,iPhone
com.microsoft.Outlook,9,1734334679,1734334688,1734334689,-21600,MacBook
com.apple.finder,0,1734334679,1734334679,1734334680,-21600,MacBook
com.google.Chrome,1472,1734333207,1734334679,1734334680,-21600,MacBook
com.google.calendar,6,1734333193,1734333199,1734333200,-21600,iPhone
com.google.calendar,10,1734333173,1734333183,1734333184,-21600,iPhone
com.apple.camera,3,1734333177,1734333180,1734333180,-21600,iPhone
com.google.calendar,3,1734333168,1734333171,1734333172,-21600,iPhone
com.google.calendar,16,1734332725,1734332741,1734332741,-21600,iPhone
com.google.calendar,4,1734332715,1734332719,1734332720,-21600,iPhone
com.tencent.xin,6,1734332706,1734332712,1734332713,-21600,iPhone
com.tencent.xin,28,1734331945,1734331973,1734331974,-21600,iPhone
com.tencent.xin,10,1734330807,1734330817,1734330818,-21600,iPhone
com.apple.mobiletimer,5,1734330802,1734330807,1734330808,-21600,iPhone
com.tencent.xin,4,1734330798,1734330802,1734330803,-21600,iPhone
com.tencent.xin,17,1734329994,1734330011,1734330012,-21600,iPhone
com.apple.mobiletimer,6,1734329987,1734329993,1734329993,-21600,iPhone
com.apple.mobiletimer,9,1734329033,1734329042,1734329043,-21600,iPhone
com.google.chrome.ios,3,1734329029,1734329032,1734329032,-21600,iPhone
com.google.chrome.ios,1,1734329024,1734329025,1734329026,-21600,iPhone
com.google.chrome.ios,10,1734327751,1734327761,1734327761,-21600,iPhone
com.google.chrome.ios,1,1734326809,1734326810,1734326811,-21600,iPhone
com.google.chrome.ios,22,1734326786,1734326808,1734326809,-21600,iPhone
com.tencent.xin,35,1734326751,1734326786,1734326786,-21600,iPhone
com.google.chrome.ios,51,1734326700,1734326751,1734326752,-21600,iPhone
com.fobwifi.fobwifi,1,1734326698,1734326699,1734326700,-21600,iPhone
com.duosecurity.DuoMobile,9,1734326689,1734326698,1734326699,-21600,iPhone
com.fobwifi.fobwifi,5,1734326684,1734326689,1734326690,-21600,iPhone
com.duosecurity.DuoMobile,1,1734326682,1734326683,1734326684,-21600,iPhone
com.google.chrome.ios,28,1734326654,1734326682,1734326682,-21600,iPhone
com.google.chrome.ios,11,1734326642,1734326653,1734326654,-21600,iPhone
com.apple.BarcodeScanner,6,1734326636,1734326642,1734326643,-21600,iPhone
com.apple.BarcodeScanner,2,1734326619,1734326621,1734326621,-21600,iPhone
com.apple.mobiletimer,3,1734326609,1734326612,1734326613,-21600,iPhone
com.apple.mobiletimer,5,1734326547,1734326552,1734326553,-21600,iPhone
com.microsoft.Office.Outlook,4,1734326542,1734326546,1734326546,-21600,iPhone
com.tencent.xin,8,1734326533,1734326541,1734326541,-21600,iPhone
com.tencent.xin,6,1734326386,1734326392,1734326392,-21600,iPhone
com.tencent.xin,6,1734326354,1734326360,1734326360,-21600,iPhone
com.tencent.xin,10,1734326343,1734326353,1734326354,-21600,iPhone
com.tencent.xin,1,1734326101,1734326102,1734326103,-21600,iPhone
com.tencent.xin,8,1734326091,1734326099,1734326100,-21600,iPhone
com.apple.camera,1,1734326096,1734326097,1734326097,-21600,iPhone
com.google.Chrome,351,1734325736,1734326087,1734326087,-21600,MacBook
com.tencent.xin,57,1734325994,1734326051,1734326052,-21600,iPhone
com.apple.MobileSMS,5,1734325989,1734325994,1734325995,-21600,iPhone
com.tencent.xin,1,1734325986,1734325987,1734325988,-21600,iPhone
com.microsoft.Office.Outlook,12,1734325973,1734325985,1734325986,-21600,iPhone
com.apple.finder,1,1734325735,1734325736,1734325737,-21600,MacBook
com.apple.Preview,14,1734325721,1734325735,1734325735,-21600,MacBook
com.apple.finder,3,1734325718,1734325721,1734325722,-21600,MacBook
com.google.Chrome,428,1734325290,1734325718,1734325719,-21600,MacBook
com.apple.finder,2,1734325288,1734325290,1734325290,-21600,MacBook
com.tencent.xinWeChat,41,1734325247,1734325288,1734325289,-21600,MacBook
com.apple.finder,0,1734325247,1734325247,1734325248,-21600,MacBook
com.google.Chrome,89,1734325158,1734325247,1734325248,-21600,MacBook
com.microsoft.Office.Outlook,1,1734325217,1734325218,1734325219,-21600,iPhone
com.microsoft.Office.Outlook,31,1734325174,1734325205,1734325206,-21600,iPhone
com.apple.mobiletimer,3,1734325151,1734325154,1734325154,-21600,iPhone
com.apple.mobiletimer,5,1734324937,1734324942,1734324942,-21600,iPhone
com.apple.mobiletimer,6,1734324692,1734324698,1734324698,-21600,iPhone
com.apple.mobiletimer,5,1734324686,1734324691,1734324692,-21600,iPhone
com.apple.finder,7,1734324529,1734324536,1734324536,-21600,MacBook
com.google.Chrome,78,1734324451,1734324529,1734324529,-21600,MacBook
com.apple.mobiletimer,46,1734324469,1734324515,1734324515,-21600,iPhone
com.apple.finder,0,1734324451,1734324451,1734324452,-21600,MacBook
com.google.Chrome,449,1734324002,1734324451,1734324451,-21600,MacBook
com.apple.mobiletimer,8,1734324079,1734324087,1734324088,-21600,iPhone
com.apple.finder,1,1734324001,1734324002,1734324002,-21600,MacBook
com.google.Chrome,1609,1734322392,1734324001,1734324001,-21600,MacBook
com.apple.mobiletimer,10,1734322630,1734322640,1734322640,-21600,iPhone
com.apple.Preferences,2,1734322627,1734322629,1734322630,-21600,iPhone
com.apple.Preferences,12,1734322331,1734322343,1734322343,-21600,iPhone
com.google.calendar,2,1734322322,1734322324,1734322324,-21600,iPhone
com.netease.cloudmusic,2,1734322318,1734322320,1734322321,-21600,iPhone
com.google.Chrome,1748,1734319504,1734321252,1734321253,-21600,MacBook
com.apple.finder,1,1734319503,1734319504,1734319504,-21600,MacBook
com.google.Chrome,1475,1734318028,1734319503,1734319504,-21600,MacBook
com.apple.finder,1,1734318027,1734318028,1734318028,-21600,MacBook
com.google.Chrome,737,1734317290,1734318027,1734318028,-21600,MacBook
com.adobe.acc.AdobeCreativeCloud,2,1734317288,1734317290,1734317290,-21600,MacBook
com.google.Chrome,161,1734317127,1734317288,1734317289,-21600,MacBook
com.apple.finder,11,1734315891,1734315902,1734315903,-21600,MacBook
com.netease.cloudmusic,12,1734315698,1734315710,1734315710,-21600,iPhone
com.netease.cloudmusic,1,1734315483,1734315484,1734315485,-21600,iPhone
com.netease.cloudmusic,22,1734315376,1734315398,1734315398,-21600,iPhone
com.netease.cloudmusic,14,1734315355,1734315369,1734315370,-21600,iPhone
com.netease.cloudmusic,4,1734315345,1734315349,1734315350,-21600,iPhone
com.netease.cloudmusic,2,1734315226,1734315228,1734315228,-21600,iPhone
com.netease.cloudmusic,36,1734314801,1734314837,1734314838,-21600,iPhone
com.fobwifi.fobwifi,76,1734314725,1734314801,1734314802,-21600,iPhone
com.duosecurity.DuoMobile,1,1734314724,1734314725,1734314725,-21600,iPhone
com.netease.cloudmusic,38,1734314684,1734314722,1734314723,-21600,iPhone
com.fobwifi.fobwifi,1,1734314682,1734314683,1734314684,-21600,iPhone
com.apple.Preferences,14,1734314661,1734314675,1734314675,-21600,iPhone
com.tencent.xin,4,1734314657,1734314661,1734314661,-21600,iPhone
com.tencent.xin,4,1734314160,1734314164,1734314165,-21600,iPhone
com.tencent.xin,2,1734313937,1734313939,1734313940,-21600,iPhone
com.tencent.xin,7,1734313923,1734313930,1734313931,-21600,iPhone
com.tinyspeck.chatlyio,6,1734313916,1734313922,1734313923,-21600,iPhone
com.tencent.xin,4,1734313910,1734313914,1734313914,-21600,iPhone
com.tencent.xin,69,1734313840,1734313909,1734313909,-21600,iPhone
com.apple.camera,6,1734312199,1734312205,1734312206,-21600,iPhone
com.tencent.xin,32,1734312171,1734312203,1734312204,-21600,iPhone
com.apple.PassbookUIService,21,1734312176,1734312197,1734312198,-21600,iPhone
com.tencent.xin,5,1734311811,1734311816,1734311817,-21600,iPhone
com.tencent.xin,115,1734311640,1734311755,1734311756,-21600,iPhone
com.apple.finder,39,1734310201,1734310240,1734310241,-21600,MacBook
com.google.Chrome,12,1734310189,1734310201,1734310202,-21600,MacBook
com.apple.finder,1,1734310188,1734310189,1734310189,-21600,MacBook
com.apple.Preview,4,1734310184,1734310188,1734310188,-21600,MacBook
com.google.Chrome,606,1734309578,1734310184,1734310185,-21600,MacBook
com.google.Chrome,70,1734309039,1734309109,1734309110,-21600,MacBook
com.apple.Preview,1,1734309038,1734309039,1734309039,-21600,MacBook
com.tencent.xinWeChat,146,1734308892,1734309038,1734309039,-21600,MacBook
com.tencent.xin,63,1734308964,1734309027,1734309028,-21600,iPhone
com.apple.Preview,0,1734308892,1734308892,1734308893,-21600,MacBook
com.google.Chrome,531,1734308361,1734308892,1734308893,-21600,MacBook
com.apple.Preview,2,1734307976,1734307978,1734307978,-21600,MacBook
com.apple.finder,1,1734307975,1734307976,1734307977,-21600,MacBook
com.tencent.xinWeChat,2,1734307973,1734307975,1734307976,-21600,MacBook
com.apple.finder,0,1734307973,1734307973,1734307974,-21600,MacBook
com.tencent.xinWeChat,1,1734307972,1734307973,1734307973,-21600,MacBook
com.apple.Preview,6,1734307966,1734307972,1734307973,-21600,MacBook
com.google.Chrome,93,1734307873,1734307966,1734307967,-21600,MacBook
com.apple.Preview,1,1734307872,1734307873,1734307874,-21600,MacBook
com.tencent.xinWeChat,4,1734307868,1734307872,1734307873,-21600,MacBook
com.apple.finder,1,1734307867,1734307868,1734307868,-21600,MacBook
com.tencent.xinWeChat,19,1734307848,1734307867,1734307867,-21600,MacBook
com.apple.Preview,0,1734307848,1734307848,1734307849,-21600,MacBook
com.google.Chrome,197,1734307651,1734307848,1734307849,-21600,MacBook
com.apple.Preview,1,1734307650,1734307651,1734307652,-21600,MacBook
com.google.Chrome,121,1734307529,1734307650,1734307650,-21600,MacBook
com.apple.finder,1,1734307528,1734307529,1734307530,-21600,MacBook
com.apple.Preview,1,1734307527,1734307528,1734307529,-21600,MacBook
com.google.Chrome,267,1734307260,1734307527,1734307528,-21600,MacBook
com.apple.Preview,5,1734307255,1734307260,1734307261,-21600,MacBook
com.apple.finder,1,1734307254,1734307255,1734307255,-21600,MacBook
com.apple.Preview,2,1734307252,1734307254,1734307255,-21600,MacBook
com.apple.Notes,0,1734307252,1734307252,1734307253,-21600,MacBook
com.apple.finder,1,1734307251,1734307252,1734307252,-21600,MacBook
com.google.Chrome,8,1734307243,1734307251,1734307252,-21600,MacBook
com.apple.finder,2,1734307241,1734307243,1734307244,-21600,MacBook
com.google.Chrome,12,1734307229,1734307241,1734307241,-21600,MacBook
com.apple.finder,3,1734307226,1734307229,1734307230,-21600,MacBook
com.google.Chrome,58,1734307168,1734307226,1734307227,-21600,MacBook
com.apple.Notes,2,1734307166,1734307168,1734307168,-21600,MacBook
com.google.Chrome,6,1734307160,1734307166,1734307166,-21600,MacBook
com.apple.Notes,9,1734307151,1734307160,1734307161,-21600,MacBook
com.apple.Preview,1,1734307150,1734307151,1734307152,-21600,MacBook
com.google.Chrome,99,1734307051,1734307150,1734307151,-21600,MacBook
com.apple.Preview,4,1734307047,1734307051,1734307051,-21600,MacBook
com.google.Chrome,89,1734306958,1734307047,1734307047,-21600,MacBook
com.apple.Preview,11,1734306947,1734306958,1734306958,-21600,MacBook
com.apple.finder,8,1734306939,1734306947,1734306947,-21600,MacBook
com.apple.Notes,2,1734306937,1734306939,1734306940,-21600,MacBook
com.google.Chrome,1,1734306936,1734306937,1734306938,-21600,MacBook
com.apple.Notes,1,1734306935,1734306936,1734306937,-21600,MacBook
com.google.Chrome,106,1734306829,1734306935,1734306936,-21600,MacBook
com.apple.Notes,14,1734306815,1734306829,1734306830,-21600,MacBook
com.google.Chrome,75,1734306740,1734306815,1734306815,-21600,MacBook
com.apple.Notes,12,1734306728,1734306740,1734306741,-21600,MacBook
com.google.Chrome,3,1734306725,1734306728,1734306729,-21600,MacBook
com.apple.Notes,2,1734306723,1734306725,1734306725,-21600,MacBook
com.google.Chrome,10,1734306713,1734306723,1734306723,-21600,MacBook
com.apple.Notes,10,1734306703,1734306713,1734306713,-21600,MacBook
com.google.Chrome,0,1734306703,1734306703,1734306704,-21600,MacBook
com.apple.Notes,24,1734306679,1734306703,1734306703,-21600,MacBook
com.google.Chrome,11,1734306668,1734306679,1734306680,-21600,MacBook
com.apple.Notes,16,1734306652,1734306668,1734306669,-21600,MacBook
com.apple.finder,1,1734306651,1734306652,1734306652,-21600,MacBook
com.google.Chrome,121,1734306530,1734306651,1734306651,-21600,MacBook
com.tencent.xin,10,1734306570,1734306580,1734306580,-21600,iPhone
com.duosecurity.DuoMobile,7,1734306562,1734306569,1734306569,-21600,iPhone
com.tinyspeck.chatlyio,13,1734306547,1734306560,1734306560,-21600,iPhone
com.tencent.xin,6,1734306541,1734306547,1734306548,-21600,iPhone
com.apple.finder,3,1734306527,1734306530,1734306530,-21600,MacBook
com.tencent.xinWeChat,6,1734306521,1734306527,1734306527,-21600,MacBook
com.google.Chrome,7,1734306514,1734306521,1734306521,-21600,MacBook
com.tencent.xinWeChat,6,1734306508,1734306514,1734306514,-21600,MacBook
com.google.Chrome,544,1734305964,1734306508,1734306508,-21600,MacBook
com.apple.finder,11,1734305938,1734305949,1734305949,-21600,MacBook
com.apple.Preview,3,1734305935,1734305938,1734305938,-21600,MacBook
com.tencent.xinWeChat,2,1734305933,1734305935,1734305936,-21600,MacBook
com.google.Chrome,10,1734305923,1734305933,1734305933,-21600,MacBook
com.google.Chrome,541,1734305244,1734305785,1734305786,-21600,MacBook
com.tencent.xinWeChat,27,1734304767,1734304794,1734304795,-21600,MacBook
com.google.Chrome,2,1734304765,1734304767,1734304768,-21600,MacBook
com.tencent.xinWeChat,2,1734304763,1734304765,1734304766,-21600,MacBook
com.google.Chrome,4,1734304759,1734304763,1734304764,-21600,MacBook
com.tencent.xinWeChat,4,1734304755,1734304759,1734304759,-21600,MacBook
com.google.Chrome,62,1734304693,1734304755,1734304756,-21600,MacBook
com.tencent.xinWeChat,13,1734304680,1734304693,1734304694,-21600,MacBook
com.google.Chrome,7,1734304673,1734304680,1734304681,-21600,MacBook
com.tencent.xinWeChat,7,1734304666,1734304673,1734304674,-21600,MacBook
com.google.Chrome,7,1734304659,1734304666,1734304667,-21600,MacBook
com.tencent.xinWeChat,28,1734304631,1734304659,1734304660,-21600,MacBook
com.google.Chrome,122,1734304509,1734304631,1734304632,-21600,MacBook
com.tencent.xinWeChat,55,1734304454,1734304509,1734304509,-21600,MacBook
com.google.Chrome,20,1734304434,1734304454,1734304454,-21600,MacBook
com.tencent.xinWeChat,9,1734304425,1734304434,1734304434,-21600,MacBook
com.google.Chrome,3,1734304422,1734304425,1734304426,-21600,MacBook
com.tencent.xinWeChat,3,1734304419,1734304422,1734304423,-21600,MacBook
com.apple.Preview,1,1734304418,1734304419,1734304420,-21600,MacBook
com.apple.finder,7,1734304411,1734304418,1734304418,-21600,MacBook
com.google.Chrome,30,1734304381,1734304411,1734304412,-21600,MacBook
com.apple.finder,1,1734304380,1734304381,1734304382,-21600,MacBook
com.tencent.xinWeChat,73,1734304307,1734304380,1734304381,-21600,MacBook
com.tencent.xin,5,1734304311,1734304316,1734304317,-21600,iPhone
com.apple.finder,4,1734304303,1734304307,1734304307,-21600,MacBook
com.tencent.xinWeChat,1,1734304302,1734304303,1734304304,-21600,MacBook
com.apple.Preview,1,1734304301,1734304302,1734304303,-21600,MacBook
com.apple.finder,1,1734304300,1734304301,1734304302,-21600,MacBook
com.apple.Preview,0,1734304300,1734304300,1734304301,-21600,MacBook
com.tencent.xinWeChat,1,1734304299,1734304300,1734304300,-21600,MacBook
com.apple.finder,1,1734304298,1734304299,1734304299,-21600,MacBook
com.apple.Preview,1,1734304297,1734304298,1734304299,-21600,MacBook
com.google.Chrome,46,1734304251,1734304297,1734304297,-21600,MacBook
com.apple.Preview,2,1734304249,1734304251,1734304252,-21600,MacBook
com.google.Chrome,26,1734304223,1734304249,1734304250,-21600,MacBook
com.apple.Preview,3,1734304220,1734304223,1734304223,-21600,MacBook
com.apple.finder,1,1734304219,1734304220,1734304221,-21600,MacBook
com.apple.Preview,29,1734304190,1734304219,1734304220,-21600,MacBook
com.apple.finder,0,1734304190,1734304190,1734304191,-21600,MacBook
com.apple.Preview,2,1734304188,1734304190,1734304190,-21600,MacBook
com.apple.finder,3,1734304185,1734304188,1734304188,-21600,MacBook
com.apple.Preview,5,1734304180,1734304185,1734304185,-21600,MacBook
com.google.Chrome,3,1734304177,1734304180,1734304180,-21600,MacBook
com.apple.Preview,3,1734304174,1734304177,1734304177,-21600,MacBook
com.google.Chrome,8,1734304166,1734304174,1734304175,-21600,MacBook
com.apple.Preview,3,1734304163,1734304166,1734304166,-21600,MacBook
com.google.Chrome,93,1734304070,1734304163,1734304164,-21600,MacBook
com.apple.Preview,11,1734304059,1734304070,1734304070,-21600,MacBook
com.apple.finder,1,1734304058,1734304059,1734304059,-21600,MacBook
com.apple.Preview,2,1734304056,1734304058,1734304058,-21600,MacBook
com.apple.finder,3,1734304053,1734304056,1734304056,-21600,MacBook
com.microsoft.Outlook,54,1734303999,1734304053,1734304053,-21600,MacBook
com.apple.finder,2,1734303997,1734303999,1734304000,-21600,MacBook
us.zoom.xos,9,1734303988,1734303997,1734303998,-21600,MacBook
com.microsoft.Outlook,23,1734303965,1734303988,1734303989,-21600,MacBook
us.zoom.xos,3,1734303962,1734303965,1734303965,-21600,MacBook
com.microsoft.Outlook,16,1734303946,1734303962,1734303962,-21600,MacBook
com.apple.finder,3,1734303943,1734303946,1734303946,-21600,MacBook
com.apple.Preview,4,1734303939,1734303943,1734303943,-21600,MacBook
com.apple.finder,23,1734303916,1734303939,1734303939,-21600,MacBook
com.microsoft.Outlook,3,1734303913,1734303916,1734303916,-21600,MacBook
com.google.Chrome,19,1734303894,1734303913,1734303914,-21600,MacBook
com.tencent.xin,28,1734303552,1734303580,1734303581,-21600,iPhone
com.apple.mobilenotes,2,1734303550,1734303552,1734303552,-21600,iPhone
com.apple.mobilephone,30,1734303520,1734303550,1734303550,-21600,iPhone
com.google.Chrome,46,1734303232,1734303278,1734303279,-21600,MacBook
com.microsoft.Outlook,6,1734303226,1734303232,1734303232,-21600,MacBook
com.apple.systempreferences,0,1734303226,1734303226,1734303227,-21600,MacBook
com.google.Chrome,606,1734302620,1734303226,1734303227,-21600,MacBook
com.apple.systempreferences,90,1734302148,1734302238,1734302238,-21600,MacBook
com.apple.Preferences,92,1734302129,1734302221,1734302221,-21600,iPhone
com.tencent.weread,1,1734301924,1734301925,1734301926,-21600,iPhone
com.tencent.weread,52,1734301717,1734301769,1734301770,-21600,iPhone
com.apple.Preferences,3,1734301714,1734301717,1734301717,-21600,iPhone
com.tencent.weread,27,1734301687,1734301714,1734301714,-21600,iPhone
com.tencent.xin,5,1734301626,1734301631,1734301632,-21600,iPhone
com.apple.Preferences,10,1734301616,1734301626,1734301627,-21600,iPhone
com.tencent.xin,10,1734301606,1734301616,1734301616,-21600,iPhone
com.tencent.xin,40,1734301489,1734301529,1734301530,-21600,iPhone
com.tencent.xin,2,1734301360,1734301362,1734301362,-21600,iPhone
com.tencent.xin,6,1734301342,1734301348,1734301349,-21600,iPhone
com.tencent.xin,211,1734300937,1734301148,1734301149,-21600,iPhone
com.openai.chat,34,1734300903,1734300937,1734300938,-21600,iPhone
com.microsoft.Office.Outlook,76,1734300827,1734300903,1734300903,-21600,iPhone
com.apple.Preferences,3,1734300823,1734300826,1734300827,-21600,iPhone
com.tencent.xin,22,1734300801,1734300823,1734300824,-21600,iPhone
com.microsoft.Office.Outlook,5,1734300796,1734300801,1734300802,-21600,iPhone
com.tencent.xin,0,1734300796,1734300796,1734300797,-21600,iPhone
com.microsoft.Office.Outlook,2,1734300794,1734300796,1734300796,-21600,iPhone
com.apple.Preferences,4,1734300790,1734300794,1734300795,-21600,iPhone
com.tencent.xin,2,1734300166,1734300168,1734300169,-21600,iPhone
com.tencent.xin,29,1734300016,1734300045,1734300046,-21600,iPhone
com.differentsocial.Weee,4,1734300012,1734300016,1734300016,-21600,iPhone
com.differentsocial.Weee,49,1734299660,1734299709,1734299709,-21600,iPhone
com.tencent.xin,2,1734299651,1734299653,1734299654,-21600,iPhone
com.tencent.xin,32,1734299559,1734299591,1734299592,-21600,iPhone
com.tencent.xin,12,1734299393,1734299405,1734299405,-21600,iPhone
com.apple.mobilenotes,3,1734299390,1734299393,1734299393,-21600,iPhone
com.apple.mobilenotes,2,1734299303,1734299305,1734299306,-21600,iPhone
com.apple.mobilenotes,10,1734299267,1734299277,1734299277,-21600,iPhone
com.google.Maps,2,1734299265,1734299267,1734299268,-21600,iPhone
com.tencent.xin,3,1734299262,1734299265,1734299265,-21600,iPhone
com.tencent.xin,2,1734299231,1734299233,1734299234,-21600,iPhone
com.tencent.xin,21,1734299175,1734299196,1734299197,-21600,iPhone
com.google.Maps,13,1734299162,1734299175,1734299176,-21600,iPhone
com.tencent.xin,23,1734299139,1734299162,1734299163,-21600,iPhone
com.google.Maps,23,1734299116,1734299139,1734299140,-21600,iPhone
com.tencent.xin,11,1734299105,1734299116,1734299117,-21600,iPhone
com.google.Maps,5,1734299100,1734299105,1734299105,-21600,iPhone
com.tencent.xin,6,1734299094,1734299100,1734299101,-21600,iPhone
com.google.Maps,6,1734299088,1734299094,1734299095,-21600,iPhone
com.tencent.xin,1,1734299087,1734299088,1734299089,-21600,iPhone
com.google.Maps,10,1734299076,1734299086,1734299087,-21600,iPhone
com.google.Maps,6,1734298955,1734298961,1734298962,-21600,iPhone
com.google.Maps,64,1734298883,1734298947,1734298947,-21600,iPhone
com.apple.mobilenotes,22,1734298861,1734298883,1734298884,-21600,iPhone
com.google.Maps,30,1734298830,1734298860,1734298861,-21600,iPhone
com.instructure.icanvas,3,1734298827,1734298830,1734298830,-21600,iPhone
com.instructure.icanvas,27,1734298790,1734298817,1734298817,-21600,iPhone
com.microsoft.Office.Outlook,5,1734298782,1734298787,1734298788,-21600,iPhone
com.google.Maps,2,1734298780,1734298782,1734298783,-21600,iPhone
com.microsoft.Office.Outlook,5,1734298775,1734298780,1734298780,-21600,iPhone
com.tencent.xin,13,1734298761,1734298774,1734298775,-21600,iPhone
com.tencent.xin,5,1734298546,1734298551,1734298552,-21600,iPhone
com.tencent.xin,19,1734298526,1734298545,1734298546,-21600,iPhone
com.tencent.xin,2,1734298326,1734298328,1734298329,-21600,iPhone
com.tencent.xin,166,1734298087,1734298253,1734298255,-21600,iPhone
com.instructure.icanvas,4,1734298083,1734298087,1734298087,-21600,iPhone
com.instructure.icanvas,12,1734297506,1734297518,1734297519,-21600,iPhone
com.discoverfinancial.mobile,3,1734297503,1734297506,1734297507,-21600,iPhone
com.discoverfinancial.mobile,10,1734297299,1734297309,1734297309,-21600,iPhone
com.discoverfinancial.mobile,1,1734296867,1734296868,1734296868,-21600,iPhone
com.discoverfinancial.mobile,3,1734296855,1734296858,1734296858,-21600,iPhone
com.discoverfinancial.mobile,34,1734296604,1734296638,1734296638,-21600,iPhone
com.apple.CoreAuthUI,2,1734296614,1734296616,1734296617,-21600,iPhone
com.tencent.xin,3,1734296600,1734296603,1734296604,-21600,iPhone
com.tencent.xin,7,1734296372,1734296379,1734296380,-21600,iPhone
com.tinyspeck.chatlyio,7,1734296365,1734296372,1734296373,-21600,iPhone
com.microsoft.Office.Outlook,32,1734296333,1734296365,1734296366,-21600,iPhone
com.tinyspeck.chatlyio,16,1734296317,1734296333,1734296334,-21600,iPhone
com.tencent.xin,5,1734296310,1734296315,1734296316,-21600,iPhone
com.tencent.xin,6,1734296214,1734296220,1734296221,-21600,iPhone
com.tencent.xin,78,1734296135,1734296213,1734296214,-21600,iPhone
com.tencent.xin,64,1734296069,1734296133,1734296134,-21600,iPhone
com.tencent.xin,20,1734296009,1734296029,1734296030,-21600,iPhone
com.tencent.xin,17,1734295786,1734295803,1734295804,-21600,iPhone
com.tencent.xin,73,1734295067,1734295140,1734295141,-21600,iPhone
com.tencent.xin,6,1734294788,1734294794,1734294794,-21600,iPhone
com.tencent.xin,60,1734294642,1734294702,1734294703,-21600,iPhone
com.tencent.xin,24,1734294617,1734294641,1734294641,-21600,iPhone
com.tencent.xin,9,1734294603,1734294612,1734294612,-21600,iPhone
com.tencent.xin,79,1734294506,1734294585,1734294586,-21600,iPhone
com.tencent.xin,80,1734294385,1734294465,1734294466,-21600,iPhone
com.tencent.xin,4,1734294379,1734294383,1734294384,-21600,iPhone
com.tencent.xin,15,1734294361,1734294376,1734294376,-21600,iPhone
com.tencent.xin,126,1734294233,1734294359,1734294359,-21600,iPhone
com.tencent.xin,69,1734294164,1734294233,1734294233,-21600,iPhone
com.instructure.icanvas,0,1734294164,1734294164,1734294165,-21600,iPhone
com.google.chrome.ios,21,1734294143,1734294164,1734294164,-21600,iPhone
com.instructure.icanvas,17,1734294126,1734294143,1734294144,-21600,iPhone
com.tencent.xin,23,1734294101,1734294124,1734294125,-21600,iPhone
com.tencent.xin,120,1734293979,1734294099,1734294100,-21600,iPhone
com.bilibili.bilicomic,10,1734293969,1734293979,1734293979,-21600,iPhone
com.tencent.xin,5,1734293957,1734293962,1734293963,-21600,iPhone
com.bilibili.bilicomic,25,1734293932,1734293957,1734293958,-21600,iPhone
com.bilibili.bilicomic,2,1734293929,1734293931,1734293931,-21600,iPhone
com.tencent.xin,42,1734293885,1734293927,1734293928,-21600,iPhone
com.tencent.xin,2,1734293875,1734293877,1734293878,-21600,iPhone
com.tencent.xin,9,1734293865,1734293874,1734293875,-21600,iPhone
com.tencent.xin,7,1734293799,1734293806,1734293806,-21600,iPhone
com.tencent.xin,1,1734293795,1734293796,1734293797,-21600,iPhone
com.tencent.xin,1,1734293789,1734293790,1734293791,-21600,iPhone
com.tencent.xin,2,1734293786,1734293788,1734293788,-21600,iPhone
com.tencent.xin,2,1734293779,1734293781,1734293781,-21600,iPhone
com.tencent.xin,39,1734293722,1734293761,1734293763,-21600,iPhone
com.xingin.discover,28,1734293694,1734293722,1734293723,-21600,iPhone
com.microsoft.Office.Outlook,22,1734293672,1734293694,1734293695,-21600,iPhone
com.xingin.discover,1296,1734292374,1734293670,1734293671,-21600,iPhone
com.xingin.discover,995,1734291378,1734292373,1734292374,-21600,iPhone
com.tencent.xin,124,1734291252,1734291376,1734291377,-21600,iPhone
com.tencent.xin,74,1734291177,1734291251,1734291252,-21600,iPhone
com.microsoft.Office.Outlook,2,1734291175,1734291177,1734291177,-21600,iPhone
com.tencent.xin,144,1734291030,1734291174,1734291175,-21600,iPhone
com.apple.MobileSMS,2,1734291026,1734291028,1734291029,-21600,iPhone
com.apple.MobileSMS,7,1734291018,1734291025,1734291025,-21600,iPhone
com.apple.mobilesafari,5,1734291011,1734291016,1734291017,-21600,iPhone
com.apple.mobilesafari,4,1734291007,1734291011,1734291011,-21600,iPhone
com.apple.mobilesafari,72,1734290824,1734290896,1734290897,-21600,iPhone
com.apple.mobilesafari,4,1734290819,1734290823,1734290824,-21600,iPhone
com.apple.mobilesafari,141,1734290315,1734290456,1734290457,-21600,iPhone
com.apple.Preferences,5,1734290310,1734290315,1734290316,-21600,iPhone
com.apple.mobilesafari,4,1734290306,1734290310,1734290310,-21600,iPhone
com.apple.mobilesafari,2775,1734287294,1734290069,1734290070,-21600,iPhone
com.apple.mobilesafari,4777,1734282516,1734287293,1734287294,-21600,iPhone
com.google.chrome.ios,31,1734282484,1734282515,1734282516,-21600,iPhone
com.bilibili.bilicomic,108,1734282374,1734282482,1734282482,-21600,iPhone
com.apple.mobiletimer,2,1734280904,1734280906,1734280907,-21600,iPhone
com.apple.mobiletimer,5,1734280897,1734280902,1734280903,-21600,iPhone
com.apple.mobiletimer,25,1734280800,1734280825,1734280825,-21600,iPhone
com.apple.mobiletimer,7,1734279708,1734279715,1734279715,-21600,iPhone
com.apple.camera,2,1734279711,1734279713,1734279713,-21600,iPhone
com.apple.mobiletimer,25,1734279600,1734279625,1734279625,-21600,iPhone
com.apple.mobiletimer,2,1734277536,1734277538,1734277538,-21600,iPhone
com.apple.mobiletimer,6,1734277529,1734277535,1734277536,-21600,iPhone
com.tencent.xin,29,1734277500,1734277529,1734277529,-21600,iPhone
com.tencent.xin,18,1734275813,1734275831,1734275831,-21600,iPhone
com.microsoft.Office.Outlook,13,1734275798,1734275811,1734275812,-21600,iPhone
com.tencent.xin,1,1734275797,1734275798,1734275799,-21600,iPhone
com.apple.mobiletimer,20,1734275775,1734275795,1734275796,-21600,iPhone
com.apple.finder,11,1734251695,1734251706,1734251706,-21600,MacBook
com.apple.finder,7,1734251286,1734251293,1734251293,-21600,MacBook
com.google.Chrome,3,1734251283,1734251286,1734251286,-21600,MacBook
com.apple.finder,8,1734251275,1734251283,1734251283,-21600,MacBook
com.apple.Notes,64,1734251211,1734251275,1734251275,-21600,MacBook
com.apple.finder,1,1734251210,1734251211,1734251212,-21600,MacBook
com.google.Chrome,7,1734251203,1734251210,1734251210,-21600,MacBook
com.tinyspeck.slackmacgap,6,1734251197,1734251203,1734251204,-21600,MacBook
com.apple.finder,4,1734251193,1734251197,1734251198,-21600,MacBook
com.apple.systempreferences,5,1734251188,1734251193,1734251193,-21600,MacBook
com.google.Chrome,2,1734251186,1734251188,1734251188,-21600,MacBook
com.apple.systempreferences,45,1734251141,1734251186,1734251187,-21600,MacBook
com.apple.finder,1,1734251140,1734251141,1734251141,-21600,MacBook
com.apple.systempreferences,2,1734251138,1734251140,1734251141,-21600,MacBook
com.apple.finder,1,1734251121,1734251122,1734251122,-21600,MacBook
com.apple.systempreferences,4,1734251117,1734251121,1734251122,-21600,MacBook
com.microsoft.Outlook,3,1734251114,1734251117,1734251117,-21600,MacBook
com.apple.systempreferences,17,1734251097,1734251114,1734251115,-21600,MacBook
com.google.Chrome,4,1734251092,1734251096,1734251097,-21600,MacBook
com.apple.systempreferences,1,1734251085,1734251086,1734251087,-21600,MacBook
com.google.Chrome,16,1734251069,1734251085,1734251086,-21600,MacBook
com.microsoft.Outlook,3,1734251066,1734251069,1734251070,-21600,MacBook
com.google.Chrome,1,1734251065,1734251066,1734251067,-21600,MacBook
com.microsoft.Outlook,2,1734251063,1734251065,1734251066,-21600,MacBook
com.google.Chrome,6,1734251057,1734251063,1734251064,-21600,MacBook
com.microsoft.Outlook,14,1734251043,1734251057,1734251057,-21600,MacBook
com.google.Chrome,12,1734251031,1734251043,1734251049,-21600,MacBook
com.apple.Notes,9,1734251005,1734251014,1734251048,-21600,MacBook
com.apple.mobiletimer,17,1734250568,1734250585,1734250586,-21600,iPhone
com.apple.mobiletimer,6,1734250559,1734250565,1734250566,-21600,iPhone
com.apple.mobiletimer,3,1734250522,1734250525,1734250526,-21600,iPhone
com.apple.mobiletimer,2,1734250052,1734250054,1734250054,-21600,iPhone
com.apple.mobiletimer,6,1734249991,1734249997,1734249998,-21600,iPhone
com.apple.Notes,4,1734249975,1734249979,1734249980,-21600,MacBook
com.apple.Notes,2527,1734246762,1734249289,1734249289,-21600,MacBook
com.google.Chrome,1,1734246761,1734246762,1734246762,-21600,MacBook
com.apple.Notes,6,1734246755,1734246761,1734246761,-21600,MacBook
com.google.Chrome,53,1734246702,1734246755,1734246756,-21600,MacBook
com.apple.Notes,15,1734246687,1734246702,1734246703,-21600,MacBook
com.google.Chrome,3,1734246684,1734246687,1734246688,-21600,MacBook
com.apple.Notes,39,1734246645,1734246684,1734246684,-21600,MacBook
com.google.Chrome,114,1734246520,1734246634,1734246634,-21600,MacBook
com.apple.Notes,422,1734246098,1734246520,1734246521,-21600,MacBook
com.google.Chrome,2,1734246096,1734246098,1734246098,-21600,MacBook
com.apple.Notes,5,1734246091,1734246096,1734246097,-21600,MacBook
com.apple.Notes,118,1734245783,1734245901,1734245901,-21600,MacBook
com.google.Chrome,1,1734245782,1734245783,1734245784,-21600,MacBook
com.apple.Notes,405,1734245377,1734245782,1734245784,-21600,MacBook
com.google.Chrome,2,1734245375,1734245377,1734245378,-21600,MacBook
com.apple.Notes,75,1734245300,1734245375,1734245376,-21600,MacBook
com.tencent.xinWeChat,17,1734245283,1734245300,1734245301,-21600,MacBook
com.apple.Notes,9,1734245274,1734245283,1734245284,-21600,MacBook
com.google.Chrome,26,1734245248,1734245274,1734245275,-21600,MacBook
com.apple.Notes,1449,1734243799,1734245248,1734245249,-21600,MacBook
com.google.Chrome,1,1734243798,1734243799,1734243799,-21600,MacBook
com.apple.Notes,27,1734243771,1734243798,1734243799,-21600,MacBook
org.twinery.twine,1,1734243770,1734243771,1734243772,-21600,MacBook
com.apple.Notes,2,1734243768,1734243770,1734243771,-21600,MacBook
com.google.Chrome,3,1734243765,1734243768,1734243769,-21600,MacBook
org.twinery.twine,7,1734243758,1734243765,1734243765,-21600,MacBook
com.google.Chrome,59,1734243699,1734243758,1734243759,-21600,MacBook
org.twinery.twine,44,1734243655,1734243699,1734243700,-21600,MacBook
com.google.Chrome,407,1734243248,1734243655,1734243655,-21600,MacBook
org.twinery.twine,17,1734243231,1734243248,1734243249,-21600,MacBook
com.google.Chrome,26,1734243205,1734243231,1734243232,-21600,MacBook
org.twinery.twine,4,1734243201,1734243205,1734243206,-21600,MacBook
com.google.Chrome,23,1734243178,1734243201,1734243201,-21600,MacBook
org.twinery.twine,32,1734243146,1734243178,1734243179,-21600,MacBook
com.apple.Notes,1,1734243145,1734243146,1734243147,-21600,MacBook
org.twinery.twine,1,1734243144,1734243145,1734243145,-21600,MacBook
com.apple.Notes,12,1734243132,1734243144,1734243144,-21600,MacBook
com.google.Chrome,87,1734243045,1734243132,1734243132,-21600,MacBook
com.apple.Notes,85,1734242960,1734243045,1734243045,-21600,MacBook
com.bilibili.bilicomic,16,1734242594,1734242610,1734242610,-21600,iPhone
tv.danmaku.bilianime,1,1734242593,1734242594,1734242595,-21600,iPhone
com.bilibili.bilicomic,1,1734242592,1734242593,1734242594,-21600,iPhone
com.google.calendar,14,1734242577,1734242591,1734242591,-21600,iPhone
com.apple.MobileSMS,17,1734242555,1734242572,1734242573,-21600,iPhone
com.apple.MobileSMS,33,1734242469,1734242502,1734242502,-21600,iPhone
com.openai.chat,10,1734242457,1734242467,1734242468,-21600,iPhone
com.apple.Notes,3,1734242452,1734242455,1734242456,-21600,MacBook
com.google.Chrome,3026,1734239426,1734242452,1734242453,-21600,MacBook
com.apple.Notes,6,1734239420,1734239426,1734239426,-21600,MacBook
com.google.Chrome,5,1734239415,1734239420,1734239421,-21600,MacBook
com.apple.Notes,1,1734239414,1734239415,1734239415,-21600,MacBook
com.google.Chrome,2,1734239412,1734239414,1734239414,-21600,MacBook
com.apple.Notes,10,1734239402,1734239412,1734239413,-21600,MacBook
com.google.Chrome,319,1734239083,1734239402,1734239402,-21600,MacBook
com.apple.Notes,26,1734239057,1734239083,1734239084,-21600,MacBook
com.google.Chrome,64,1734238993,1734239057,1734239058,-21600,MacBook
com.google.Chrome,53,1734238890,1734238943,1734238944,-21600,MacBook
com.apple.Notes,17,1734238873,1734238890,1734238890,-21600,MacBook
com.google.Chrome,43,1734238830,1734238873,1734238873,-21600,MacBook
com.apple.Notes,2,1734238828,1734238830,1734238831,-21600,MacBook
com.google.Chrome,4,1734238824,1734238828,1734238829,-21600,MacBook
com.apple.Notes,16,1734238808,1734238824,1734238824,-21600,MacBook
com.apple.finder,0,1734238808,1734238808,1734238808,-21600,MacBook
com.google.Chrome,862,1734237946,1734238808,1734238808,-21600,MacBook
com.apple.finder,12,1734237934,1734237946,1734237946,-21600,MacBook
com.google.Chrome,23,1734237911,1734237934,1734237934,-21600,MacBook
com.apple.finder,1,1734237910,1734237911,1734237912,-21600,MacBook
com.tencent.xinWeChat,5,1734237905,1734237910,1734237911,-21600,MacBook
com.tencent.xin,52,1734237808,1734237860,1734237861,-21600,iPhone
com.microsoft.Office.Outlook,7,1734237801,1734237808,1734237808,-21600,iPhone
com.apple.MobileSMS,236,1734237565,1734237801,1734237802,-21600,iPhone
com.microsoft.Office.Outlook,20,1734237545,1734237565,1734237566,-21600,iPhone
com.apple.MobileSMS,31,1734237514,1734237545,1734237546,-21600,iPhone
com.tencent.xin,2,1734237511,1734237513,1734237514,-21600,iPhone
com.tencent.xin,23,1734237444,1734237467,1734237468,-21600,iPhone
com.xingin.discover,877,1734236567,1734237444,1734237444,-21600,iPhone
com.tencent.xin,202,1734236365,1734236567,1734236568,-21600,iPhone
com.xingin.discover,89,1734236276,1734236365,1734236366,-21600,iPhone
com.tencent.xin,111,1734236165,1734236276,1734236277,-21600,iPhone
com.xingin.discover,170,1734235995,1734236165,1734236166,-21600,iPhone
com.amazon.Amazon,4,1734235991,1734235995,1734235995,-21600,iPhone
com.tencent.xin,448,1734235543,1734235991,1734235992,-21600,iPhone
com.tencent.xinWeChat,128,1734235425,1734235553,1734235554,-21600,MacBook
com.amazon.Amazon,14,1734235526,1734235540,1734235546,-21600,iPhone
com.apple.camera,7,1734235528,1734235535,1734235536,-21600,iPhone
com.apple.camera,1,1734235526,1734235527,1734235528,-21600,iPhone
com.google.Chrome,3,1734235422,1734235425,1734235425,-21600,MacBook
com.tencent.xinWeChat,240,1734235182,1734235422,1734235422,-21600,MacBook
com.google.Chrome,13,1734235169,1734235182,1734235183,-21600,MacBook
com.tencent.xinWeChat,108,1734235061,1734235169,1734235169,-21600,MacBook
com.google.Chrome,48,1734235013,1734235061,1734235062,-21600,MacBook
com.tencent.xinWeChat,25,1734234988,1734235013,1734235013,-21600,MacBook
com.google.Chrome,85,1734234903,1734234988,1734234988,-21600,MacBook
com.tencent.xinWeChat,37,1734234866,1734234903,1734234904,-21600,MacBook
com.google.Chrome,26,1734234840,1734234866,1734234866,-21600,MacBook
com.tencent.xinWeChat,182,1734234658,1734234840,1734234840,-21600,MacBook
com.google.Chrome,47,1734234611,1734234658,1734234659,-21600,MacBook
com.tencent.xinWeChat,16,1734234595,1734234611,1734234612,-21600,MacBook
com.google.Chrome,6,1734234589,1734234595,1734234596,-21600,MacBook
com.tencent.xinWeChat,35,1734234554,1734234589,1734234589,-21600,MacBook
com.apple.Notes,0,1734234554,1734234554,1734234555,-21600,MacBook
com.google.Chrome,422,1734234132,1734234554,1734234554,-21600,MacBook
com.apple.Notes,8,1734234124,1734234132,1734234133,-21600,MacBook
com.google.Chrome,4,1734234120,1734234124,1734234125,-21600,MacBook
com.apple.Notes,6,1734234114,1734234120,1734234121,-21600,MacBook
com.google.Chrome,7,1734234107,1734234114,1734234115,-21600,MacBook
com.apple.Notes,16,1734234091,1734234107,1734234108,-21600,MacBook
com.google.Chrome,3,1734234088,1734234091,1734234092,-21600,MacBook
com.apple.Notes,11,1734234077,1734234088,1734234088,-21600,MacBook
com.google.Chrome,15,1734234062,1734234077,1734234078,-21600,MacBook
com.apple.Notes,4,1734234058,1734234062,1734234063,-21600,MacBook
com.google.Chrome,109,1734233949,1734234058,1734234059,-21600,MacBook
com.apple.Notes,4,1734233945,1734233949,1734233950,-21600,MacBook
com.google.Chrome,51,1734233894,1734233945,1734233946,-21600,MacBook
com.apple.Notes,7,1734233887,1734233894,1734233894,-21600,MacBook
com.google.Chrome,11,1734233876,1734233887,1734233887,-21600,MacBook
com.apple.Notes,13,1734233863,1734233876,1734233877,-21600,MacBook
com.google.Chrome,1056,1734232807,1734233863,1734233864,-21600,MacBook
com.apple.Notes,199,1734232608,1734232807,1734232807,-21600,MacBook
com.google.Chrome,3,1734232605,1734232608,1734232608,-21600,MacBook
com.apple.Notes,28,1734232577,1734232605,1734232606,-21600,MacBook
com.apple.finder,0,1734232577,1734232577,1734232577,-21600,MacBook
com.google.Chrome,560,1734232017,1734232577,1734232577,-21600,MacBook
com.amazon.Amazon,1,1734232023,1734232024,1734232025,-21600,iPhone
com.amazon.Amazon,61,1734231771,1734231832,1734231833,-21600,iPhone
com.amazon.Amazon,27,1734231743,1734231770,1734231771,-21600,iPhone
com.xingin.discover,3,1734231737,1734231740,1734231740,-21600,iPhone
com.xingin.discover,3486,1734228085,1734231571,1734231572,-21600,iPhone
com.tencent.xin,107,1734227978,1734228085,1734228085,-21600,iPhone
com.microsoft.Office.Outlook,5,1734227973,1734227978,1734227978,-21600,iPhone
com.tencent.xin,43,1734227930,1734227973,1734227973,-21600,iPhone
com.xingin.discover,4,1734227926,1734227930,1734227930,-21600,iPhone
com.tencent.xin,1,1734227925,1734227926,1734227927,-21600,iPhone
com.xingin.discover,1569,1734226355,1734227924,1734227925,-21600,iPhone
com.xingin.discover,6,1734226278,1734226284,1734226284,-21600,iPhone
com.xingin.discover,260,1734226016,1734226276,1734226277,-21600,iPhone
com.google.Chrome,304,1734225766,1734226070,1734226071,-21600,MacBook
com.tencent.xin,47,1734225969,1734226016,1734226017,-21600,iPhone
com.apple.MobileSMS,3,1734225966,1734225969,1734225970,-21600,iPhone
com.tencent.xin,1,1734225962,1734225963,1734225964,-21600,iPhone
com.xingin.discover,6,1734225955,1734225961,1734225961,-21600,iPhone
com.apple.finder,1,1734225765,1734225766,1734225766,-21600,MacBook
com.apple.finder,304,1734225286,1734225590,1734225591,-21600,MacBook
com.google.Chrome,1,1734225285,1734225286,1734225287,-21600,MacBook
com.microsoft.Outlook,1,1734225284,1734225285,1734225285,-21600,MacBook
com.google.Chrome,205,1734225079,1734225284,1734225284,-21600,MacBook
com.xingin.discover,9,1734225171,1734225180,1734225181,-21600,iPhone
com.microsoft.Outlook,6,1734225073,1734225079,1734225080,-21600,MacBook
com.apple.finder,2,1734225071,1734225073,1734225073,-21600,MacBook
com.google.Chrome,2,1734225069,1734225071,1734225072,-21600,MacBook
com.google.Chrome,449,1734224496,1734224945,1734224946,-21600,MacBook
com.apple.finder,32,1734224464,1734224496,1734224496,-21600,MacBook
com.google.Chrome,382,1734224082,1734224464,1734224465,-21600,MacBook
com.apple.finder,3,1734224079,1734224082,1734224083,-21600,MacBook
com.google.Chrome,8,1734224071,1734224079,1734224080,-21600,MacBook
com.apple.finder,3,1734224068,1734224071,1734224071,-21600,MacBook
com.google.Chrome,11,1734224057,1734224068,1734224068,-21600,MacBook
com.apple.finder,6,1734224051,1734224057,1734224058,-21600,MacBook
com.google.Chrome,1,1734224050,1734224051,1734224051,-21600,MacBook
com.apple.finder,1,1734224049,1734224050,1734224050,-21600,MacBook
com.google.Chrome,335,1734223714,1734224049,1734224049,-21600,MacBook
com.tencent.xinWeChat,6,1734223708,1734223714,1734223714,-21600,MacBook
com.google.Chrome,120,1734223588,1734223708,1734223709,-21600,MacBook
com.apple.finder,4,1734223584,1734223588,1734223589,-21600,MacBook
com.tencent.xinWeChat,2,1734223582,1734223584,1734223585,-21600,MacBook
com.apple.finder,1,1734223581,1734223582,1734223583,-21600,MacBook
com.google.Chrome,271,1734223310,1734223581,1734223582,-21600,MacBook
com.xingin.discover,10,1734223424,1734223434,1734223435,-21600,iPhone
com.xingin.discover,9,1734223361,1734223370,1734223371,-21600,iPhone
com.apple.finder,1,1734223309,1734223310,1734223311,-21600,MacBook
com.tencent.xinWeChat,35,1734223274,1734223309,1734223309,-21600,MacBook
com.apple.finder,0,1734223274,1734223274,1734223275,-21600,MacBook
com.tencent.xinWeChat,2,1734223272,1734223274,1734223274,-21600,MacBook
com.apple.finder,0,1734223272,1734223272,1734223273,-21600,MacBook
com.tencent.xinWeChat,12,1734223260,1734223272,1734223272,-21600,MacBook
com.apple.finder,1,1734223259,1734223260,1734223260,-21600,MacBook
com.tencent.xinWeChat,13,1734223246,1734223259,1734223260,-21600,MacBook
com.apple.finder,0,1734223246,1734223246,1734223247,-21600,MacBook
com.tencent.xinWeChat,2,1734223244,1734223246,1734223246,-21600,MacBook
com.apple.finder,1,1734223243,1734223244,1734223244,-21600,MacBook
com.tencent.xinWeChat,123,1734223120,1734223243,1734223244,-21600,MacBook
com.apple.finder,1,1734223119,1734223120,1734223121,-21600,MacBook
com.tencent.xinWeChat,11,1734223108,1734223119,1734223120,-21600,MacBook
com.apple.finder,0,1734223108,1734223108,1734223108,-21600,MacBook
com.google.Chrome,3,1734223105,1734223108,1734223108,-21600,MacBook
com.adobe.acc.AdobeCreativeCloud,1,1734223104,1734223105,1734223106,-21600,MacBook
com.google.Chrome,0,1734223104,1734223104,1734223104,-21600,MacBook
com.adobe.acc.AdobeCreativeCloud,1,1734223103,1734223104,1734223104,-21600,MacBook
com.google.Chrome,160,1734222943,1734223103,1734223104,-21600,MacBook
com.google.Chrome,300,1734222468,1734222768,1734222768,-21600,MacBook
com.xingin.discover,11,1734222719,1734222730,1734222730,-21600,iPhone
com.xingin.discover,4,1734222709,1734222713,1734222714,-21600,iPhone
com.xingin.discover,1,1734222704,1734222705,1734222706,-21600,iPhone
com.xingin.discover,31,1734222504,1734222535,1734222536,-21600,iPhone
com.apple.Preferences,17,1734222485,1734222502,1734222502,-21600,iPhone
com.apple.mobiletimer,11,1734222472,1734222483,1734222484,-21600,iPhone
com.apple.mobiletimer,3,1734222468,1734222471,1734222472,-21600,iPhone
com.apple.mobiletimer,6,1734222457,1734222463,1734222463,-21600,iPhone
com.apple.mobiletimer,5,1734222448,1734222453,1734222453,-21600,iPhone
com.apple.mobiletimer,1,1734222447,1734222448,1734222448,-21600,iPhone
com.apple.mobiletimer,3,1734222441,1734222444,1734222444,-21600,iPhone
com.apple.mobiletimer,2,1734222438,1734222440,1734222441,-21600,iPhone
com.apple.mobiletimer,3,1734222381,1734222384,1734222384,-21600,iPhone
com.apple.finder,3,1734222269,1734222272,1734222273,-21600,MacBook
com.apple.mobiletimer,6,1734222225,1734222231,1734222232,-21600,iPhone
com.apple.mobiletimer,2,1734222222,1734222224,1734222225,-21600,iPhone
com.apple.mobiletimer,11,1734222143,1734222154,1734222155,-21600,iPhone
com.apple.camera,1,1734222139,1734222140,1734222140,-21600,iPhone
com.netease.cloudmusic,6,1734221604,1734221610,1734221611,-21600,iPhone
com.netease.cloudmusic,12,1734221319,1734221331,1734221331,-21600,iPhone
com.netease.cloudmusic,8,1734221258,1734221266,1734221266,-21600,iPhone
com.netease.cloudmusic,35,1734221170,1734221205,1734221206,-21600,iPhone
com.apple.finder,16,1734221169,1734221185,1734221186,-21600,MacBook
com.xingin.discover,8,1734221161,1734221169,1734221169,-21600,iPhone
com.xingin.discover,279,1734220433,1734220712,1734220713,-21600,iPhone
com.xingin.discover,466,1734219741,1734220207,1734220208,-21600,iPhone
com.tencent.xin,24,1734219717,1734219741,1734219742,-21600,iPhone
com.openai.chat,124,1734219593,1734219717,1734219717,-21600,iPhone
com.tencent.xin,23,1734219570,1734219593,1734219593,-21600,iPhone
com.openai.chat,24,1734219546,1734219570,1734219570,-21600,iPhone
com.tencent.xin,90,1734219456,1734219546,1734219547,-21600,iPhone
com.openai.chat,4,1734219452,1734219456,1734219457,-21600,iPhone
com.tencent.xin,15,1734219437,1734219452,1734219453,-21600,iPhone
com.openai.chat,3,1734219434,1734219437,1734219438,-21600,iPhone
com.tencent.xin,7,1734219427,1734219434,1734219435,-21600,iPhone
com.openai.chat,3,1734219424,1734219427,1734219427,-21600,iPhone
com.tencent.xin,4,1734219420,1734219424,1734219424,-21600,iPhone
com.openai.chat,4,1734219416,1734219420,1734219420,-21600,iPhone
com.tencent.xin,4,1734219412,1734219416,1734219417,-21600,iPhone
com.openai.chat,11,1734219401,1734219412,1734219413,-21600,iPhone
com.tencent.xin,59,1734219342,1734219401,1734219401,-21600,iPhone
com.openai.chat,44,1734219298,1734219342,1734219343,-21600,iPhone
com.tencent.xin,274,1734219022,1734219296,1734219297,-21600,iPhone
com.xingin.discover,2,1734219020,1734219022,1734219023,-21600,iPhone
com.openai.chat,309,1734218711,1734219020,1734219021,-21600,iPhone
com.xingin.discover,458,1734218253,1734218711,1734218711,-21600,iPhone
com.xingin.discover,131,1734217907,1734218038,1734218039,-21600,iPhone
com.xingin.discover,99,1734217807,1734217906,1734217906,-21600,iPhone
com.xingin.discover,1295,1734216469,1734217764,1734217765,-21600,iPhone
com.bilibili.bilicomic,24,1734216445,1734216469,1734216469,-21600,iPhone
com.tencent.xin,46,1734216397,1734216443,1734216444,-21600,iPhone
com.tencent.xin,77,1734216161,1734216238,1734216238,-21600,iPhone
com.discoverfinancial.mobile,1,1734216160,1734216161,1734216161,-21600,iPhone
com.tencent.xin,11,1734216148,1734216159,1734216159,-21600,iPhone
com.microsoft.Office.Outlook,6,1734216141,1734216147,1734216147,-21600,iPhone
com.apple.mobilephone,6,1734216134,1734216140,1734216141,-21600,iPhone
com.tencent.xin,2,1734216130,1734216132,1734216132,-21600,iPhone
com.google.chrome.ios,17,1734216110,1734216127,1734216128,-21600,iPhone
com.google.chrome.ios,841,1734211316,1734212157,1734212157,-21600,iPhone
com.google.chrome.ios,664,1734210415,1734211079,1734211080,-21600,iPhone
com.google.chrome.ios,2799,1734207489,1734210288,1734210290,-21600,iPhone
com.netease.cloudmusic,163,1734207326,1734207489,1734207489,-21600,iPhone
com.apple.PassbookUIService,3,1734207274,1734207277,1734207278,-21600,iPhone
com.apple.MobileSMS,3,1734207251,1734207254,1734207254,-21600,iPhone
com.apple.mobiletimer,4,1734207246,1734207250,1734207250,-21600,iPhone
com.apple.mobiletimer,75,1734207115,1734207190,1734207191,-21600,iPhone
com.google.chrome.ios,106,1734207007,1734207113,1734207114,-21600,iPhone
com.tencent.xin,97,1734206909,1734207006,1734207007,-21600,iPhone
com.google.chrome.ios,1,1734206908,1734206909,1734206910,-21600,iPhone
com.apple.finder,18,1734206865,1734206883,1734206884,-21600,MacBook
com.apple.Preview,6,1734206859,1734206865,1734206865,-21600,MacBook
com.apple.finder,25,1734206834,1734206859,1734206860,-21600,MacBook
com.apple.Preview,0,1734206834,1734206834,1734206835,-21600,MacBook
com.apple.finder,9,1734206825,1734206834,1734206834,-21600,MacBook
com.apple.Preview,2,1734206823,1734206825,1734206826,-21600,MacBook
com.google.Chrome,726,1734206097,1734206823,1734206823,-21600,MacBook
com.apple.finder,2,1734206095,1734206097,1734206097,-21600,MacBook
com.apple.Preview,3,1734206092,1734206095,1734206096,-21600,MacBook
com.apple.finder,0,1734206092,1734206092,1734206093,-21600,MacBook
com.apple.Preview,2,1734206090,1734206092,1734206092,-21600,MacBook
com.apple.finder,0,1734206090,1734206090,1734206091,-21600,MacBook
com.apple.Preview,5,1734206085,1734206090,1734206090,-21600,MacBook
com.google.Chrome,210,1734205875,1734206085,1734206086,-21600,MacBook
com.microsoft.Outlook,10,1734205865,1734205875,1734205875,-21600,MacBook
com.google.Chrome,410,1734205455,1734205865,1734205866,-21600,MacBook
com.microsoft.Outlook,39,1734205416,1734205455,1734205456,-21600,MacBook
com.apple.Preview,0,1734205416,1734205416,1734205417,-21600,MacBook
com.google.Chrome,3360,1734202056,1734205416,1734205416,-21600,MacBook
com.apple.Preview,8,1734202048,1734202056,1734202057,-21600,MacBook
com.tencent.xinWeChat,0,1734202048,1734202048,1734202049,-21600,MacBook
com.google.chrome.ios,6,1734202036,1734202042,1734202043,-21600,iPhone
com.google.chrome.ios,6,1734202028,1734202034,1734202035,-21600,iPhone
com.google.chrome.ios,2,1734201806,1734201808,1734201809,-21600,iPhone
com.google.chrome.ios,2,1734201801,1734201803,1734201803,-21600,iPhone
com.google.chrome.ios,177,1734201527,1734201704,1734201705,-21600,iPhone
com.bilibili.bilicomic,19,1734201508,1734201527,1734201528,-21600,iPhone
com.tencent.xin,79,1734201429,1734201508,1734201508,-21600,iPhone
com.bilibili.bilicomic,89,1734201340,1734201429,1734201429,-21600,iPhone
tv.danmaku.bilianime,1,1734201339,1734201340,1734201340,-21600,iPhone
com.bilibili.bilicomic,1,1734201338,1734201339,1734201339,-21600,iPhone
com.netease.cloudmusic,12,1734201323,1734201335,1734201335,-21600,iPhone
com.xingin.discover,3,1734201067,1734201070,1734201071,-21600,iPhone
com.tencent.xin,3,1734201064,1734201067,1734201068,-21600,iPhone
com.tencent.xin,731,1734200319,1734201050,1734201051,-21600,iPhone
com.google.chrome.ios,7,1734200312,1734200319,1734200319,-21600,iPhone
com.zhihu.ios,122,1734200190,1734200312,1734200312,-21600,iPhone
com.google.chrome.ios,41,1734200149,1734200190,1734200191,-21600,iPhone
com.tencent.xin,21,1734200127,1734200148,1734200149,-21600,iPhone
com.xingin.discover,2,1734200124,1734200126,1734200127,-21600,iPhone
com.xingin.discover,1,1734200121,1734200122,1734200122,-21600,iPhone
com.xingin.discover,6,1734200094,1734200100,1734200100,-21600,iPhone
com.xingin.discover,5,1734200086,1734200091,1734200091,-21600,iPhone
com.xingin.discover,104,1734199981,1734200085,1734200086,-21600,iPhone
com.tencent.xinWeChat,63,1734199922,1734199985,1734199986,-21600,MacBook
com.google.calendar,5,1734199974,1734199979,1734199980,-21600,iPhone
com.tencent.xin,1,1734199973,1734199974,1734199975,-21600,iPhone
com.apple.MobileSMS,7,1734199964,1734199971,1734199972,-21600,iPhone
com.microsoft.Office.Outlook,7,1734199957,1734199964,1734199965,-21600,iPhone
com.apple.Preview,0,1734199922,1734199922,1734199922,-21600,MacBook
com.google.Chrome,1341,1734198581,1734199922,1734199922,-21600,MacBook
com.microsoft.Outlook,2,1734198579,1734198581,1734198582,-21600,MacBook
com.google.Chrome,8,1734198571,1734198579,1734198579,-21600,MacBook
com.microsoft.Outlook,6,1734198565,1734198571,1734198572,-21600,MacBook
com.apple.Preview,0,1734198565,1734198565,1734198566,-21600,MacBook
com.google.Chrome,2120,1734196445,1734198565,1734198566,-21600,MacBook
com.microsoft.Outlook,3,1734196442,1734196445,1734196445,-21600,MacBook
com.google.Chrome,57,1734196385,1734196442,1734196442,-21600,MacBook
com.microsoft.Outlook,13,1734196372,1734196385,1734196386,-21600,MacBook
com.apple.Preview,0,1734196372,1734196372,1734196373,-21600,MacBook
com.google.Chrome,1829,1734194543,1734196372,1734196373,-21600,MacBook
com.apple.Preview,2,1734194541,1734194543,1734194543,-21600,MacBook
com.microsoft.Outlook,9,1734194532,1734194541,1734194541,-21600,MacBook
com.apple.Preview,2,1734194530,1734194532,1734194533,-21600,MacBook
com.microsoft.Outlook,35,1734194495,1734194530,1734194531,-21600,MacBook
com.google.Chrome,11,1734194484,1734194495,1734194496,-21600,MacBook
com.microsoft.Outlook,95,1734194389,1734194484,1734194485,-21600,MacBook
com.google.Chrome,1,1734194388,1734194389,1734194389,-21600,MacBook
com.microsoft.Outlook,16,1734194372,1734194388,1734194388,-21600,MacBook
com.google.Chrome,10,1734194362,1734194372,1734194372,-21600,MacBook
com.microsoft.Outlook,9,1734194353,1734194362,1734194362,-21600,MacBook
com.google.Chrome,9,1734194344,1734194353,1734194354,-21600,MacBook
com.microsoft.Outlook,22,1734194322,1734194344,1734194345,-21600,MacBook
com.google.Chrome,13,1734194309,1734194322,1734194323,-21600,MacBook
com.microsoft.Outlook,38,1734194271,1734194309,1734194310,-21600,MacBook
com.google.Chrome,7,1734194264,1734194271,1734194272,-21600,MacBook
com.microsoft.Outlook,15,1734194249,1734194264,1734194264,-21600,MacBook
com.google.Chrome,19,1734194230,1734194249,1734194249,-21600,MacBook
com.microsoft.Outlook,26,1734194204,1734194230,1734194231,-21600,MacBook
com.google.Chrome,10,1734194194,1734194204,1734194205,-21600,MacBook
com.microsoft.Outlook,2,1734194192,1734194194,1734194195,-21600,MacBook
com.google.Chrome,33,1734194159,1734194192,1734194193,-21600,MacBook
com.microsoft.Outlook,31,1734194128,1734194159,1734194160,-21600,MacBook
com.google.Chrome,7,1734194121,1734194128,1734194129,-21600,MacBook
com.microsoft.Outlook,20,1734194101,1734194121,1734194122,-21600,MacBook
com.google.Chrome,38,1734194063,1734194101,1734194102,-21600,MacBook
com.microsoft.Outlook,102,1734193961,1734194063,1734194063,-21600,MacBook
com.google.Chrome,2,1734193959,1734193961,1734193961,-21600,MacBook
com.microsoft.Outlook,33,1734193926,1734193959,1734193960,-21600,MacBook
com.google.Chrome,2,1734193924,1734193926,1734193927,-21600,MacBook
com.microsoft.Outlook,27,1734193897,1734193924,1734193924,-21600,MacBook
com.google.Chrome,2,1734193895,1734193897,1734193898,-21600,MacBook
com.microsoft.Outlook,33,1734193862,1734193895,1734193895,-21600,MacBook
com.google.Chrome,33,1734193829,1734193862,1734193863,-21600,MacBook
com.microsoft.Outlook,108,1734193721,1734193829,1734193829,-21600,MacBook
com.google.Chrome,4,1734193700,1734193704,1734193705,-21600,MacBook
com.tencent.xinWeChat,46,1734193654,1734193700,1734193700,-21600,MacBook
com.apple.Preview,10,1734193644,1734193654,1734193654,-21600,MacBook
com.tencent.xinWeChat,40,1734193604,1734193644,1734193644,-21600,MacBook
com.apple.Preview,9,1734193595,1734193604,1734193605,-21600,MacBook
com.tencent.xinWeChat,20,1734193575,1734193595,1734193596,-21600,MacBook
com.apple.finder,2,1734193573,1734193575,1734193576,-21600,MacBook
com.tencent.xinWeChat,1,1734193572,1734193573,1734193574,-21600,MacBook
com.apple.finder,1,1734193571,1734193572,1734193573,-21600,MacBook
com.tencent.xinWeChat,0,1734193571,1734193571,1734193572,-21600,MacBook
com.apple.finder,1,1734193570,1734193571,1734193571,-21600,MacBook
com.tencent.xinWeChat,9,1734193561,1734193570,1734193570,-21600,MacBook
com.apple.finder,4,1734193557,1734193561,1734193561,-21600,MacBook
com.microsoft.Outlook,230,1734193327,1734193557,1734193558,-21600,MacBook
com.google.Chrome,288,1734193039,1734193327,1734193328,-21600,MacBook
com.microsoft.Outlook,241,1734192798,1734193039,1734193039,-21600,MacBook
com.google.Chrome,22,1734192776,1734192798,1734192798,-21600,MacBook
com.microsoft.Outlook,56,1734192720,1734192776,1734192777,-21600,MacBook
com.google.Chrome,2,1734192718,1734192720,1734192721,-21600,MacBook
com.microsoft.Outlook,66,1734192652,1734192718,1734192719,-21600,MacBook
com.google.Chrome,504,1734192148,1734192652,1734192652,-21600,MacBook
com.microsoft.Outlook,21,1734192127,1734192148,1734192148,-21600,MacBook
com.google.Chrome,18,1734192109,1734192127,1734192127,-21600,MacBook
com.microsoft.Outlook,8,1734192101,1734192109,1734192110,-21600,MacBook
com.google.Chrome,167,1734191934,1734192101,1734192102,-21600,MacBook
com.microsoft.Outlook,32,1734191902,1734191934,1734191934,-21600,MacBook
com.google.Chrome,3,1734191899,1734191902,1734191902,-21600,MacBook
com.microsoft.Outlook,62,1734191837,1734191899,1734191900,-21600,MacBook
com.google.Chrome,4,1734191833,1734191837,1734191838,-21600,MacBook
com.microsoft.Outlook,3,1734191830,1734191833,1734191833,-21600,MacBook
com.google.Chrome,5,1734191825,1734191830,1734191831,-21600,MacBook
com.microsoft.Outlook,3,1734191822,1734191825,1734191825,-21600,MacBook
com.google.Chrome,24,1734191798,1734191822,1734191822,-21600,MacBook
com.microsoft.Outlook,3,1734191795,1734191798,1734191799,-21600,MacBook
com.google.Chrome,55,1734191740,1734191795,1734191796,-21600,MacBook
com.microsoft.Outlook,603,1734191137,1734191740,1734191740,-21600,MacBook
com.google.Chrome,683,1734190454,1734191137,1734191138,-21600,MacBook
com.apple.Preview,1,1734190453,1734190454,1734190454,-21600,MacBook
com.google.Chrome,540,1734189913,1734190453,1734190453,-21600,MacBook
com.apple.Preview,1,1734189912,1734189913,1734189913,-21600,MacBook
com.google.Chrome,48,1734189864,1734189912,1734189912,-21600,MacBook
com.apple.Preview,1,1734189863,1734189864,1734189864,-21600,MacBook
com.google.Chrome,3,1734189860,1734189863,1734189863,-21600,MacBook
com.apple.Preview,1,1734189859,1734189860,1734189861,-21600,MacBook
com.google.Chrome,23,1734189836,1734189859,1734189860,-21600,MacBook
com.apple.Preview,1,1734189835,1734189836,1734189837,-21600,MacBook
com.google.Chrome,137,1734189698,1734189835,1734189836,-21600,MacBook
com.apple.Preview,1,1734189697,1734189698,1734189698,-21600,MacBook
com.google.Chrome,9,1734189688,1734189697,1734189698,-21600,MacBook
com.apple.Preview,1,1734189687,1734189688,1734189689,-21600,MacBook
com.google.Chrome,178,1734189509,1734189687,1734189688,-21600,MacBook
com.apple.Preview,1,1734189508,1734189509,1734189510,-21600,MacBook
com.google.Chrome,71,1734189437,1734189508,1734189509,-21600,MacBook
com.apple.Preview,46,1734189391,1734189437,1734189438,-21600,MacBook
com.google.Chrome,386,1734189005,1734189391,1734189392,-21600,MacBook
com.apple.Preview,7,1734188998,1734189005,1734189006,-21600,MacBook
com.microsoft.Excel,5,1734188993,1734188998,1734188998,-21600,MacBook
com.google.Chrome,193,1734188800,1734188993,1734188993,-21600,MacBook
com.apple.Preview,10,1734188790,1734188800,1734188800,-21600,MacBook
com.google.Chrome,85,1734188705,1734188790,1734188790,-21600,MacBook
com.microsoft.Outlook,51,1734188654,1734188705,1734188705,-21600,MacBook
com.google.Chrome,55,1734188599,1734188654,1734188655,-21600,MacBook
com.microsoft.Outlook,72,1734188527,1734188599,1734188599,-21600,MacBook
com.google.Chrome,69,1734188458,1734188527,1734188528,-21600,MacBook
com.microsoft.Outlook,4,1734188454,1734188458,1734188459,-21600,MacBook
com.google.Chrome,2,1734188452,1734188454,1734188455,-21600,MacBook
com.microsoft.Outlook,17,1734188435,1734188452,1734188453,-21600,MacBook
com.apple.Preview,0,1734188435,1734188435,1734188436,-21600,MacBook
com.google.Chrome,487,1734187948,1734188435,1734188436,-21600,MacBook
com.apple.Preview,13,1734187935,1734187948,1734187949,-21600,MacBook
com.google.Chrome,181,1734187754,1734187935,1734187936,-21600,MacBook
com.apple.Preview,2,1734187752,1734187754,1734187754,-21600,MacBook
com.apple.Dictionary,2,1734187750,1734187752,1734187753,-21600,MacBook
com.google.Chrome,257,1734187493,1734187750,1734187751,-21600,MacBook
com.apple.Preview,12,1734187481,1734187493,1734187494,-21600,MacBook
com.google.Chrome,99,1734187382,1734187481,1734187482,-21600,MacBook
com.microsoft.Excel,22,1734187360,1734187382,1734187383,-21600,MacBook
com.google.Chrome,33,1734187327,1734187360,1734187361,-21600,MacBook
com.microsoft.Excel,1,1734187326,1734187327,1734187328,-21600,MacBook
com.google.Chrome,76,1734187250,1734187326,1734187327,-21600,MacBook
com.microsoft.Excel,6,1734187244,1734187250,1734187251,-21600,MacBook
com.google.Chrome,65,1734187179,1734187244,1734187244,-21600,MacBook
com.microsoft.Excel,23,1734187156,1734187179,1734187179,-21600,MacBook
com.google.Chrome,10,1734187146,1734187156,1734187157,-21600,MacBook
com.microsoft.Excel,1,1734187145,1734187146,1734187147,-21600,MacBook
com.google.Chrome,6,1734187139,1734187145,1734187146,-21600,MacBook
com.microsoft.Excel,5,1734187134,1734187139,1734187140,-21600,MacBook
com.google.Chrome,11,1734187123,1734187134,1734187135,-21600,MacBook
com.microsoft.Excel,35,1734187088,1734187123,1734187124,-21600,MacBook
com.apple.TextEdit,3,1734187085,1734187088,1734187089,-21600,MacBook
com.microsoft.Excel,5,1734187080,1734187085,1734187086,-21600,MacBook
com.apple.finder,16,1734187064,1734187080,1734187080,-21600,MacBook
com.apple.archiveutility,0,1734187064,1734187064,1734187065,-21600,MacBook
com.apple.finder,6,1734187058,1734187064,1734187064,-21600,MacBook
com.apple.Preview,1,1734187057,1734187058,1734187059,-21600,MacBook
com.google.Chrome,892,1734186165,1734187057,1734187057,-21600,MacBook
com.apple.Preview,6,1734186159,1734186165,1734186166,-21600,MacBook
com.google.Chrome,9,1734186150,1734186159,1734186159,-21600,MacBook
com.apple.Preview,10,1734186140,1734186150,1734186150,-21600,MacBook
com.google.Chrome,20,1734186120,1734186140,1734186141,-21600,MacBook
com.apple.Preview,9,1734186111,1734186120,1734186121,-21600,MacBook
com.google.Chrome,17,1734186094,1734186111,1734186111,-21600,MacBook
com.apple.Preview,70,1734186024,1734186094,1734186094,-21600,MacBook
com.apple.finder,7,1734186017,1734186024,1734186024,-21600,MacBook
com.apple.Preview,3,1734186014,1734186017,1734186017,-21600,MacBook
com.apple.finder,1,1734186013,1734186014,1734186014,-21600,MacBook
com.apple.Preview,3,1734186010,1734186013,1734186013,-21600,MacBook
com.apple.finder,0,1734186010,1734186010,1734186011,-21600,MacBook
com.apple.Preview,4,1734186006,1734186010,1734186010,-21600,MacBook
com.apple.finder,1,1734186005,1734186006,1734186007,-21600,MacBook
com.apple.Preview,9,1734185996,1734186005,1734186005,-21600,MacBook
com.google.Chrome,456,1734185540,1734185996,1734185996,-21600,MacBook
com.apple.Preview,105,1734185435,1734185540,1734185541,-21600,MacBook
com.apple.finder,13,1734185422,1734185435,1734185436,-21600,MacBook
com.apple.Preview,3,1734185419,1734185422,1734185423,-21600,MacBook
com.google.Chrome,192,1734185227,1734185419,1734185419,-21600,MacBook
com.apple.Preview,2,1734185225,1734185227,1734185228,-21600,MacBook
com.google.Chrome,13,1734185212,1734185225,1734185226,-21600,MacBook
com.google.Chrome,2556,1734181411,1734183967,1734183968,-21600,MacBook
com.google.Chrome,301,1734176617,1734176918,1734176918,-21600,MacBook
com.google.Chrome,301,1734176150,1734176451,1734176452,-21600,MacBook
com.google.Chrome,302,1734175453,1734175755,1734175755,-21600,MacBook
com.google.Chrome,300,1734173212,1734173512,1734173512,-21600,MacBook
com.apple.Preview,1034,1734172178,1734173212,1734173213,-21600,MacBook
com.apple.finder,1,1734172177,1734172178,1734172178,-21600,MacBook
com.apple.Preview,14,1734172163,1734172177,1734172177,-21600,MacBook
com.apple.finder,1,1734172162,1734172163,1734172164,-21600,MacBook
com.apple.Preview,5,1734172157,1734172162,1734172163,-21600,MacBook
com.apple.finder,6,1734172151,1734172157,1734172157,-21600,MacBook
com.apple.Preview,4,1734172147,1734172151,1734172152,-21600,MacBook
com.apple.finder,1,1734172146,1734172147,1734172147,-21600,MacBook
com.apple.Preview,6,1734172140,1734172146,1734172146,-21600,MacBook
com.apple.finder,2,1734172138,1734172140,1734172140,-21600,MacBook
com.apple.Preview,6,1734172132,1734172138,1734172138,-21600,MacBook
com.apple.finder,5,1734172127,1734172132,1734172133,-21600,MacBook
com.apple.Dictionary,1,1734172126,1734172127,1734172128,-21600,MacBook
com.apple.Preview,28,1734172098,1734172126,1734172126,-21600,MacBook
com.apple.Preview,2792,1734168131,1734170923,1734170924,-21600,MacBook
com.google.Chrome,81,1734168050,1734168131,1734168132,-21600,MacBook
com.apple.Preview,23,1734168027,1734168050,1734168050,-21600,MacBook
com.google.Chrome,1261,1734166766,1734168027,1734168028,-21600,MacBook
com.apple.Preview,2,1734166764,1734166766,1734166767,-21600,MacBook
com.google.Chrome,3,1734166761,1734166764,1734166764,-21600,MacBook
com.apple.Preview,28,1734166733,1734166761,1734166762,-21600,MacBook
com.google.Chrome,2,1734166731,1734166733,1734166734,-21600,MacBook
com.apple.Preview,16,1734166715,1734166731,1734166731,-21600,MacBook
com.google.Chrome,124,1734166591,1734166715,1734166716,-21600,MacBook
com.microsoft.Office.Outlook,4,1734166607,1734166611,1734166612,-21600,iPhone
com.xingin.discover,6,1734166601,1734166607,1734166609,-21600,iPhone
com.google.Chrome,1107,1734165118,1734166225,1734166226,-21600,MacBook
com.apple.Dictionary,1,1734165117,1734165118,1734165118,-21600,MacBook
com.google.Chrome,402,1734164715,1734165117,1734165118,-21600,MacBook
com.apple.Preview,2,1734164713,1734164715,1734164715,-21600,MacBook
com.google.Chrome,241,1734164472,1734164713,1734164714,-21600,MacBook
com.apple.Preview,3,1734164469,1734164472,1734164473,-21600,MacBook
com.google.Chrome,492,1734163977,1734164469,1734164470,-21600,MacBook
com.google.Chrome,383,1734163581,1734163964,1734163964,-21600,MacBook
com.apple.finder,16,1734163565,1734163581,1734163582,-21600,MacBook
com.apple.finder,16,1734163520,1734163536,1734163537,-21600,MacBook
com.apple.PassbookUIService,31,1734163483,1734163514,1734163514,-21600,iPhone
com.xingin.discover,31,1734163483,1734163514,1734163514,-21600,iPhone
com.xingin.discover,1851,1734161626,1734163477,1734163478,-21600,iPhone
com.microsoft.Office.Outlook,34,1734161592,1734161626,1734161627,-21600,iPhone
com.microsoft.Office.Outlook,50,1734161540,1734161590,1734161591,-21600,iPhone
com.xingin.discover,1,1734161539,1734161540,1734161540,-21600,iPhone
com.tencent.xin,9,1734161528,1734161537,1734161538,-21600,iPhone
com.apple.mobilenotes,12,1734161516,1734161528,1734161529,-21600,iPhone
com.tencent.xin,1673,1734159840,1734161513,1734161514,-21600,iPhone
com.apple.finder,78,1734159795,1734159873,1734159873,-21600,MacBook
com.google.chrome.ios,18,1734159822,1734159840,1734159841,-21600,iPhone
com.tencent.xin,20,1734159801,1734159821,1734159821,-21600,iPhone
com.google.Chrome,406,1734159389,1734159795,1734159796,-21600,MacBook
com.apple.Preview,4,1734159385,1734159389,1734159390,-21600,MacBook
com.google.Chrome,22,1734159363,1734159385,1734159385,-21600,MacBook
com.apple.Notes,6,1734159357,1734159363,1734159363,-21600,MacBook
com.google.Chrome,7,1734159350,1734159357,1734159358,-21600,MacBook
com.apple.Preview,4,1734159346,1734159350,1734159351,-21600,MacBook
com.google.Chrome,3,1734159343,1734159346,1734159347,-21600,MacBook
com.apple.Preview,2,1734159341,1734159343,1734159344,-21600,MacBook
com.google.Chrome,11,1734159330,1734159341,1734159342,-21600,MacBook
com.apple.Preview,1,1734159329,1734159330,1734159331,-21600,MacBook
com.google.Chrome,6,1734159323,1734159329,1734159330,-21600,MacBook
com.apple.Preview,14,1734159309,1734159323,1734159323,-21600,MacBook
com.google.Chrome,17,1734159292,1734159309,1734159310,-21600,MacBook
com.apple.Preview,17,1734159275,1734159292,1734159292,-21600,MacBook
com.google.Chrome,16,1734159259,1734159275,1734159275,-21600,MacBook
com.apple.Preview,75,1734159184,1734159259,1734159259,-21600,MacBook
com.google.Chrome,216,1734158968,1734159184,1734159184,-21600,MacBook
com.apple.Preview,0,1734158968,1734158968,1734158969,-21600,MacBook
com.google.Chrome,27,1734158941,1734158968,1734158968,-21600,MacBook
com.apple.Preview,2,1734158939,1734158941,1734158942,-21600,MacBook
com.google.Chrome,115,1734158824,1734158939,1734158940,-21600,MacBook
com.apple.Preview,1,1734158823,1734158824,1734158825,-21600,MacBook
com.google.Chrome,6,1734158817,1734158823,1734158824,-21600,MacBook
com.apple.Preview,6,1734158811,1734158817,1734158817,-21600,MacBook
com.google.Chrome,228,1734158583,1734158811,1734158812,-21600,MacBook
com.apple.Preview,99,1734158484,1734158583,1734158584,-21600,MacBook
com.apple.Notes,5,1734158479,1734158484,1734158484,-21600,MacBook
com.apple.Preview,31,1734158448,1734158479,1734158480,-21600,MacBook
com.apple.Notes,6,1734158442,1734158448,1734158449,-21600,MacBook
com.apple.Preview,25,1734158417,1734158442,1734158442,-21600,MacBook
com.apple.Notes,3,1734158414,1734158417,1734158418,-21600,MacBook
com.apple.Preview,7,1734158407,1734158414,1734158414,-21600,MacBook
com.apple.Notes,3,1734158404,1734158407,1734158408,-21600,MacBook
com.apple.Preview,26,1734158378,1734158404,1734158405,-21600,MacBook
com.apple.Notes,9,1734158369,1734158378,1734158379,-21600,MacBook
com.apple.Preview,2,1734158367,1734158369,1734158370,-21600,MacBook
com.apple.Notes,17,1734158350,1734158367,1734158367,-21600,MacBook
com.apple.Preview,1,1734158349,1734158350,1734158351,-21600,MacBook
com.apple.Notes,0,1734158349,1734158349,1734158350,-21600,MacBook
com.apple.Preview,4,1734158345,1734158349,1734158349,-21600,MacBook
com.apple.Notes,8,1734158337,1734158345,1734158346,-21600,MacBook
com.apple.Preview,10,1734158327,1734158337,1734158338,-21600,MacBook
com.apple.Notes,1,1734158326,1734158327,1734158328,-21600,MacBook
com.apple.Preview,15,1734158311,1734158326,1734158327,-21600,MacBook
com.apple.Notes,4,1734158307,1734158311,1734158311,-21600,MacBook
com.apple.Preview,8,1734158299,1734158307,1734158308,-21600,MacBook
com.apple.finder,1,1734158298,1734158299,1734158300,-21600,MacBook
com.google.Chrome,113,1734158185,1734158298,1734158299,-21600,MacBook
com.apple.Preview,1,1734158184,1734158185,1734158186,-21600,MacBook
com.apple.finder,1,1734158183,1734158184,1734158185,-21600,MacBook
com.apple.Notes,3,1734158180,1734158183,1734158183,-21600,MacBook
com.apple.finder,2,1734158178,1734158180,1734158181,-21600,MacBook
com.apple.Preview,41,1734158137,1734158178,1734158179,-21600,MacBook
com.apple.Notes,9,1734158128,1734158137,1734158137,-21600,MacBook
com.apple.Preview,1,1734158127,1734158128,1734158129,-21600,MacBook
com.apple.Notes,4,1734158123,1734158127,1734158128,-21600,MacBook
com.apple.Preview,23,1734158100,1734158123,1734158123,-21600,MacBook
com.apple.Notes,8,1734158092,1734158100,1734158101,-21600,MacBook
com.apple.Preview,6,1734158086,1734158092,1734158093,-21600,MacBook
com.apple.Notes,3,1734158083,1734158086,1734158087,-21600,MacBook
com.apple.Preview,8,1734158075,1734158083,1734158083,-21600,MacBook
com.apple.Notes,2,1734158073,1734158075,1734158076,-21600,MacBook
com.apple.Preview,3,1734158070,1734158073,1734158073,-21600,MacBook
com.apple.Notes,9,1734158061,1734158070,1734158070,-21600,MacBook
com.apple.Preview,3,1734158058,1734158061,1734158061,-21600,MacBook
com.apple.Notes,8,1734158050,1734158058,1734158059,-21600,MacBook
com.apple.Preview,7,1734158043,1734158050,1734158050,-21600,MacBook
com.apple.Notes,5,1734158038,1734158043,1734158043,-21600,MacBook
com.apple.Preview,8,1734158030,1734158038,1734158039,-21600,MacBook
com.apple.Notes,1,1734158029,1734158030,1734158031,-21600,MacBook
com.apple.Preview,3,1734158026,1734158029,1734158030,-21600,MacBook
com.apple.Notes,1,1734158025,1734158026,1734158026,-21600,MacBook
com.apple.Preview,1,1734158024,1734158025,1734158025,-21600,MacBook
com.apple.Notes,2,1734158022,1734158024,1734158025,-21600,MacBook
com.apple.Preview,62,1734157960,1734158022,1734158022,-21600,MacBook
com.apple.Notes,1,1734157959,1734157960,1734157961,-21600,MacBook
com.apple.Preview,3,1734157956,1734157959,1734157960,-21600,MacBook
com.apple.Notes,7,1734157949,1734157956,1734157957,-21600,MacBook
com.apple.Preview,2,1734157947,1734157949,1734157950,-21600,MacBook
com.apple.Notes,3,1734157944,1734157947,1734157948,-21600,MacBook
com.apple.Preview,3,1734157941,1734157944,1734157945,-21600,MacBook
com.apple.Notes,9,1734157932,1734157941,1734157942,-21600,MacBook
com.apple.Preview,13,1734157919,1734157932,1734157933,-21600,MacBook
com.apple.finder,1,1734157918,1734157919,1734157920,-21600,MacBook
com.apple.Preview,3,1734157915,1734157918,1734157918,-21600,MacBook
com.apple.finder,6,1734157909,1734157915,1734157916,-21600,MacBook
com.google.Chrome,21,1734157888,1734157909,1734157910,-21600,MacBook
com.apple.Preview,114,1734157774,1734157888,1734157888,-21600,MacBook
com.apple.finder,5,1734157769,1734157774,1734157775,-21600,MacBook
com.google.Chrome,538,1734157231,1734157769,1734157769,-21600,MacBook
com.apple.finder,1,1734157230,1734157231,1734157232,-21600,MacBook
com.google.Chrome,408,1734156822,1734157230,1734157231,-21600,MacBook
com.apple.finder,1,1734156821,1734156822,1734156823,-21600,MacBook
com.google.Chrome,490,1734156331,1734156821,1734156822,-21600,MacBook
com.apple.finder,2,1734156329,1734156331,1734156331,-21600,MacBook
com.apple.TextEdit,7,1734156322,1734156329,1734156329,-21600,MacBook
com.apple.finder,2,1734156320,1734156322,1734156323,-21600,MacBook
com.google.Chrome,18,1734156302,1734156320,1734156321,-21600,MacBook
com.apple.finder,5,1734156297,1734156302,1734156303,-21600,MacBook
com.google.Chrome,5,1734156292,1734156297,1734156297,-21600,MacBook
com.apple.finder,1,1734156291,1734156292,1734156293,-21600,MacBook
com.google.Chrome,1,1734156290,1734156291,1734156291,-21600,MacBook
com.apple.finder,12,1734156278,1734156290,1734156290,-21600,MacBook
com.apple.Preview,4,1734156274,1734156278,1734156279,-21600,MacBook
com.apple.finder,4,1734156270,1734156274,1734156275,-21600,MacBook
com.apple.archiveutility,1,1734156269,1734156270,1734156270,-21600,MacBook
com.apple.finder,5,1734156264,1734156269,1734156270,-21600,MacBook
com.google.Chrome,362,1734155902,1734156264,1734156264,-21600,MacBook
com.apple.finder,1,1734155901,1734155902,1734155903,-21600,MacBook
com.apple.Preview,10,1734155891,1734155901,1734155902,-21600,MacBook
com.apple.finder,1,1734155890,1734155891,1734155891,-21600,MacBook
com.google.Chrome,35,1734155855,1734155890,1734155891,-21600,MacBook
com.apple.finder,1,1734155854,1734155855,1734155855,-21600,MacBook
com.apple.Dictionary,2,1734155852,1734155854,1734155855,-21600,MacBook
com.google.Chrome,346,1734155506,1734155852,1734155853,-21600,MacBook
com.apple.Preview,1,1734155505,1734155506,1734155507,-21600,MacBook
com.google.Chrome,105,1734155400,1734155505,1734155506,-21600,MacBook
com.apple.Preview,1,1734155399,1734155400,1734155401,-21600,MacBook
com.google.Chrome,133,1734155266,1734155399,1734155400,-21600,MacBook
com.apple.Preview,14,1734155252,1734155266,1734155266,-21600,MacBook
com.google.Chrome,135,1734155117,1734155252,1734155253,-21600,MacBook
com.apple.Preview,6,1734155111,1734155117,1734155118,-21600,MacBook
com.google.Chrome,129,1734154982,1734155111,1734155111,-21600,MacBook
com.apple.Preview,26,1734154956,1734154982,1734154983,-21600,MacBook
com.apple.finder,21,1734154935,1734154956,1734154957,-21600,MacBook
com.apple.Preview,1,1734154934,1734154935,1734154936,-21600,MacBook
com.apple.finder,4,1734154930,1734154934,1734154934,-21600,MacBook
com.apple.Preview,32,1734154898,1734154930,1734154931,-21600,MacBook
com.google.Chrome,96,1734154802,1734154898,1734154898,-21600,MacBook
com.apple.Preview,13,1734154789,1734154802,1734154802,-21600,MacBook
com.google.Chrome,9,1734154780,1734154789,1734154790,-21600,MacBook
com.apple.Preview,7,1734154773,1734154780,1734154781,-21600,MacBook
com.apple.finder,5,1734154768,1734154773,1734154773,-21600,MacBook
com.google.Chrome,3,1734154765,1734154768,1734154768,-21600,MacBook
com.apple.finder,1,1734154764,1734154765,1734154766,-21600,MacBook
com.apple.Preview,7,1734154757,1734154764,1734154765,-21600,MacBook
com.apple.finder,6,1734154751,1734154757,1734154757,-21600,MacBook
com.google.Chrome,60,1734154691,1734154751,1734154752,-21600,MacBook
com.apple.finder,4,1734154687,1734154691,1734154692,-21600,MacBook
com.apple.Preview,2,1734154685,1734154687,1734154687,-21600,MacBook
com.google.Chrome,3,1734154682,1734154685,1734154686,-21600,MacBook
com.apple.Preview,192,1734154490,1734154682,1734154683,-21600,MacBook
com.apple.finder,8,1734154482,1734154490,1734154491,-21600,MacBook
com.apple.Preview,3,1734154479,1734154482,1734154482,-21600,MacBook
com.apple.finder,2,1734154477,1734154479,1734154479,-21600,MacBook
com.apple.Preview,3,1734154474,1734154477,1734154478,-21600,MacBook
com.google.Chrome,23,1734154451,1734154474,1734154475,-21600,MacBook
com.apple.Preview,6,1734154445,1734154451,1734154451,-21600,MacBook
com.google.Chrome,31,1734154414,1734154445,1734154445,-21600,MacBook
com.apple.Preview,3,1734154411,1734154414,1734154415,-21600,MacBook
com.google.Chrome,6,1734154405,1734154411,1734154411,-21600,MacBook
com.apple.Preview,17,1734154388,1734154405,1734154405,-21600,MacBook
com.google.Chrome,6,1734154382,1734154388,1734154388,-21600,MacBook
com.apple.Preview,3,1734154379,1734154382,1734154383,-21600,MacBook
com.google.Chrome,6,1734154373,1734154379,1734154380,-21600,MacBook
com.apple.Preview,2,1734154371,1734154373,1734154373,-21600,MacBook
com.google.Chrome,8,1734154363,1734154371,1734154371,-21600,MacBook
com.apple.Preview,3,1734154360,1734154363,1734154364,-21600,MacBook
com.google.Chrome,1,1734154359,1734154360,1734154361,-21600,MacBook
com.apple.Preview,8,1734154351,1734154359,1734154359,-21600,MacBook
com.google.Chrome,18,1734154333,1734154351,1734154352,-21600,MacBook
com.apple.Preview,100,1734154233,1734154333,1734154334,-21600,MacBook
com.google.Chrome,9,1734154224,1734154233,1734154234,-21600,MacBook
com.apple.Preview,12,1734154212,1734154224,1734154224,-21600,MacBook
com.google.Chrome,3,1734154209,1734154212,1734154212,-21600,MacBook
com.apple.Preview,1,1734154208,1734154209,1734154209,-21600,MacBook
com.google.Chrome,12,1734154196,1734154208,1734154208,-21600,MacBook
com.apple.Preview,37,1734154159,1734154196,1734154197,-21600,MacBook
com.apple.finder,0,1734154159,1734154159,1734154160,-21600,MacBook
com.apple.Preview,2,1734154157,1734154159,1734154159,-21600,MacBook
com.apple.finder,1,1734154156,1734154157,1734154158,-21600,MacBook
com.google.Chrome,40,1734154116,1734154156,1734154156,-21600,MacBook
com.apple.Preview,13,1734154103,1734154116,1734154116,-21600,MacBook
com.google.Chrome,150,1734153953,1734154103,1734154103,-21600,MacBook
com.apple.Preview,1,1734153952,1734153953,1734153954,-21600,MacBook
com.google.Chrome,22,1734153930,1734153952,1734153952,-21600,MacBook
com.apple.Preview,1,1734153929,1734153930,1734153930,-21600,MacBook
com.google.Chrome,74,1734153855,1734153929,1734153929,-21600,MacBook
com.apple.Preview,2,1734153853,1734153855,1734153855,-21600,MacBook
com.google.Chrome,5,1734153848,1734153853,1734153854,-21600,MacBook
com.apple.Preview,1,1734153847,1734153848,1734153848,-21600,MacBook
com.google.Chrome,264,1734153583,1734153847,1734153847,-21600,MacBook
com.apple.Preview,1,1734153582,1734153583,1734153583,-21600,MacBook
com.google.Chrome,7,1734153575,1734153582,1734153582,-21600,MacBook
com.apple.Preview,1,1734153574,1734153575,1734153576,-21600,MacBook
com.google.Chrome,114,1734153460,1734153574,1734153575,-21600,MacBook
com.google.Chrome,345,1734152949,1734153294,1734153294,-21600,MacBook
com.apple.Preview,1,1734152948,1734152949,1734152950,-21600,MacBook
com.google.Chrome,14,1734152934,1734152948,1734152949,-21600,MacBook
com.apple.Preview,0,1734152934,1734152934,1734152935,-21600,MacBook
com.google.Chrome,7,1734152927,1734152934,1734152934,-21600,MacBook
com.apple.Preview,1,1734152926,1734152927,1734152928,-21600,MacBook
com.google.Chrome,124,1734152802,1734152926,1734152927,-21600,MacBook
com.apple.finder,3,1734152799,1734152802,1734152803,-21600,MacBook
com.google.Chrome,2,1734152797,1734152799,1734152800,-21600,MacBook
com.apple.finder,1,1734152796,1734152797,1734152797,-21600,MacBook
com.apple.Dictionary,2,1734152794,1734152796,1734152797,-21600,MacBook
com.google.Chrome,361,1734152433,1734152794,1734152795,-21600,MacBook
com.apple.Preview,26,1734152407,1734152433,1734152434,-21600,MacBook
com.google.Chrome,28,1734152379,1734152407,1734152408,-21600,MacBook
com.apple.Preview,48,1734152331,1734152379,1734152379,-21600,MacBook
com.google.Chrome,82,1734152249,1734152331,1734152332,-21600,MacBook
com.apple.Preview,39,1734152210,1734152249,1734152250,-21600,MacBook
com.apple.finder,4,1734152206,1734152210,1734152211,-21600,MacBook
com.google.Chrome,2,1734152204,1734152206,1734152207,-21600,MacBook
com.apple.finder,4,1734152200,1734152204,1734152205,-21600,MacBook
com.apple.Preview,4,1734152196,1734152200,1734152201,-21600,MacBook
com.google.Chrome,40,1734152156,1734152196,1734152197,-21600,MacBook
com.apple.Preview,12,1734152144,1734152156,1734152156,-21600,MacBook
com.google.Chrome,7,1734152137,1734152144,1734152145,-21600,MacBook
com.apple.Preview,1,1734152136,1734152137,1734152137,-21600,MacBook
com.google.Chrome,6,1734152130,1734152136,1734152136,-21600,MacBook
com.apple.Preview,6,1734152124,1734152130,1734152131,-21600,MacBook
com.google.Chrome,12,1734152112,1734152124,1734152125,-21600,MacBook
com.apple.Preview,43,1734152069,1734152112,1734152112,-21600,MacBook
com.google.Chrome,1,1734152068,1734152069,1734152069,-21600,MacBook
com.apple.Preview,1,1734152067,1734152068,1734152069,-21600,MacBook
com.apple.finder,1,1734152066,1734152067,1734152067,-21600,MacBook
com.apple.Preview,35,1734152031,1734152066,1734152067,-21600,MacBook
com.google.Chrome,411,1734151620,1734152031,1734152032,-21600,MacBook
com.apple.Preview,35,1734151585,1734151620,1734151621,-21600,MacBook
com.google.Chrome,1,1734151584,1734151585,1734151586,-21600,MacBook
com.apple.Preview,40,1734151544,1734151584,1734151584,-21600,MacBook
com.google.Chrome,5,1734151539,1734151544,1734151545,-21600,MacBook
com.apple.Preview,4,1734151535,1734151539,1734151539,-21600,MacBook
com.google.Chrome,22,1734151513,1734151535,1734151535,-21600,MacBook
com.apple.Preview,96,1734151417,1734151513,1734151514,-21600,MacBook
com.google.Chrome,35,1734151382,1734151417,1734151418,-21600,MacBook
com.apple.Preview,265,1734151117,1734151382,1734151383,-21600,MacBook
com.google.Chrome,2,1734151115,1734151117,1734151118,-21600,MacBook
com.apple.Preview,4,1734151111,1734151115,1734151115,-21600,MacBook
com.google.Chrome,3,1734151108,1734151111,1734151112,-21600,MacBook
com.apple.Preview,72,1734151036,1734151108,1734151109,-21600,MacBook
com.google.Chrome,57,1734150979,1734151036,1734151037,-21600,MacBook
com.apple.Preview,15,1734150964,1734150979,1734150979,-21600,MacBook
com.google.Chrome,42,1734150922,1734150964,1734150964,-21600,MacBook
com.apple.Preview,5,1734150917,1734150922,1734150923,-21600,MacBook
com.apple.finder,10,1734150907,1734150917,1734150918,-21600,MacBook
com.apple.Preview,5,1734150902,1734150907,1734150908,-21600,MacBook
com.apple.finder,5,1734150897,1734150902,1734150903,-21600,MacBook
com.apple.Preview,3,1734150894,1734150897,1734150898,-21600,MacBook
com.apple.finder,8,1734150886,1734150894,1734150895,-21600,MacBook
com.apple.Preview,3,1734150883,1734150886,1734150887,-21600,MacBook
com.apple.finder,15,1734150868,1734150883,1734150884,-21600,MacBook
com.apple.Preview,1,1734150867,1734150868,1734150869,-21600,MacBook
com.google.Chrome,17,1734150850,1734150867,1734150868,-21600,MacBook
com.apple.Preview,4,1734150846,1734150850,1734150850,-21600,MacBook
com.apple.finder,3,1734150843,1734150846,1734150846,-21600,MacBook
com.apple.Preview,1,1734150842,1734150843,1734150843,-21600,MacBook
com.google.Chrome,4,1734150838,1734150842,1734150842,-21600,MacBook
com.apple.Preview,3,1734150835,1734150838,1734150838,-21600,MacBook
com.google.Chrome,1,1734150834,1734150835,1734150835,-21600,MacBook
com.apple.Preview,2,1734150832,1734150834,1734150834,-21600,MacBook
com.google.Chrome,4,1734150828,1734150832,1734150832,-21600,MacBook
com.apple.Preview,4,1734150824,1734150828,1734150829,-21600,MacBook
com.apple.finder,5,1734150819,1734150824,1734150824,-21600,MacBook
com.google.Chrome,882,1734149937,1734150819,1734150820,-21600,MacBook
com.apple.Preview,3,1734149934,1734149937,1734149938,-21600,MacBook
com.apple.finder,2,1734149932,1734149934,1734149934,-21600,MacBook
com.apple.Preview,10,1734149922,1734149932,1734149933,-21600,MacBook
com.apple.finder,6,1734149916,1734149922,1734149922,-21600,MacBook
com.google.Chrome,19,1734149897,1734149916,1734149916,-21600,MacBook
com.apple.Preview,77,1734149820,1734149897,1734149897,-21600,MacBook
com.google.Chrome,819,1734149001,1734149820,1734149821,-21600,MacBook
com.apple.Preview,4,1734148997,1734149001,1734149001,-21600,MacBook
com.google.Chrome,1,1734148996,1734148997,1734148998,-21600,MacBook
com.apple.Preview,2,1734148994,1734148996,1734148996,-21600,MacBook
com.google.Chrome,49,1734148945,1734148994,1734148995,-21600,MacBook
com.apple.Preview,109,1734148836,1734148945,1734148945,-21600,MacBook
com.google.Chrome,83,1734148753,1734148836,1734148837,-21600,MacBook
com.apple.Preview,6,1734148747,1734148753,1734148753,-21600,MacBook
com.google.Chrome,51,1734148696,1734148747,1734148748,-21600,MacBook
com.apple.Preview,2,1734148694,1734148696,1734148697,-21600,MacBook
com.google.Chrome,1,1734148693,1734148694,1734148695,-21600,MacBook
com.apple.Preview,3,1734148690,1734148693,1734148693,-21600,MacBook
com.google.Chrome,7,1734148683,1734148690,1734148690,-21600,MacBook
com.apple.Preview,18,1734148665,1734148683,1734148684,-21600,MacBook
com.google.Chrome,107,1734148558,1734148665,1734148666,-21600,MacBook
com.apple.Preview,70,1734148488,1734148558,1734148559,-21600,MacBook
com.google.Chrome,36,1734148452,1734148488,1734148489,-21600,MacBook
com.apple.Preview,32,1734148420,1734148452,1734148453,-21600,MacBook
com.apple.finder,1,1734148419,1734148420,1734148420,-21600,MacBook
com.apple.Preview,13,1734148406,1734148419,1734148419,-21600,MacBook
com.apple.finder,8,1734148398,1734148406,1734148406,-21600,MacBook
com.apple.Preview,2,1734148396,1734148398,1734148399,-21600,MacBook
com.apple.finder,5,1734148391,1734148396,1734148397,-21600,MacBook
com.apple.Preview,50,1734148341,1734148391,1734148392,-21600,MacBook
com.google.Chrome,28,1734148313,1734148341,1734148342,-21600,MacBook
com.apple.Preview,2,1734148311,1734148313,1734148314,-21600,MacBook
com.google.Chrome,9,1734148302,1734148311,1734148311,-21600,MacBook
com.apple.Preview,18,1734148284,1734148302,1734148303,-21600,MacBook
com.google.Chrome,141,1734148143,1734148284,1734148285,-21600,MacBook
com.apple.Preview,19,1734148124,1734148143,1734148143,-21600,MacBook
com.apple.finder,1,1734148123,1734148124,1734148125,-21600,MacBook
com.google.Chrome,318,1734147805,1734148123,1734148124,-21600,MacBook
com.apple.finder,2,1734147803,1734147805,1734147805,-21600,MacBook
com.apple.Preview,4,1734147799,1734147803,1734147804,-21600,MacBook
com.apple.finder,6,1734147793,1734147799,1734147800,-21600,MacBook
com.apple.Notes,2,1734147791,1734147793,1734147793,-21600,MacBook
com.google.Chrome,767,1734147024,1734147791,1734147792,-21600,MacBook
com.apple.Notes,2,1734147022,1734147024,1734147025,-21600,MacBook
com.tencent.xinWeChat,4,1734147018,1734147022,1734147022,-21600,MacBook
com.tencent.xinWeChat,43,1734146744,1734146787,1734146787,-21600,MacBook
com.tinyspeck.slackmacgap,3,1734146741,1734146744,1734146745,-21600,MacBook
com.tencent.xinWeChat,0,1734146741,1734146741,1734146742,-21600,MacBook
com.tinyspeck.slackmacgap,0,1734146741,1734146741,1734146741,-21600,MacBook
com.tencent.xinWeChat,1,1734146740,1734146741,1734146741,-21600,MacBook
com.tinyspeck.slackmacgap,1,1734146739,1734146740,1734146741,-21600,MacBook
com.tencent.xinWeChat,0,1734146739,1734146739,1734146740,-21600,MacBook
com.microsoft.Outlook,2,1734146737,1734146739,1734146739,-21600,MacBook
com.tencent.xinWeChat,5,1734146732,1734146737,1734146737,-21600,MacBook
com.microsoft.Outlook,0,1734146732,1734146732,1734146732,-21600,MacBook
com.google.Chrome,1303,1734145429,1734146732,1734146732,-21600,MacBook
com.microsoft.Outlook,12,1734145417,1734145429,1734145429,-21600,MacBook
com.apple.Notes,0,1734145417,1734145417,1734145418,-21600,MacBook
com.google.Chrome,373,1734145044,1734145417,1734145418,-21600,MacBook
com.apple.Notes,10,1734145034,1734145044,1734145045,-21600,MacBook
com.google.Chrome,240,1734144794,1734145034,1734145035,-21600,MacBook
com.apple.Notes,9,1734144785,1734144794,1734144795,-21600,MacBook
com.google.Chrome,3,1734144782,1734144785,1734144786,-21600,MacBook
com.apple.Notes,8,1734144774,1734144782,1734144783,-21600,MacBook
com.apple.finder,0,1734144774,1734144774,1734144774,-21600,MacBook
com.google.Chrome,214,1734144560,1734144774,1734144774,-21600,MacBook
com.apple.finder,59,1734144501,1734144560,1734144561,-21600,MacBook
com.tencent.xin,8,1734144520,1734144528,1734144529,-21600,iPhone
com.tencent.xin,69,1734144216,1734144285,1734144286,-21600,iPhone
com.microsoft.Office.Outlook,1,1734144215,1734144216,1734144216,-21600,iPhone
com.tencent.xin,1,1734144214,1734144215,1734144215,-21600,iPhone
com.xingin.discover,192,1734144021,1734144213,1734144213,-21600,iPhone
com.apple.MobileSMS,1,1734144019,1734144020,1734144021,-21600,iPhone
com.xingin.discover,202,1734143817,1734144019,1734144019,-21600,iPhone
com.apple.camera,42,1734143758,1734143800,1734143801,-21600,iPhone
com.xingin.discover,43,1734143757,1734143800,1734143801,-21600,iPhone
com.xingin.discover,294,1734143428,1734143722,1734143722,-21600,iPhone
com.apple.finder,290,1734143282,1734143572,1734143572,-21600,MacBook
com.tencent.xin,74,1734143354,1734143428,1734143428,-21600,iPhone
com.google.Chrome,237,1734143034,1734143271,1734143271,-21600,MacBook
com.google.Chrome,616,1734142049,1734142665,1734142666,-21600,MacBook
com.google.Chrome,328,1734141581,1734141909,1734141909,-21600,MacBook
com.google.Chrome,477,1734140931,1734141408,1734141408,-21600,MacBook
com.tencent.xin,3,1734141090,1734141093,1734141094,-21600,iPhone
com.tencent.xin,10,1734141079,1734141089,1734141090,-21600,iPhone
com.apple.PassbookUIService,7,1734141082,1734141089,1734141090,-21600,iPhone
com.tencent.xinWeChat,8,1734140923,1734140931,1734140932,-21600,MacBook
com.google.Chrome,136,1734140787,1734140923,1734140924,-21600,MacBook
com.apple.finder,1,1734140786,1734140787,1734140788,-21600,MacBook
com.tencent.xinWeChat,7,1734140779,1734140786,1734140787,-21600,MacBook
com.google.Chrome,5,1734140774,1734140779,1734140779,-21600,MacBook
com.tencent.xinWeChat,155,1734140619,1734140774,1734140775,-21600,MacBook
com.apple.finder,1,1734140618,1734140619,1734140619,-21600,MacBook
com.tencent.xinWeChat,0,1734140618,1734140618,1734140619,-21600,MacBook
com.apple.finder,0,1734140618,1734140618,1734140619,-21600,MacBook
com.tencent.xinWeChat,4,1734140614,1734140618,1734140618,-21600,MacBook
com.apple.finder,1,1734140613,1734140614,1734140614,-21600,MacBook
com.tencent.xinWeChat,6,1734140607,1734140613,1734140613,-21600,MacBook
com.apple.finder,0,1734140607,1734140607,1734140608,-21600,MacBook
com.tencent.xinWeChat,24,1734140583,1734140607,1734140607,-21600,MacBook
com.apple.finder,1,1734140582,1734140583,1734140583,-21600,MacBook
com.tencent.xinWeChat,5,1734140577,1734140582,1734140583,-21600,MacBook
com.apple.finder,0,1734140577,1734140577,1734140578,-21600,MacBook
com.tencent.xinWeChat,27,1734140550,1734140577,1734140577,-21600,MacBook
com.apple.finder,0,1734140550,1734140550,1734140551,-21600,MacBook
com.tencent.xinWeChat,2,1734140548,1734140550,1734140550,-21600,MacBook
com.apple.finder,1,1734140547,1734140548,1734140548,-21600,MacBook
com.tencent.xinWeChat,0,1734140547,1734140547,1734140548,-21600,MacBook
com.apple.finder,0,1734140547,1734140547,1734140547,-21600,MacBook
com.tencent.xinWeChat,5,1734140542,1734140547,1734140547,-21600,MacBook
com.apple.finder,0,1734140542,1734140542,1734140543,-21600,MacBook
com.tencent.xinWeChat,1,1734140541,1734140542,1734140542,-21600,MacBook
com.apple.finder,0,1734140541,1734140541,1734140542,-21600,MacBook
com.tencent.xinWeChat,2,1734140539,1734140541,1734140541,-21600,MacBook
com.apple.finder,0,1734140539,1734140539,1734140540,-21600,MacBook
com.tencent.xinWeChat,1,1734140538,1734140539,1734140540,-21600,MacBook
com.apple.finder,1,1734140537,1734140538,1734140538,-21600,MacBook
com.tencent.xinWeChat,3,1734140534,1734140537,1734140538,-21600,MacBook
com.apple.finder,1,1734140533,1734140534,1734140534,-21600,MacBook
com.tencent.xinWeChat,7,1734140526,1734140533,1734140534,-21600,MacBook
com.apple.finder,1,1734140525,1734140526,1734140526,-21600,MacBook
com.tencent.xinWeChat,2,1734140523,1734140525,1734140526,-21600,MacBook
com.apple.finder,0,1734140523,1734140523,1734140524,-21600,MacBook
com.tencent.xinWeChat,33,1734140490,1734140523,1734140524,-21600,MacBook
com.apple.finder,0,1734140490,1734140490,1734140491,-21600,MacBook
com.tencent.xinWeChat,2,1734140488,1734140490,1734140491,-21600,MacBook
com.apple.finder,0,1734140488,1734140488,1734140489,-21600,MacBook
com.tencent.xinWeChat,0,1734140488,1734140488,1734140489,-21600,MacBook
com.apple.finder,1,1734140487,1734140488,1734140488,-21600,MacBook
com.tencent.xinWeChat,62,1734140425,1734140487,1734140488,-21600,MacBook
com.google.Chrome,2607,1734137818,1734140425,1734140426,-21600,MacBook
com.tencent.xin,19,1734140184,1734140203,1734140204,-21600,iPhone
com.tencent.xin,22,1734140161,1734140183,1734140184,-21600,iPhone
com.xingin.discover,2,1734140159,1734140161,1734140162,-21600,iPhone
com.xingin.discover,1,1734140158,1734140159,1734140159,-21600,iPhone
com.apple.finder,5,1734137813,1734137818,1734137818,-21600,MacBook
com.google.Chrome,191,1734137622,1734137813,1734137814,-21600,MacBook
com.apple.finder,1,1734137621,1734137622,1734137622,-21600,MacBook
com.google.Chrome,225,1734137396,1734137621,1734137622,-21600,MacBook
com.xingin.discover,2,1734137408,1734137410,1734137411,-21600,iPhone
com.xingin.discover,6,1734137322,1734137328,1734137328,-21600,iPhone
com.xingin.discover,35,1734137267,1734137302,1734137303,-21600,iPhone
com.ubercab.UberEats,4,1734137261,1734137265,1734137265,-21600,iPhone
com.ubercab.UberEats,4,1734137256,1734137260,1734137261,-21600,iPhone
com.ubercab.UberEats,8,1734137181,1734137189,1734137189,-21600,iPhone
com.ubercab.UberEats,27,1734137139,1734137166,1734137167,-21600,iPhone
com.tencent.xin,9,1734137130,1734137139,1734137140,-21600,iPhone
com.google.Chrome,1650,1734135481,1734137131,1734137132,-21600,MacBook
com.tencent.xin,5,1734136749,1734136754,1734136755,-21600,iPhone
com.apple.mobiletimer,5,1734136744,1734136749,1734136750,-21600,iPhone
com.apple.mobiletimer,6,1734136705,1734136711,1734136711,-21600,iPhone
com.ubercab.UberEats,7,1734136698,1734136705,1734136705,-21600,iPhone
com.apple.mobiletimer,1,1734136696,1734136697,1734136698,-21600,iPhone
com.tencent.xin,31,1734136665,1734136696,1734136697,-21600,iPhone
com.ridewithvia.UCA.UniversityOfChicagoRider,38,1734136627,1734136665,1734136666,-21600,iPhone
com.tencent.xin,31,1734136596,1734136627,1734136627,-21600,iPhone
com.tencent.xin,1,1734136594,1734136595,1734136596,-21600,iPhone
com.ubercab.UberEats,7,1734136587,1734136594,1734136594,-21600,iPhone
com.ubercab.UberEats,11,1734135794,1734135805,1734135806,-21600,iPhone
com.apple.mobiletimer,2,1734135792,1734135794,1734135795,-21600,iPhone
com.apple.finder,4,1734135477,1734135481,1734135482,-21600,MacBook
com.microsoft.Outlook,121,1734135356,1734135477,1734135478,-21600,MacBook
com.tencent.xin,13,1734134886,1734134899,1734134900,-21600,iPhone
com.apple.mobiletimer,8,1734134878,1734134886,1734134886,-21600,iPhone
com.ubercab.UberEats,5,1734134872,1734134877,1734134878,-21600,iPhone
com.discoverfinancial.mobile,121,1734134751,1734134872,1734134872,-21600,iPhone
com.apple.CoreAuthUI,2,1734134757,1734134759,1734134760,-21600,iPhone
com.ubercab.UberEats,327,1734134422,1734134749,1734134750,-21600,iPhone
com.apple.PassbookUIService,8,1734134739,1734134747,1734134747,-21600,iPhone
com.microsoft.Outlook,314,1734134119,1734134433,1734134434,-21600,MacBook
com.apple.Notes,1,1734134118,1734134119,1734134120,-21600,MacBook
com.microsoft.Outlook,6,1734134112,1734134118,1734134118,-21600,MacBook
com.apple.Notes,1,1734134111,1734134112,1734134113,-21600,MacBook
com.apple.Notes,450,1734133355,1734133805,1734133806,-21600,MacBook
com.apple.finder,1,1734133354,1734133355,1734133355,-21600,MacBook
com.apple.Notes,328,1734133026,1734133354,1734133355,-21600,MacBook
com.apple.finder,1,1734133025,1734133026,1734133026,-21600,MacBook
com.apple.Notes,762,1734132263,1734133025,1734133026,-21600,MacBook
com.apple.finder,1,1734132262,1734132263,1734132264,-21600,MacBook
com.apple.Notes,375,1734131887,1734132262,1734132263,-21600,MacBook
com.google.Chrome,1,1734131886,1734131887,1734131888,-21600,MacBook
com.apple.Notes,5,1734131881,1734131886,1734131887,-21600,MacBook
com.apple.finder,2,1734131879,1734131881,1734131881,-21600,MacBook
com.google.Chrome,6,1734131873,1734131879,1734131880,-21600,MacBook
com.apple.finder,3,1734131870,1734131873,1734131874,-21600,MacBook
com.google.Chrome,2,1734131868,1734131870,1734131870,-21600,MacBook
com.apple.finder,2,1734131866,1734131868,1734131868,-21600,MacBook
com.google.Chrome,2,1734131864,1734131866,1734131867,-21600,MacBook
com.apple.finder,1,1734131863,1734131864,1734131865,-21600,MacBook
com.google.Chrome,64,1734131799,1734131863,1734131864,-21600,MacBook
com.apple.finder,0,1734131799,1734131799,1734131800,-21600,MacBook
com.apple.Notes,2,1734131797,1734131799,1734131799,-21600,MacBook
com.apple.finder,1,1734131796,1734131797,1734131798,-21600,MacBook
com.apple.Notes,19,1734131777,1734131796,1734131797,-21600,MacBook
com.google.Chrome,2,1734131775,1734131777,1734131778,-21600,MacBook
com.apple.Notes,6,1734131769,1734131775,1734131775,-21600,MacBook
com.google.Chrome,5,1734131764,1734131769,1734131770,-21600,MacBook
com.apple.Notes,15,1734131749,1734131764,1734131765,-21600,MacBook
com.apple.finder,2,1734131747,1734131749,1734131749,-21600,MacBook
com.google.Chrome,3,1734131744,1734131747,1734131748,-21600,MacBook
com.apple.finder,1,1734131743,1734131744,1734131745,-21600,MacBook
com.tencent.xinWeChat,27,1734131716,1734131743,1734131743,-21600,MacBook
com.google.Chrome,1544,1734130172,1734131716,1734131717,-21600,MacBook
com.apple.finder,3,1734130169,1734130172,1734130172,-21600,MacBook
com.google.Chrome,2764,1734127405,1734130169,1734130170,-21600,MacBook
com.apple.finder,1,1734127404,1734127405,1734127406,-21600,MacBook
com.tencent.xinWeChat,34,1734127370,1734127404,1734127404,-21600,MacBook
com.google.Chrome,35,1734127335,1734127370,1734127371,-21600,MacBook
com.microsoft.Outlook,2,1734127333,1734127335,1734127335,-21600,MacBook
com.google.Chrome,31,1734127302,1734127333,1734127333,-21600,MacBook
com.microsoft.Outlook,22,1734127280,1734127302,1734127302,-21600,MacBook
com.google.Chrome,744,1734126536,1734127280,1734127281,-21600,MacBook
com.microsoft.Outlook,1,1734126535,1734126536,1734126537,-21600,MacBook
com.apple.Dictionary,1,1734126534,1734126535,1734126536,-21600,MacBook
com.google.Chrome,865,1734125669,1734126534,1734126534,-21600,MacBook
com.microsoft.Outlook,16,1734125653,1734125669,1734125669,-21600,MacBook
com.apple.finder,1,1734125652,1734125653,1734125654,-21600,MacBook
com.google.Chrome,1419,1734124233,1734125652,1734125653,-21600,MacBook
com.apple.finder,2,1734124231,1734124233,1734124233,-21600,MacBook
com.google.Chrome,21,1734124210,1734124231,1734124232,-21600,MacBook
com.apple.finder,1,1734124209,1734124210,1734124210,-21600,MacBook
com.apple.Dictionary,1,1734124208,1734124209,1734124210,-21600,MacBook
com.google.Chrome,0,1734124208,1734124208,1734124209,-21600,MacBook
com.apple.Dictionary,2,1734124206,1734124208,1734124208,-21600,MacBook
com.google.Chrome,91,1734124115,1734124206,1734124207,-21600,MacBook
com.apple.finder,2,1734124113,1734124115,1734124115,-21600,MacBook
com.apple.Dictionary,2,1734124111,1734124113,1734124114,-21600,MacBook
com.google.Chrome,1319,1734122792,1734124111,1734124112,-21600,MacBook
com.tencent.xin,36,1734123352,1734123388,1734123389,-21600,iPhone
com.apple.MobileSMS,4,1734123348,1734123352,1734123352,-21600,iPhone
com.tencent.xin,2,1734123345,1734123347,1734123347,-21600,iPhone
com.tencent.xin,1,1734123343,1734123344,1734123345,-21600,iPhone
com.chase,6,1734123337,1734123343,1734123344,-21600,iPhone
com.apple.finder,3,1734122789,1734122792,1734122792,-21600,MacBook
com.tencent.xinWeChat,108,1734122681,1734122789,1734122790,-21600,MacBook
com.chase,19,1734122735,1734122754,1734122754,-21600,iPhone
com.apple.CoreAuthUI,2,1734122738,1734122740,1734122740,-21600,iPhone
com.netease.cloudmusic,1,1734122731,1734122732,1734122733,-21600,iPhone
com.apple.finder,1,1734122680,1734122681,1734122681,-21600,MacBook
com.tencent.xinWeChat,7,1734122673,1734122680,1734122681,-21600,MacBook
com.apple.finder,0,1734122673,1734122673,1734122674,-21600,MacBook
com.tencent.xinWeChat,43,1734122630,1734122673,1734122673,-21600,MacBook
com.apple.finder,2,1734122628,1734122630,1734122630,-21600,MacBook
com.google.Chrome,201,1734122427,1734122628,1734122629,-21600,MacBook
com.apple.finder,1,1734122426,1734122427,1734122428,-21600,MacBook
com.google.Chrome,67,1734122359,1734122426,1734122426,-21600,MacBook
com.apple.finder,3,1734122356,1734122359,1734122359,-21600,MacBook
com.microsoft.Outlook,4,1734122352,1734122356,1734122356,-21600,MacBook
com.apple.Notes,2,1734122350,1734122352,1734122353,-21600,MacBook
com.google.Chrome,58,1734122292,1734122350,1734122351,-21600,MacBook
com.apple.Notes,19,1734122254,1734122273,1734122273,-21600,MacBook
com.google.Chrome,6,1734122248,1734122254,1734122254,-21600,MacBook
com.apple.Notes,24,1734122224,1734122248,1734122248,-21600,MacBook
com.apple.finder,9,1734122215,1734122224,1734122224,-21600,MacBook
com.google.Chrome,204,1734122011,1734122215,1734122216,-21600,MacBook
com.netease.cloudmusic,6,1734122185,1734122191,1734122192,-21600,iPhone
com.google.calendar,2,1734122181,1734122183,1734122184,-21600,iPhone
com.microsoft.Office.Outlook,9,1734122172,1734122181,1734122181,-21600,iPhone
com.apple.finder,1,1734122010,1734122011,1734122012,-21600,MacBook
com.google.Chrome,1,1734122009,1734122010,1734122010,-21600,MacBook
com.microsoft.Outlook,2,1734122007,1734122009,1734122009,-21600,MacBook
com.apple.finder,3,1734122004,1734122007,1734122007,-21600,MacBook
us.zoom.xos,11,1734121993,1734122004,1734122004,-21600,MacBook
com.apple.finder,1,1734121992,1734121993,1734121993,-21600,MacBook
com.microsoft.Outlook,13,1734121979,1734121992,1734121992,-21600,MacBook
com.apple.finder,1,1734121978,1734121979,1734121979,-21600,MacBook
com.microsoft.Outlook,0,1734121978,1734121978,1734121979,-21600,MacBook
com.apple.finder,1,1734121977,1734121978,1734121978,-21600,MacBook
com.microsoft.Outlook,22,1734121955,1734121977,1734121978,-21600,MacBook
com.apple.finder,0,1734121955,1734121955,1734121956,-21600,MacBook
com.microsoft.Outlook,1,1734121954,1734121955,1734121955,-21600,MacBook
com.apple.finder,0,1734121954,1734121954,1734121954,-21600,MacBook
com.microsoft.Outlook,1,1734121953,1734121954,1734121954,-21600,MacBook
com.apple.finder,1,1734121952,1734121953,1734121953,-21600,MacBook
com.microsoft.Outlook,0,1734121952,1734121952,1734121953,-21600,MacBook
com.apple.finder,1,1734121951,1734121952,1734121952,-21600,MacBook
com.microsoft.Outlook,0,1734121951,1734121951,1734121952,-21600,MacBook
com.apple.finder,1,1734121950,1734121951,1734121951,-21600,MacBook
com.microsoft.Outlook,0,1734121950,1734121950,1734121951,-21600,MacBook
com.apple.finder,1,1734121949,1734121950,1734121950,-21600,MacBook
com.microsoft.Outlook,0,1734121949,1734121949,1734121950,-21600,MacBook
com.apple.finder,1,1734121948,1734121949,1734121949,-21600,MacBook
com.microsoft.Outlook,1,1734121947,1734121948,1734121949,-21600,MacBook
com.apple.finder,0,1734121947,1734121947,1734121948,-21600,MacBook
com.microsoft.Outlook,1,1734121946,1734121947,1734121948,-21600,MacBook
com.apple.finder,0,1734121946,1734121946,1734121947,-21600,MacBook
com.microsoft.Outlook,1,1734121945,1734121946,1734121946,-21600,MacBook
com.apple.finder,0,1734121945,1734121945,1734121946,-21600,MacBook
com.microsoft.Outlook,1,1734121944,1734121945,1734121946,-21600,MacBook
com.apple.finder,0,1734121944,1734121944,1734121945,-21600,MacBook
com.microsoft.Outlook,0,1734121944,1734121944,1734121945,-21600,MacBook
com.apple.finder,1,1734121943,1734121944,1734121944,-21600,MacBook
com.microsoft.Outlook,77,1734121866,1734121943,1734121944,-21600,MacBook
com.apple.finder,1,1734121865,1734121866,1734121866,-21600,MacBook
com.microsoft.Outlook,0,1734121865,1734121865,1734121866,-21600,MacBook
com.apple.finder,1,1734121864,1734121865,1734121865,-21600,MacBook
com.microsoft.Outlook,0,1734121864,1734121864,1734121865,-21600,MacBook
com.apple.finder,1,1734121863,1734121864,1734121864,-21600,MacBook
com.microsoft.Outlook,0,1734121863,1734121863,1734121864,-21600,MacBook
com.apple.finder,1,1734121862,1734121863,1734121864,-21600,MacBook
com.microsoft.Outlook,0,1734121862,1734121862,1734121863,-21600,MacBook
us.zoom.xos,35,1734121827,1734121862,1734121862,-21600,MacBook
com.apple.finder,1,1734121826,1734121827,1734121828,-21600,MacBook
com.microsoft.Outlook,0,1734121826,1734121826,1734121826,-21600,MacBook
com.apple.finder,2,1734121824,1734121826,1734121826,-21600,MacBook
com.microsoft.Outlook,1,1734121823,1734121824,1734121825,-21600,MacBook
com.apple.finder,0,1734121823,1734121823,1734121824,-21600,MacBook
com.microsoft.Outlook,2,1734121821,1734121823,1734121823,-21600,MacBook
us.zoom.xos,3,1734121818,1734121821,1734121821,-21600,MacBook
com.apple.finder,1,1734121817,1734121818,1734121819,-21600,MacBook
com.microsoft.Outlook,3,1734121814,1734121817,1734121817,-21600,MacBook
us.zoom.xos,37,1734121777,1734121814,1734121815,-21600,MacBook
com.google.Chrome,20,1734121757,1734121777,1734121778,-21600,MacBook
com.apple.finder,5,1734121752,1734121757,1734121757,-21600,MacBook
us.zoom.xos,8,1734121744,1734121752,1734121752,-21600,MacBook
com.google.Chrome,1,1734121743,1734121744,1734121745,-21600,MacBook
us.zoom.xos,0,1734121743,1734121743,1734121744,-21600,MacBook
com.google.Chrome,3,1734121740,1734121743,1734121743,-21600,MacBook
com.apple.finder,2,1734121738,1734121740,1734121741,-21600,MacBook
us.zoom.xos,2,1734121736,1734121738,1734121739,-21600,MacBook
com.google.Chrome,1,1734121735,1734121736,1734121736,-21600,MacBook
us.zoom.xos,2,1734121733,1734121735,1734121736,-21600,MacBook
com.google.Chrome,3,1734121730,1734121733,1734121733,-21600,MacBook
us.zoom.xos,7,1734121723,1734121730,1734121731,-21600,MacBook
com.microsoft.Office.Outlook,5,1734121725,1734121730,1734121731,-21600,iPhone
com.google.Chrome,3,1734121720,1734121723,1734121724,-21600,MacBook
com.microsoft.Outlook,1,1734121719,1734121720,1734121720,-21600,MacBook
com.google.Chrome,8,1734121711,1734121719,1734121719,-21600,MacBook
com.microsoft.Outlook,15,1734121696,1734121711,1734121712,-21600,MacBook
com.apple.finder,1,1734121695,1734121696,1734121697,-21600,MacBook
com.google.Chrome,674,1734121021,1734121695,1734121696,-21600,MacBook
com.microsoft.Outlook,3,1734121018,1734121021,1734121022,-21600,MacBook
com.google.Chrome,51,1734120967,1734121018,1734121018,-21600,MacBook
com.microsoft.Outlook,11,1734120956,1734120967,1734120968,-21600,MacBook
com.apple.Notes,131,1734120825,1734120956,1734120957,-21600,MacBook
com.google.Chrome,15,1734120810,1734120825,1734120825,-21600,MacBook
com.apple.Notes,170,1734120640,1734120810,1734120810,-21600,MacBook
com.apple.MobileSMS,2,1734120668,1734120670,1734120671,-21600,iPhone
com.google.calendar,7,1734120660,1734120667,1734120668,-21600,iPhone
com.apple.MobileSMS,1,1734120659,1734120660,1734120660,-21600,iPhone
com.netease.cloudmusic,14,1734120643,1734120657,1734120658,-21600,iPhone
com.apple.finder,1,1734120639,1734120640,1734120640,-21600,MacBook
com.google.Chrome,190,1734120449,1734120639,1734120639,-21600,MacBook
com.google.Chrome,3257,1734115862,1734119119,1734119119,-21600,MacBook
com.microsoft.Outlook,1,1734115861,1734115862,1734115862,-21600,MacBook
com.apple.Dictionary,2,1734115859,1734115861,1734115861,-21600,MacBook
com.google.Chrome,985,1734114874,1734115859,1734115859,-21600,MacBook
com.microsoft.Outlook,2,1734114872,1734114874,1734114875,-21600,MacBook
com.google.Chrome,791,1734114081,1734114872,1734114873,-21600,MacBook
com.netease.cloudmusic,13,1734114175,1734114188,1734114189,-21600,iPhone
com.apple.Preferences,3,1734114171,1734114174,1734114175,-21600,iPhone
com.netease.cloudmusic,9,1734114160,1734114169,1734114170,-21600,iPhone
com.google.Chrome,53,1734113908,1734113961,1734113961,-21600,MacBook
com.microsoft.Outlook,1,1734113907,1734113908,1734113908,-21600,MacBook
com.apple.Dictionary,2,1734113905,1734113907,1734113908,-21600,MacBook
com.google.Chrome,346,1734113559,1734113905,1734113906,-21600,MacBook
com.microsoft.Office.Outlook,18,1734113567,1734113585,1734113585,-21600,iPhone
com.microsoft.Outlook,20,1734113539,1734113559,1734113559,-21600,MacBook
com.microsoft.Office.Outlook,3,1734113546,1734113549,1734113550,-21600,iPhone
com.apple.finder,1,1734113538,1734113539,1734113540,-21600,MacBook
com.microsoft.Outlook,6,1734113532,1734113538,1734113539,-21600,MacBook
com.apple.finder,3,1734113529,1734113532,1734113532,-21600,MacBook
com.apple.Preview,3,1734113526,1734113529,1734113530,-21600,MacBook
com.apple.finder,1,1734113525,1734113526,1734113527,-21600,MacBook
com.apple.Preview,1,1734113524,1734113525,1734113526,-21600,MacBook
com.apple.finder,0,1734113524,1734113524,1734113525,-21600,MacBook
com.microsoft.Outlook,12,1734113512,1734113524,1734113524,-21600,MacBook
com.google.Chrome,8,1734113471,1734113479,1734113479,-21600,MacBook
com.microsoft.Outlook,23,1734113448,1734113471,1734113472,-21600,MacBook
com.google.Chrome,51,1734113397,1734113448,1734113449,-21600,MacBook
com.microsoft.Outlook,13,1734113384,1734113397,1734113398,-21600,MacBook
com.apple.Preview,8,1734113376,1734113384,1734113385,-21600,MacBook
com.apple.finder,4,1734113372,1734113376,1734113376,-21600,MacBook
com.apple.Preview,17,1734113355,1734113372,1734113373,-21600,MacBook
com.apple.finder,2,1734113353,1734113355,1734113355,-21600,MacBook
com.apple.Preview,1,1734113352,1734113353,1734113354,-21600,MacBook
com.apple.finder,2,1734113350,1734113352,1734113352,-21600,MacBook
com.microsoft.Outlook,76,1734113274,1734113350,1734113351,-21600,MacBook
com.apple.finder,2,1734113272,1734113274,1734113274,-21600,MacBook
com.apple.Preview,13,1734113259,1734113272,1734113272,-21600,MacBook
com.microsoft.Office.Outlook,70,1734113197,1734113267,1734113268,-21600,iPhone
com.apple.finder,1,1734113258,1734113259,1734113260,-21600,MacBook
com.apple.Preview,1,1734113257,1734113258,1734113259,-21600,MacBook
com.apple.finder,0,1734113257,1734113257,1734113258,-21600,MacBook
com.microsoft.Outlook,3,1734113254,1734113257,1734113257,-21600,MacBook
com.apple.finder,2,1734113252,1734113254,1734113255,-21600,MacBook
com.microsoft.Outlook,2,1734113250,1734113252,1734113253,-21600,MacBook
com.apple.finder,1,1734113249,1734113250,1734113251,-21600,MacBook
com.apple.Preview,25,1734113224,1734113249,1734113249,-21600,MacBook
com.apple.finder,3,1734113221,1734113224,1734113225,-21600,MacBook
com.apple.Preview,3,1734113218,1734113221,1734113221,-21600,MacBook
com.apple.finder,2,1734113216,1734113218,1734113218,-21600,MacBook
com.microsoft.Outlook,10,1734113206,1734113216,1734113217,-21600,MacBook
com.apple.finder,1,1734113205,1734113206,1734113207,-21600,MacBook
com.microsoft.Outlook,8,1734113197,1734113205,1734113206,-21600,MacBook
com.apple.finder,0,1734113197,1734113197,1734113199,-21600,MacBook
com.google.Chrome,3,1734113194,1734113197,1734113198,-21600,MacBook
com.microsoft.Office.Outlook,1,1734113175,1734113176,1734113177,-21600,iPhone
com.netease.cloudmusic,11,1734113164,1734113175,1734113175,-21600,iPhone
com.microsoft.Office.Outlook,40,1734113124,1734113164,1734113164,-21600,iPhone
com.microsoft.Office.Outlook,43,1734113080,1734113123,1734113124,-21600,iPhone
com.apple.mobiletimer,2,1734113070,1734113072,1734113073,-21600,iPhone
com.netease.cloudmusic,85,1734112985,1734113070,1734113070,-21600,iPhone
com.xingin.discover,61,1734112923,1734112984,1734112985,-21600,iPhone
com.netease.cloudmusic,17,1734112906,1734112923,1734112924,-21600,iPhone
com.google.Chrome,20,1734112895,1734112915,1734112915,-21600,MacBook
com.xingin.discover,10,1734112896,1734112906,1734112907,-21600,iPhone
com.netease.cloudmusic,2,1734112894,1734112896,1734112898,-21600,iPhone
com.xingin.discover,1884,1734111007,1734112891,1734112892,-21600,iPhone
com.apple.mobiletimer,5,1734111002,1734111007,1734111007,-21600,iPhone
com.xingin.discover,1985,1734109017,1734111002,1734111003,-21600,iPhone
com.apple.camera,60,1734108955,1734109015,1734109016,-21600,iPhone
com.apple.mobileslideshow,29,1734108925,1734108954,1734108955,-21600,iPhone
com.tencent.xin,90,1734108835,1734108925,1734108926,-21600,iPhone
com.apple.mobileslideshow,119,1734108714,1734108833,1734108834,-21600,iPhone
com.apple.MobileSMS,3,1734108710,1734108713,1734108713,-21600,iPhone
com.tencent.xin,97,1734108612,1734108709,1734108709,-21600,iPhone
com.apple.camera,91,1734108613,1734108704,1734108705,-21600,iPhone
com.tencent.xin,37,1734108504,1734108541,1734108542,-21600,iPhone
com.apple.camera,36,1734108505,1734108541,1734108542,-21600,iPhone
com.tencent.xin,27,1734108333,1734108360,1734108361,-21600,iPhone
com.microsoft.Office.Outlook,20,1734108313,1734108333,1734108334,-21600,iPhone
com.tencent.xin,1,1734108312,1734108313,1734108314,-21600,iPhone
com.apple.MobileSMS,9,1734108303,1734108312,1734108312,-21600,iPhone
com.apple.mobiletimer,5,1734108296,1734108301,1734108302,-21600,iPhone
com.apple.mobiletimer,7,1734085182,1734085189,1734085190,-21600,iPhone
com.google.Chrome,2054,1734083103,1734085157,1734085157,-21600,MacBook
com.apple.finder,1,1734083102,1734083103,1734083104,-21600,MacBook
com.apple.Dictionary,2,1734083100,1734083102,1734083103,-21600,MacBook
com.google.Chrome,252,1734082848,1734083100,1734083101,-21600,MacBook
com.google.Chrome,17,1734082780,1734082797,1734082798,-21600,MacBook
com.google.Chrome,306,1734082123,1734082429,1734082430,-21600,MacBook
com.amazon.Amazon,97,1734082307,1734082404,1734082405,-21600,iPhone
com.amazon.Amazon,170,1734082136,1734082306,1734082307,-21600,iPhone
com.apple.CoreAuthUI,2,1734082139,1734082141,1734082142,-21600,iPhone
com.xingin.discover,3,1734082045,1734082048,1734082048,-21600,iPhone
com.xingin.discover,2076,1734079571,1734081647,1734081647,-21600,iPhone
com.google.Chrome,461,1734079235,1734079696,1734079697,-21600,MacBook
com.netease.cloudmusic,1,1734079568,1734079569,1734079570,-21600,iPhone
com.netease.cloudmusic,5,1734079345,1734079350,1734079350,-21600,iPhone
com.google.Chrome,433,1734078495,1734078928,1734078929,-21600,MacBook
com.netease.cloudmusic,6,1734078615,1734078621,1734078621,-21600,iPhone
com.google.Chrome,317,1734078097,1734078414,1734078415,-21600,MacBook
com.apple.finder,0,1734078097,1734078097,1734078098,-21600,MacBook
com.apple.Dictionary,2,1734078095,1734078097,1734078097,-21600,MacBook
com.google.Chrome,2230,1734075865,1734078095,1734078095,-21600,MacBook
com.apple.finder,1,1734075854,1734075855,1734075855,-21600,MacBook
com.apple.Notes,0,1734075854,1734075854,1734075855,-21600,MacBook
com.apple.finder,1,1734075853,1734075854,1734075854,-21600,MacBook
com.apple.Notes,1,1734075852,1734075853,1734075853,-21600,MacBook
com.apple.finder,2,1734075850,1734075852,1734075852,-21600,MacBook
com.apple.Notes,2,1734075848,1734075850,1734075850,-21600,MacBook
com.apple.finder,1,1734075847,1734075848,1734075849,-21600,MacBook
com.apple.Notes,0,1734075847,1734075847,1734075848,-21600,MacBook
com.apple.finder,1,1734075846,1734075847,1734075847,-21600,MacBook
com.apple.Notes,2,1734075844,1734075846,1734075846,-21600,MacBook
com.apple.finder,1,1734075843,1734075844,1734075845,-21600,MacBook
com.apple.Notes,1,1734075842,1734075843,1734075844,-21600,MacBook
com.apple.finder,1,1734075841,1734075842,1734075842,-21600,MacBook
com.apple.Notes,1,1734075840,1734075841,1734075842,-21600,MacBook
com.apple.finder,1,1734075839,1734075840,1734075841,-21600,MacBook
com.apple.Notes,14,1734075825,1734075839,1734075840,-21600,MacBook
com.apple.finder,1,1734075824,1734075825,1734075826,-21600,MacBook
com.apple.Notes,1,1734075823,1734075824,1734075825,-21600,MacBook
com.apple.finder,1,1734075822,1734075823,1734075823,-21600,MacBook
com.apple.Notes,2,1734075820,1734075822,1734075823,-21600,MacBook
com.apple.finder,1,1734075819,1734075820,1734075820,-21600,MacBook
com.apple.Notes,0,1734075819,1734075819,1734075820,-21600,MacBook
com.apple.finder,1,1734075818,1734075819,1734075819,-21600,MacBook
com.apple.Notes,2,1734075816,1734075818,1734075818,-21600,MacBook
com.apple.finder,3,1734075813,1734075816,1734075817,-21600,MacBook
com.apple.Notes,0,1734075813,1734075813,1734075814,-21600,MacBook
com.apple.finder,1,1734075812,1734075813,1734075813,-21600,MacBook
com.apple.Notes,1,1734075811,1734075812,1734075813,-21600,MacBook
com.apple.finder,1,1734075810,1734075811,1734075812,-21600,MacBook
com.apple.Notes,87,1734075723,1734075810,1734075811,-21600,MacBook
com.apple.finder,1,1734075722,1734075723,1734075723,-21600,MacBook
com.apple.Notes,0,1734075722,1734075722,1734075723,-21600,MacBook
com.apple.finder,1,1734075721,1734075722,1734075722,-21600,MacBook
com.apple.Notes,2,1734075719,1734075721,1734075722,-21600,MacBook
com.apple.finder,1,1734075718,1734075719,1734075719,-21600,MacBook
com.apple.Notes,1,1734075717,1734075718,1734075719,-21600,MacBook
com.apple.finder,0,1734075717,1734075717,1734075718,-21600,MacBook
com.apple.Notes,1,1734075716,1734075717,1734075717,-21600,MacBook
com.apple.finder,0,1734075716,1734075716,1734075717,-21600,MacBook
com.apple.Notes,4,1734075712,1734075716,1734075716,-21600,MacBook
com.apple.finder,1,1734075711,1734075712,1734075712,-21600,MacBook
com.apple.Notes,279,1734075432,1734075711,1734075711,-21600,MacBook
com.apple.finder,1,1734075431,1734075432,1734075432,-21600,MacBook
com.apple.Notes,227,1734075204,1734075431,1734075432,-21600,MacBook
com.google.Chrome,1,1734075203,1734075204,1734075205,-21600,MacBook
com.apple.Notes,1,1734075202,1734075203,1734075203,-21600,MacBook
com.microsoft.VSCode,6,1734075196,1734075202,1734075202,-21600,MacBook
com.apple.Notes,6,1734075190,1734075196,1734075197,-21600,MacBook
com.adobe.Photoshop,3,1734075187,1734075190,1734075191,-21600,MacBook
com.apple.Notes,5,1734075182,1734075187,1734075188,-21600,MacBook
com.apple.finder,1,1734075181,1734075182,1734075182,-21600,MacBook
com.apple.Notes,4,1734075177,1734075181,1734075182,-21600,MacBook
com.apple.finder,0,1734075177,1734075177,1734075178,-21600,MacBook
com.apple.Notes,81,1734075096,1734075177,1734075177,-21600,MacBook
com.tencent.xinWeChat,3,1734075093,1734075096,1734075096,-21600,MacBook
com.apple.finder,9,1734075084,1734075093,1734075094,-21600,MacBook
com.apple.Preview,14,1734075070,1734075084,1734075084,-21600,MacBook
com.apple.finder,3,1734075067,1734075070,1734075071,-21600,MacBook
com.tencent.xinWeChat,1,1734075066,1734075067,1734075067,-21600,MacBook
com.google.Chrome,1,1734075065,1734075066,1734075066,-21600,MacBook
com.tencent.xinWeChat,18,1734075047,1734075065,1734075065,-21600,MacBook
com.tencent.xin,7,1734075051,1734075058,1734075059,-21600,iPhone
com.apple.Notes,53,1734074994,1734075047,1734075048,-21600,MacBook
com.tencent.xinWeChat,2,1734074992,1734074994,1734074995,-21600,MacBook
com.apple.Notes,11,1734074981,1734074992,1734074993,-21600,MacBook
com.google.Chrome,38,1734074943,1734074981,1734074982,-21600,MacBook
com.bilibili.bilicomic,7,1734074809,1734074816,1734074817,-21600,iPhone
com.bilibili.bilicomic,2,1734074805,1734074807,1734074807,-21600,iPhone
com.tencent.xin,114,1734074690,1734074804,1734074804,-21600,iPhone
com.microsoft.Office.Outlook,13,1734074677,1734074690,1734074690,-21600,iPhone
com.apple.MobileSMS,3,1734074674,1734074677,1734074678,-21600,iPhone
com.microsoft.Office.Outlook,1,1734074672,1734074673,1734074674,-21600,iPhone
com.tencent.xin,784,1734073887,1734074671,1734074672,-21600,iPhone
com.differentsocial.Weee,82,1734073804,1734073886,1734073887,-21600,iPhone
com.xingin.discover,20,1734073782,1734073802,1734073803,-21600,iPhone
com.tencent.xin,1,1734073781,1734073782,1734073783,-21600,iPhone
com.xingin.discover,1520,1734072261,1734073781,1734073782,-21600,iPhone
com.differentsocial.Weee,119,1734072142,1734072261,1734072261,-21600,iPhone
com.differentsocial.Weee,46,1734072092,1734072138,1734072138,-21600,iPhone
com.bilibili.bilicomic,103,1734071980,1734072083,1734072084,-21600,iPhone
com.bilibili.bilicomic,43,1734071924,1734071967,1734071968,-21600,iPhone
com.netease.cloudmusic,2,1734071917,1734071919,1734071920,-21600,iPhone
com.google.Chrome,2579,1734069337,1734071916,1734071916,-21600,MacBook
com.netease.cloudmusic,3,1734067892,1734067895,1734067895,-21600,iPhone
com.apple.Preferences,7,1734067884,1734067891,1734067891,-21600,iPhone
com.apple.Preferences,7,1734067870,1734067877,1734067878,-21600,iPhone
com.tinyspeck.chatlyio,3,1734067866,1734067869,1734067870,-21600,iPhone
com.tinyspeck.chatlyio,38,1734067802,1734067840,1734067841,-21600,iPhone
com.apple.Notes,29,1734066667,1734066696,1734066696,-21600,MacBook
com.microsoft.Outlook,1,1734066666,1734066667,1734066667,-21600,MacBook
com.apple.Notes,1,1734066665,1734066666,1734066667,-21600,MacBook
com.google.Chrome,1,1734066664,1734066665,1734066665,-21600,MacBook
com.apple.Notes,1,1734066663,1734066664,1734066664,-21600,MacBook
com.google.Chrome,22,1734066641,1734066663,1734066664,-21600,MacBook
com.apple.Notes,1,1734066640,1734066641,1734066641,-21600,MacBook
com.google.Chrome,212,1734066428,1734066640,1734066640,-21600,MacBook
com.apple.Notes,27,1734066401,1734066428,1734066429,-21600,MacBook
com.apple.Notes,300,1734065944,1734066244,1734066244,-21600,MacBook
com.google.Chrome,11,1734065933,1734065944,1734065945,-21600,MacBook
com.apple.Notes,79,1734065854,1734065933,1734065934,-21600,MacBook
com.microsoft.Outlook,3,1734065851,1734065854,1734065855,-21600,MacBook
com.google.Chrome,3,1734065848,1734065851,1734065852,-21600,MacBook
com.microsoft.Outlook,22,1734065826,1734065848,1734065849,-21600,MacBook
com.apple.finder,20,1734065806,1734065826,1734065826,-21600,MacBook
com.microsoft.VSCode,13,1734065793,1734065806,1734065807,-21600,MacBook
com.google.Chrome,5,1734065788,1734065793,1734065794,-21600,MacBook
com.google.Chrome,302,1734065269,1734065571,1734065572,-21600,MacBook
com.microsoft.VSCode,1,1734065268,1734065269,1734065270,-21600,MacBook
com.google.Chrome,8,1734065260,1734065268,1734065269,-21600,MacBook
com.microsoft.VSCode,1,1734065259,1734065260,1734065260,-21600,MacBook
com.google.Chrome,159,1734065100,1734065259,1734065259,-21600,MacBook
com.microsoft.VSCode,1,1734065099,1734065100,1734065101,-21600,MacBook
com.google.Chrome,42,1734065057,1734065099,1734065100,-21600,MacBook
com.microsoft.VSCode,11,1734065046,1734065057,1734065058,-21600,MacBook
com.microsoft.Excel,371,1734064675,1734065046,1734065046,-21600,MacBook
com.google.Chrome,1,1734064674,1734064675,1734064676,-21600,MacBook
com.microsoft.Excel,5,1734064669,1734064674,1734064674,-21600,MacBook
com.google.Chrome,4,1734064665,1734064669,1734064669,-21600,MacBook
com.microsoft.Excel,16,1734064649,1734064665,1734064665,-21600,MacBook
com.google.Chrome,4,1734064645,1734064649,1734064649,-21600,MacBook
com.microsoft.Excel,21,1734064624,1734064645,1734064645,-21600,MacBook
com.microsoft.VSCode,0,1734064624,1734064624,1734064625,-21600,MacBook
com.google.Chrome,87,1734064537,1734064624,1734064624,-21600,MacBook
com.microsoft.VSCode,16,1734064521,1734064537,1734064538,-21600,MacBook
com.google.Chrome,12,1734064509,1734064521,1734064521,-21600,MacBook
com.microsoft.Excel,24,1734064485,1734064509,1734064509,-21600,MacBook
com.google.Chrome,13,1734064472,1734064485,1734064486,-21600,MacBook
com.microsoft.Outlook,1,1734064471,1734064472,1734064473,-21600,MacBook
net.sourceforge.sqlitebrowser,2,1734064469,1734064471,1734064471,-21600,MacBook
com.google.Chrome,6,1734064463,1734064469,1734064470,-21600,MacBook
net.sourceforge.sqlitebrowser,1,1734064462,1734064463,1734064464,-21600,MacBook
com.microsoft.Excel,2,1734064460,1734064462,1734064463,-21600,MacBook
net.sourceforge.sqlitebrowser,1,1734064459,1734064460,1734064461,-21600,MacBook
com.google.Chrome,9,1734064450,1734064459,1734064460,-21600,MacBook
net.sourceforge.sqlitebrowser,1,1734064449,1734064450,1734064450,-21600,MacBook
com.microsoft.Excel,130,1734064319,1734064449,1734064450,-21600,MacBook
net.sourceforge.sqlitebrowser,0,1734064319,1734064319,1734064320,-21600,MacBook
com.google.Chrome,104,1734064215,1734064319,1734064319,-21600,MacBook
net.sourceforge.sqlitebrowser,0,1734064215,1734064215,1734064216,-21600,MacBook
com.microsoft.Excel,22,1734064193,1734064215,1734064215,-21600,MacBook
com.apple.finder,1,1734064192,1734064193,1734064194,-21600,MacBook
com.apple.TextEdit,2,1734064190,1734064192,1734064193,-21600,MacBook
com.apple.finder,12,1734064178,1734064190,1734064191,-21600,MacBook
com.microsoft.VSCode,2,1734064176,1734064178,1734064179,-21600,MacBook
com.apple.finder,0,1734064176,1734064176,1734064176,-21600,MacBook
com.google.Chrome,19,1734064157,1734064176,1734064176,-21600,MacBook
com.apple.finder,1,1734064156,1734064157,1734064157,-21600,MacBook
com.microsoft.VSCode,17,1734064139,1734064156,1734064156,-21600,MacBook
com.apple.finder,2,1734064137,1734064139,1734064140,-21600,MacBook
net.sourceforge.sqlitebrowser,1,1734064136,1734064137,1734064138,-21600,MacBook
com.apple.finder,4,1734064132,1734064136,1734064137,-21600,MacBook
com.microsoft.VSCode,25,1734064107,1734064132,1734064133,-21600,MacBook
com.google.Chrome,38,1734064069,1734064107,1734064108,-21600,MacBook
com.microsoft.VSCode,35,1734064034,1734064069,1734064070,-21600,MacBook
com.google.Chrome,10,1734064024,1734064034,1734064035,-21600,MacBook
com.microsoft.VSCode,33,1734063991,1734064024,1734064025,-21600,MacBook
com.google.Chrome,65,1734063926,1734063991,1734063992,-21600,MacBook
net.sourceforge.sqlitebrowser,3,1734063923,1734063926,1734063926,-21600,MacBook
com.microsoft.VSCode,4,1734063919,1734063923,1734063924,-21600,MacBook
com.apple.finder,0,1734063919,1734063919,1734063920,-21600,MacBook
com.microsoft.VSCode,34,1734063885,1734063919,1734063919,-21600,MacBook
com.apple.finder,62,1734063823,1734063885,1734063885,-21600,MacBook
com.google.Chrome,24,1734063799,1734063823,1734063823,-21600,MacBook
com.microsoft.VSCode,9,1734063790,1734063799,1734063800,-21600,MacBook
com.google.Chrome,17,1734063773,1734063790,1734063790,-21600,MacBook
com.microsoft.VSCode,24,1734063749,1734063773,1734063774,-21600,MacBook
com.google.Chrome,33,1734063716,1734063749,1734063751,-21600,MacBook
com.microsoft.VSCode,1,1734063715,1734063716,1734063716,-21600,MacBook
net.sourceforge.sqlitebrowser,3,1734063712,1734063715,1734063716,-21600,MacBook
com.google.Chrome,42,1734063670,1734063712,1734063713,-21600,MacBook
net.sourceforge.sqlitebrowser,1,1734063669,1734063670,1734063670,-21600,MacBook
com.microsoft.VSCode,111,1734063558,1734063669,1734063669,-21600,MacBook
com.google.Chrome,7,1734063551,1734063558,1734063559,-21600,MacBook
com.microsoft.VSCode,2,1734063549,1734063551,1734063551,-21600,MacBook
com.google.Chrome,1,1734063548,1734063549,1734063550,-21600,MacBook
net.sourceforge.sqlitebrowser,1,1734063547,1734063548,1734063548,-21600,MacBook
com.microsoft.VSCode,36,1734063511,1734063547,1734063548,-21600,MacBook
com.google.Chrome,26,1734063485,1734063511,1734063511,-21600,MacBook
net.sourceforge.sqlitebrowser,1,1734063484,1734063485,1734063485,-21600,MacBook
com.microsoft.VSCode,3,1734063481,1734063484,1734063485,-21600,MacBook
com.apple.finder,0,1734063481,1734063481,1734063482,-21600,MacBook
net.sourceforge.sqlitebrowser,3,1734063478,1734063481,1734063481,-21600,MacBook
com.google.Chrome,77,1734063401,1734063478,1734063478,-21600,MacBook
net.sourceforge.sqlitebrowser,42,1734063359,1734063401,1734063402,-21600,MacBook
com.google.Chrome,21,1734063338,1734063359,1734063359,-21600,MacBook
net.sourceforge.sqlitebrowser,2,1734063336,1734063338,1734063339,-21600,MacBook
com.google.Chrome,22,1734063314,1734063336,1734063336,-21600,MacBook
net.sourceforge.sqlitebrowser,92,1734063222,1734063314,1734063314,-21600,MacBook
com.apple.finder,1,1734063221,1734063222,1734063223,-21600,MacBook
net.sourceforge.sqlitebrowser,1,1734063220,1734063221,1734063222,-21600,MacBook
com.apple.finder,4,1734063216,1734063220,1734063220,-21600,MacBook
net.sourceforge.sqlitebrowser,3,1734063213,1734063216,1734063217,-21600,MacBook
com.apple.finder,1,1734063212,1734063213,1734063213,-21600,MacBook
net.sourceforge.sqlitebrowser,2,1734063210,1734063212,1734063212,-21600,MacBook
com.apple.finder,0,1734063210,1734063210,1734063211,-21600,MacBook
com.microsoft.VSCode,8,1734063200,1734063208,1734063209,-21600,MacBook
com.google.Chrome,9,1734063191,1734063200,1734063201,-21600,MacBook
com.microsoft.VSCode,2,1734063189,1734063191,1734063191,-21600,MacBook
com.adobe.Photoshop,1,1734063188,1734063189,1734063190,-21600,MacBook
com.apple.finder,3,1734063185,1734063188,1734063188,-21600,MacBook
com.apple.TextEdit,2,1734063183,1734063185,1734063185,-21600,MacBook
com.apple.finder,1,1734063182,1734063183,1734063183,-21600,MacBook
com.apple.TextEdit,3,1734063179,1734063182,1734063183,-21600,MacBook
com.apple.finder,1,1734063178,1734063179,1734063179,-21600,MacBook
com.google.Chrome,5,1734063173,1734063178,1734063178,-21600,MacBook
com.apple.finder,0,1734063173,1734063173,1734063174,-21600,MacBook
com.apple.TextEdit,4,1734063169,1734063173,1734063173,-21600,MacBook
com.apple.finder,2,1734063167,1734063169,1734063169,-21600,MacBook
com.apple.TextEdit,15,1734063152,1734063167,1734063168,-21600,MacBook
com.apple.finder,0,1734063152,1734063152,1734063153,-21600,MacBook
com.microsoft.Excel,4,1734063148,1734063152,1734063152,-21600,MacBook
com.apple.finder,2,1734063146,1734063148,1734063148,-21600,MacBook
com.google.Chrome,21,1734063125,1734063146,1734063147,-21600,MacBook
com.apple.finder,0,1734063125,1734063125,1734063125,-21600,MacBook
com.apple.TextEdit,3,1734063122,1734063125,1734063125,-21600,MacBook
com.apple.finder,1,1734063121,1734063122,1734063122,-21600,MacBook
com.apple.TextEdit,27,1734063094,1734063121,1734063122,-21600,MacBook
com.apple.finder,1,1734063093,1734063094,1734063095,-21600,MacBook
com.apple.TextEdit,12,1734063081,1734063093,1734063093,-21600,MacBook
com.apple.finder,4,1734063077,1734063081,1734063082,-21600,MacBook
com.google.Chrome,6,1734063071,1734063077,1734063077,-21600,MacBook
com.apple.finder,0,1734063071,1734063071,1734063072,-21600,MacBook
com.google.Chrome,5,1734063066,1734063071,1734063071,-21600,MacBook
com.apple.finder,1,1734063065,1734063066,1734063067,-21600,MacBook
com.google.Chrome,9,1734063056,1734063065,1734063066,-21600,MacBook
com.apple.finder,1,1734063055,1734063056,1734063056,-21600,MacBook
com.google.Chrome,3,1734063052,1734063055,1734063056,-21600,MacBook
com.apple.finder,1,1734063051,1734063052,1734063053,-21600,MacBook
com.google.Chrome,4,1734063047,1734063051,1734063052,-21600,MacBook
com.apple.finder,16,1734063031,1734063047,1734063048,-21600,MacBook
com.apple.archiveutility,1,1734063030,1734063031,1734063032,-21600,MacBook
com.apple.finder,49,1734062981,1734063030,1734063031,-21600,MacBook
com.adobe.Photoshop,1,1734062980,1734062981,1734062981,-21600,MacBook
com.apple.finder,0,1734062980,1734062980,1734062981,-21600,MacBook
com.apple.Preview,7,1734062973,1734062980,1734062980,-21600,MacBook
com.apple.finder,1,1734062972,1734062973,1734062973,-21600,MacBook
com.adobe.Photoshop,0,1734062972,1734062972,1734062973,-21600,MacBook
com.apple.finder,22,1734062950,1734062972,1734062973,-21600,MacBook
com.google.Chrome,1,1734062949,1734062950,1734062951,-21600,MacBook
com.microsoft.VSCode,1,1734062948,1734062949,1734062949,-21600,MacBook
com.google.Chrome,32,1734062916,1734062948,1734062948,-21600,MacBook
com.microsoft.VSCode,52,1734062864,1734062916,1734062916,-21600,MacBook
com.apple.finder,11,1734062853,1734062864,1734062865,-21600,MacBook
com.microsoft.Excel,7,1734062846,1734062853,1734062854,-21600,MacBook
com.apple.finder,2,1734062844,1734062846,1734062846,-21600,MacBook
com.microsoft.Excel,9,1734062835,1734062844,1734062845,-21600,MacBook
com.apple.finder,21,1734062814,1734062835,1734062836,-21600,MacBook
com.google.Chrome,28,1734062786,1734062814,1734062815,-21600,MacBook
com.apple.finder,12,1734062774,1734062786,1734062786,-21600,MacBook
com.google.Chrome,2,1734062772,1734062774,1734062775,-21600,MacBook
com.apple.finder,3,1734062769,1734062772,1734062773,-21600,MacBook
com.google.Chrome,17,1734062752,1734062769,1734062770,-21600,MacBook
com.apple.finder,3,1734062749,1734062752,1734062752,-21600,MacBook
com.google.Chrome,43,1734062706,1734062749,1734062749,-21600,MacBook
com.apple.finder,8,1734062698,1734062706,1734062707,-21600,MacBook
com.google.Chrome,20,1734062678,1734062698,1734062699,-21600,MacBook
com.apple.finder,3,1734062675,1734062678,1734062679,-21600,MacBook
com.google.Chrome,12,1734062663,1734062675,1734062675,-21600,MacBook
com.apple.finder,75,1734062588,1734062663,1734062664,-21600,MacBook
com.google.Chrome,7,1734062581,1734062588,1734062589,-21600,MacBook
com.apple.finder,2,1734062579,1734062581,1734062582,-21600,MacBook
com.google.Chrome,3,1734062576,1734062579,1734062579,-21600,MacBook
com.apple.finder,3,1734062573,1734062576,1734062577,-21600,MacBook
com.google.Chrome,1,1734062572,1734062573,1734062574,-21600,MacBook
com.apple.finder,6,1734062566,1734062572,1734062572,-21600,MacBook
com.google.Chrome,9,1734062557,1734062566,1734062567,-21600,MacBook
com.apple.finder,25,1734062532,1734062557,1734062558,-21600,MacBook
com.microsoft.Excel,2,1734062530,1734062532,1734062533,-21600,MacBook
com.google.Chrome,47,1734062483,1734062530,1734062531,-21600,MacBook
com.microsoft.Excel,101,1734062382,1734062483,1734062483,-21600,MacBook
com.google.Chrome,7,1734062375,1734062382,1734062383,-21600,MacBook
com.microsoft.Excel,238,1734062137,1734062375,1734062376,-21600,MacBook
com.google.Chrome,24,1734062113,1734062137,1734062138,-21600,MacBook
com.microsoft.Excel,4,1734062109,1734062113,1734062113,-21600,MacBook
com.apple.finder,1,1734062108,1734062109,1734062110,-21600,MacBook
com.google.Chrome,81,1734062027,1734062108,1734062108,-21600,MacBook
com.apple.finder,2,1734062025,1734062027,1734062028,-21600,MacBook
com.apple.systempreferences,0,1734062025,1734062025,1734062026,-21600,MacBook
com.google.Chrome,2,1734062023,1734062025,1734062025,-21600,MacBook
com.apple.systempreferences,42,1734061981,1734062023,1734062024,-21600,MacBook
com.google.Chrome,0,1734061981,1734061981,1734061982,-21600,MacBook
com.apple.finder,1,1734061980,1734061981,1734061982,-21600,MacBook
com.google.Chrome,135,1734061845,1734061980,1734061981,-21600,MacBook
com.apple.finder,2,1734061843,1734061845,1734061846,-21600,MacBook
com.apple.Notes,82,1734061761,1734061843,1734061843,-21600,MacBook
com.apple.systempreferences,3,1734061756,1734061759,1734061760,-21600,MacBook
com.apple.Preferences,2,1734061661,1734061663,1734061664,-21600,iPhone
com.apple.systempreferences,258,1734061401,1734061659,1734061660,-21600,MacBook
com.apple.finder,5,1734061387,1734061392,1734061392,-21600,MacBook
com.microsoft.Excel,5,1734061382,1734061387,1734061387,-21600,MacBook
com.apple.Terminal,6,1734061376,1734061382,1734061382,-21600,MacBook
com.google.Chrome,1064,1734060312,1734061376,1734061376,-21600,MacBook
com.apple.Preferences,276,1734061095,1734061371,1734061372,-21600,iPhone
com.apple.Preferences,85,1734060985,1734061070,1734061070,-21600,iPhone
com.apple.Preferences,89,1734060890,1734060979,1734060980,-21600,iPhone
com.google.chrome.ios,28,1734060862,1734060890,1734060891,-21600,iPhone
com.apple.Preferences,15,1734060847,1734060862,1734060863,-21600,iPhone
com.apple.VoiceMemos,13,1734060833,1734060846,1734060847,-21600,iPhone
com.apple.VoiceMemos,2,1734060827,1734060829,1734060830,-21600,iPhone
com.apple.Preferences,120,1734060705,1734060825,1734060826,-21600,iPhone
com.apple.Preferences,113,1734060590,1734060703,1734060704,-21600,iPhone
com.apple.Preferences,9,1734060532,1734060541,1734060542,-21600,iPhone
com.microsoft.Outlook,27,1734060256,1734060283,1734060284,-21600,MacBook
com.microsoft.Excel,66,1734060190,1734060256,1734060256,-21600,MacBook
com.google.Chrome,5,1734060185,1734060190,1734060191,-21600,MacBook
com.microsoft.Excel,64,1734060121,1734060185,1734060186,-21600,MacBook
com.google.Chrome,29,1734060092,1734060121,1734060122,-21600,MacBook
com.microsoft.Excel,69,1734060023,1734060092,1734060092,-21600,MacBook
com.google.Chrome,52,1734059971,1734060023,1734060023,-21600,MacBook
com.microsoft.Excel,17,1734059954,1734059971,1734059971,-21600,MacBook
com.google.Chrome,6,1734059948,1734059954,1734059954,-21600,MacBook
com.microsoft.Excel,86,1734059862,1734059948,1734059949,-21600,MacBook
com.google.Chrome,13,1734059849,1734059862,1734059862,-21600,MacBook
com.microsoft.Excel,131,1734059718,1734059849,1734059849,-21600,MacBook
com.google.Chrome,17,1734059701,1734059718,1734059719,-21600,MacBook
com.microsoft.Excel,8,1734059693,1734059701,1734059702,-21600,MacBook
com.microsoft.VSCode,3,1734059690,1734059693,1734059694,-21600,MacBook
com.google.Chrome,1,1734059689,1734059690,1734059691,-21600,MacBook
com.microsoft.VSCode,2,1734059687,1734059689,1734059689,-21600,MacBook
com.microsoft.Excel,4,1734059683,1734059687,1734059688,-21600,MacBook
com.microsoft.VSCode,0,1734059683,1734059683,1734059684,-21600,MacBook
com.google.Chrome,26,1734059657,1734059683,1734059683,-21600,MacBook
com.microsoft.VSCode,1,1734059656,1734059657,1734059657,-21600,MacBook
com.microsoft.Excel,52,1734059604,1734059656,1734059656,-21600,MacBook
com.google.Chrome,5,1734059599,1734059604,1734059604,-21600,MacBook
com.microsoft.VSCode,0,1734059599,1734059599,1734059600,-21600,MacBook
com.google.Chrome,9,1734059590,1734059599,1734059599,-21600,MacBook
com.microsoft.VSCode,1,1734059589,1734059590,1734059590,-21600,MacBook
com.google.Chrome,27,1734059562,1734059589,1734059589,-21600,MacBook
com.microsoft.VSCode,1,1734059561,1734059562,1734059562,-21600,MacBook
com.microsoft.Excel,43,1734059518,1734059561,1734059561,-21600,MacBook
com.google.Chrome,4,1734059514,1734059518,1734059519,-21600,MacBook
com.microsoft.VSCode,1,1734059513,1734059514,1734059515,-21600,MacBook
com.google.Chrome,338,1734059175,1734059513,1734059514,-21600,MacBook
com.microsoft.VSCode,1,1734059174,1734059175,1734059176,-21600,MacBook
com.microsoft.Excel,130,1734059044,1734059174,1734059175,-21600,MacBook
com.microsoft.VSCode,1,1734059043,1734059044,1734059044,-21600,MacBook
com.google.Chrome,17,1734059026,1734059043,1734059043,-21600,MacBook
com.microsoft.VSCode,1,1734059025,1734059026,1734059026,-21600,MacBook
com.microsoft.Excel,85,1734058940,1734059025,1734059026,-21600,MacBook
com.apple.finder,1,1734058939,1734058940,1734058940,-21600,MacBook
com.microsoft.VSCode,3,1734058936,1734058939,1734058939,-21600,MacBook
com.google.Chrome,55,1734058881,1734058936,1734058937,-21600,MacBook
com.microsoft.VSCode,1,1734058880,1734058881,1734058882,-21600,MacBook
com.apple.finder,1,1734058879,1734058880,1734058881,-21600,MacBook
com.microsoft.Excel,0,1734058879,1734058879,1734058880,-21600,MacBook
com.apple.finder,14,1734058865,1734058879,1734058879,-21600,MacBook
com.apple.Terminal,1,1734058864,1734058865,1734058865,-21600,MacBook
com.apple.finder,1,1734058863,1734058864,1734058865,-21600,MacBook
com.microsoft.Excel,4,1734058859,1734058863,1734058864,-21600,MacBook
com.apple.finder,1,1734058858,1734058859,1734058860,-21600,MacBook
com.google.Chrome,43,1734058815,1734058858,1734058859,-21600,MacBook
com.microsoft.VSCode,103,1734058712,1734058815,1734058815,-21600,MacBook
com.google.Chrome,43,1734058669,1734058712,1734058713,-21600,MacBook
com.microsoft.VSCode,74,1734058595,1734058669,1734058669,-21600,MacBook
com.google.Chrome,30,1734058565,1734058595,1734058596,-21600,MacBook
com.microsoft.VSCode,15,1734058550,1734058565,1734058565,-21600,MacBook
com.google.Chrome,4,1734058546,1734058550,1734058551,-21600,MacBook
com.microsoft.VSCode,23,1734058523,1734058546,1734058547,-21600,MacBook
com.microsoft.Excel,2,1734058521,1734058523,1734058523,-21600,MacBook
com.google.Chrome,116,1734058405,1734058521,1734058522,-21600,MacBook
com.microsoft.Outlook,2,1734058403,1734058405,1734058405,-21600,MacBook
com.google.Chrome,2,1734058401,1734058403,1734058404,-21600,MacBook
com.microsoft.Outlook,4,1734058397,1734058401,1734058401,-21600,MacBook
com.microsoft.Excel,4,1734058393,1734058397,1734058397,-21600,MacBook
com.microsoft.Outlook,1,1734058392,1734058393,1734058393,-21600,MacBook
com.google.Chrome,42,1734058350,1734058392,1734058393,-21600,MacBook
com.microsoft.VSCode,0,1734058350,1734058350,1734058351,-21600,MacBook
com.google.Chrome,9,1734058341,1734058350,1734058350,-21600,MacBook
com.microsoft.VSCode,1,1734058340,1734058341,1734058342,-21600,MacBook
com.google.Chrome,5,1734058335,1734058340,1734058340,-21600,MacBook
com.microsoft.Outlook,9,1734058326,1734058335,1734058335,-21600,MacBook
com.google.Chrome,2,1734058324,1734058326,1734058327,-21600,MacBook
com.microsoft.Outlook,8,1734058316,1734058324,1734058325,-21600,MacBook
com.microsoft.Excel,0,1734058316,1734058316,1734058316,-21600,MacBook
com.google.Chrome,135,1734058181,1734058316,1734058316,-21600,MacBook
com.microsoft.VSCode,1,1734058180,1734058181,1734058182,-21600,MacBook
com.microsoft.Excel,32,1734058148,1734058180,1734058181,-21600,MacBook
com.microsoft.VSCode,1,1734058147,1734058148,1734058149,-21600,MacBook
com.google.Chrome,15,1734058132,1734058147,1734058148,-21600,MacBook
com.microsoft.VSCode,122,1734058010,1734058132,1734058132,-21600,MacBook
com.microsoft.Excel,0,1734058010,1734058010,1734058010,-21600,MacBook
com.google.Chrome,52,1734057958,1734058010,1734058010,-21600,MacBook
com.microsoft.Excel,0,1734057958,1734057958,1734057959,-21600,MacBook
com.apple.finder,6,1734057952,1734057958,1734057959,-21600,MacBook
com.google.Chrome,19,1734057933,1734057952,1734057953,-21600,MacBook
com.apple.finder,1,1734057932,1734057933,1734057933,-21600,MacBook
com.microsoft.Excel,8,1734057924,1734057932,1734057932,-21600,MacBook
com.google.Chrome,6,1734057918,1734057924,1734057925,-21600,MacBook
com.microsoft.Excel,18,1734057900,1734057918,1734057918,-21600,MacBook
com.apple.finder,12,1734057888,1734057900,1734057901,-21600,MacBook
com.apple.Terminal,0,1734057888,1734057888,1734057889,-21600,MacBook
com.google.Chrome,59,1734057829,1734057888,1734057888,-21600,MacBook
com.apple.Terminal,2,1734057827,1734057829,1734057830,-21600,MacBook
com.google.Chrome,5,1734057822,1734057827,1734057828,-21600,MacBook
com.apple.Terminal,1,1734057821,1734057822,1734057823,-21600,MacBook
com.apple.finder,5,1734057816,1734057821,1734057822,-21600,MacBook
com.apple.TextEdit,2,1734057814,1734057816,1734057817,-21600,MacBook
com.apple.Terminal,13,1734057801,1734057814,1734057814,-21600,MacBook
com.apple.TextEdit,3,1734057798,1734057801,1734057801,-21600,MacBook
com.apple.finder,1,1734057797,1734057798,1734057798,-21600,MacBook
com.apple.TextEdit,0,1734057797,1734057797,1734057798,-21600,MacBook
com.apple.finder,5,1734057792,1734057797,1734057797,-21600,MacBook
com.apple.systempreferences,1,1734057791,1734057792,1734057792,-21600,MacBook
com.apple.finder,1,1734057790,1734057791,1734057791,-21600,MacBook
com.apple.TextEdit,4,1734057786,1734057790,1734057791,-21600,MacBook
com.apple.Terminal,17,1734057769,1734057786,1734057787,-21600,MacBook
com.microsoft.Outlook,0,1734057769,1734057769,1734057769,-21600,MacBook
com.google.Chrome,185,1734057584,1734057769,1734057769,-21600,MacBook
com.microsoft.Outlook,1,1734057583,1734057584,1734057584,-21600,MacBook
com.google.Chrome,3,1734057580,1734057583,1734057583,-21600,MacBook
com.apple.systempreferences,2,1734057578,1734057580,1734057581,-21600,MacBook
com.google.Chrome,26,1734057552,1734057578,1734057578,-21600,MacBook
com.apple.systempreferences,1,1734057551,1734057552,1734057553,-21600,MacBook
com.apple.finder,1,1734057550,1734057551,1734057551,-21600,MacBook
com.microsoft.VSCode,4,1734057546,1734057550,1734057551,-21600,MacBook
com.apple.finder,1,1734057545,1734057546,1734057546,-21600,MacBook
com.apple.TextEdit,4,1734057541,1734057545,1734057545,-21600,MacBook
com.apple.finder,4,1734057537,1734057541,1734057541,-21600,MacBook
com.apple.TextEdit,5,1734057532,1734057537,1734057537,-21600,MacBook
com.microsoft.Excel,86,1734057446,1734057532,1734057532,-21600,MacBook
com.apple.TextEdit,0,1734057446,1734057446,1734057447,-21600,MacBook
com.apple.finder,6,1734057440,1734057446,1734057446,-21600,MacBook
com.microsoft.Excel,0,1734057440,1734057440,1734057441,-21600,MacBook
com.apple.finder,1,1734057439,1734057440,1734057440,-21600,MacBook
com.microsoft.VSCode,6,1734057433,1734057439,1734057440,-21600,MacBook
com.apple.finder,19,1734057414,1734057433,1734057434,-21600,MacBook
com.apple.Terminal,1,1734057413,1734057414,1734057414,-21600,MacBook
com.apple.finder,1,1734057412,1734057413,1734057414,-21600,MacBook
com.apple.systempreferences,5,1734057407,1734057412,1734057413,-21600,MacBook
com.apple.Terminal,7,1734057400,1734057407,1734057407,-21600,MacBook
com.apple.systempreferences,11,1734057389,1734057400,1734057401,-21600,MacBook
com.google.Chrome,36,1734057353,1734057389,1734057390,-21600,MacBook
com.apple.systempreferences,19,1734057334,1734057353,1734057353,-21600,MacBook
com.google.Chrome,2,1734057332,1734057334,1734057334,-21600,MacBook
com.apple.systempreferences,9,1734057323,1734057332,1734057333,-21600,MacBook
com.google.Chrome,1,1734057322,1734057323,1734057324,-21600,MacBook
com.apple.systempreferences,1,1734057321,1734057322,1734057323,-21600,MacBook
com.google.Chrome,14,1734057307,1734057321,1734057322,-21600,MacBook
com.apple.systempreferences,1,1734057298,1734057299,1734057300,-21600,MacBook
com.microsoft.VSCode,2,1734057296,1734057298,1734057298,-21600,MacBook
com.google.Chrome,51,1734057245,1734057296,1734057297,-21600,MacBook
com.microsoft.VSCode,3,1734057242,1734057245,1734057246,-21600,MacBook
com.apple.Terminal,4,1734057238,1734057242,1734057242,-21600,MacBook
com.apple.finder,2,1734057236,1734057238,1734057238,-21600,MacBook
com.google.Chrome,68,1734057168,1734057236,1734057237,-21600,MacBook
com.apple.finder,3,1734057165,1734057168,1734057168,-21600,MacBook
com.apple.Terminal,3,1734057162,1734057165,1734057165,-21600,MacBook
com.microsoft.VSCode,2,1734057160,1734057162,1734057163,-21600,MacBook
com.apple.Terminal,3,1734057157,1734057160,1734057160,-21600,MacBook
com.microsoft.VSCode,4,1734057153,1734057157,1734057158,-21600,MacBook
com.apple.Terminal,12,1734057141,1734057153,1734057154,-21600,MacBook
com.microsoft.VSCode,4,1734057137,1734057141,1734057141,-21600,MacBook
com.google.Chrome,19,1734057118,1734057137,1734057137,-21600,MacBook
com.microsoft.VSCode,9,1734057109,1734057118,1734057119,-21600,MacBook
com.google.Chrome,33,1734057076,1734057109,1734057110,-21600,MacBook
com.microsoft.VSCode,46,1734057030,1734057076,1734057077,-21600,MacBook
com.apple.finder,1,1734057029,1734057030,1734057030,-21600,MacBook
com.google.Chrome,2,1734057027,1734057029,1734057029,-21600,MacBook
com.apple.finder,37,1734056990,1734057027,1734057028,-21600,MacBook
com.microsoft.VSCode,331,1734056659,1734056990,1734056991,-21600,MacBook
com.tencent.xin,5,1734056720,1734056725,1734056725,-21600,iPhone
com.apple.finder,1,1734056658,1734056659,1734056660,-21600,MacBook
com.microsoft.VSCode,0,1734056658,1734056658,1734056659,-21600,MacBook
com.apple.finder,11,1734056647,1734056658,1734056658,-21600,MacBook
com.google.Chrome,13,1734056634,1734056647,1734056648,-21600,MacBook
com.apple.finder,2,1734056632,1734056634,1734056635,-21600,MacBook
com.google.Chrome,102,1734056530,1734056632,1734056632,-21600,MacBook
com.apple.finder,8,1734056522,1734056530,1734056531,-21600,MacBook
com.apple.archiveutility,1,1734056521,1734056522,1734056522,-21600,MacBook
com.apple.finder,4,1734056517,1734056521,1734056522,-21600,MacBook
com.google.Chrome,21,1734056496,1734056517,1734056518,-21600,MacBook
com.apple.finder,2,1734056494,1734056496,1734056497,-21600,MacBook
com.google.Chrome,256,1734056238,1734056494,1734056495,-21600,MacBook
com.tencent.xin,44,1734056385,1734056429,1734056430,-21600,iPhone
com.tencent.xin,1,1734056383,1734056384,1734056385,-21600,iPhone
com.apple.Preferences,2,1734056381,1734056383,1734056384,-21600,iPhone
com.apple.ActivityMonitor,3,1734056235,1734056238,1734056239,-21600,MacBook
com.google.Chrome,217,1734056018,1734056235,1734056236,-21600,MacBook
com.apple.ActivityMonitor,43,1734055975,1734056018,1734056019,-21600,MacBook
com.google.Chrome,205,1734055770,1734055975,1734055976,-21600,MacBook
com.apple.finder,2,1734055768,1734055770,1734055770,-21600,MacBook
com.apple.systempreferences,7,1734055761,1734055768,1734055769,-21600,MacBook
com.apple.finder,1,1734055760,1734055761,1734055761,-21600,MacBook
com.apple.systempreferences,3,1734055757,1734055760,1734055760,-21600,MacBook
com.apple.finder,1,1734055750,1734055751,1734055752,-21600,MacBook
com.apple.systempreferences,4,1734055746,1734055750,1734055751,-21600,MacBook
com.google.Chrome,26,1734055720,1734055746,1734055747,-21600,MacBook
com.google.Chrome,541,1734055070,1734055611,1734055612,-21600,MacBook
com.apple.finder,18,1734055052,1734055070,1734055070,-21600,MacBook
com.apple.Notes,1,1734055051,1734055052,1734055053,-21600,MacBook
com.apple.finder,1,1734055050,1734055051,1734055051,-21600,MacBook
com.apple.Notes,0,1734055050,1734055050,1734055051,-21600,MacBook
com.apple.finder,1,1734055049,1734055050,1734055050,-21600,MacBook
com.apple.Notes,4,1734055045,1734055049,1734055049,-21600,MacBook
com.google.Chrome,29,1734055016,1734055045,1734055046,-21600,MacBook
com.apple.Notes,167,1734054849,1734055016,1734055017,-21600,MacBook
com.apple.finder,1,1734054848,1734054849,1734054849,-21600,MacBook
com.google.Chrome,1,1734054847,1734054848,1734054848,-21600,MacBook
com.apple.finder,1,1734054846,1734054847,1734054848,-21600,MacBook
com.google.Chrome,480,1734054366,1734054846,1734054847,-21600,MacBook
com.apple.finder,1,1734054365,1734054366,1734054367,-21600,MacBook
com.microsoft.Outlook,17,1734054348,1734054365,1734054365,-21600,MacBook
com.tinyspeck.slackmacgap,2,1734054346,1734054348,1734054349,-21600,MacBook
com.microsoft.Outlook,2,1734054344,1734054346,1734054347,-21600,MacBook
com.tinyspeck.slackmacgap,1,1734054343,1734054344,1734054344,-21600,MacBook
com.apple.finder,0,1734054343,1734054343,1734054344,-21600,MacBook
com.google.Chrome,6,1734054337,1734054343,1734054344,-21600,MacBook
com.google.Chrome,5577,1734039648,1734045225,1734045226,-21600,MacBook
com.apple.finder,1,1734039647,1734039648,1734039649,-21600,MacBook
com.microsoft.Outlook,13,1734039634,1734039647,1734039647,-21600,MacBook
com.apple.finder,1,1734039633,1734039634,1734039634,-21600,MacBook
com.microsoft.Outlook,12,1734039621,1734039633,1734039634,-21600,MacBook
com.apple.finder,1,1734039620,1734039621,1734039621,-21600,MacBook
com.microsoft.Outlook,1,1734039619,1734039620,1734039620,-21600,MacBook
com.apple.finder,0,1734039619,1734039619,1734039620,-21600,MacBook
com.microsoft.Outlook,2,1734039617,1734039619,1734039619,-21600,MacBook
com.apple.finder,1,1734039616,1734039617,1734039618,-21600,MacBook
com.microsoft.Outlook,33,1734039583,1734039616,1734039617,-21600,MacBook
com.google.Chrome,19,1734039564,1734039583,1734039584,-21600,MacBook
com.microsoft.Outlook,38,1734039526,1734039564,1734039564,-21600,MacBook
com.google.Chrome,3,1734039523,1734039526,1734039527,-21600,MacBook
com.microsoft.Outlook,34,1734039489,1734039523,1734039523,-21600,MacBook
com.google.Chrome,28,1734039461,1734039489,1734039490,-21600,MacBook
com.microsoft.Outlook,14,1734039447,1734039461,1734039462,-21600,MacBook
com.google.Chrome,34,1734039413,1734039447,1734039448,-21600,MacBook
com.microsoft.Outlook,17,1734039396,1734039413,1734039413,-21600,MacBook
com.google.Chrome,6,1734039390,1734039396,1734039397,-21600,MacBook
com.microsoft.Outlook,8,1734039382,1734039390,1734039390,-21600,MacBook
com.google.Chrome,2,1734039380,1734039382,1734039383,-21600,MacBook
com.microsoft.Outlook,6,1734039374,1734039380,1734039380,-21600,MacBook
com.google.Chrome,4,1734039370,1734039374,1734039375,-21600,MacBook
com.microsoft.Outlook,8,1734039362,1734039370,1734039370,-21600,MacBook
com.apple.Notes,2,1734039360,1734039362,1734039363,-21600,MacBook
com.microsoft.Outlook,5,1734039355,1734039360,1734039360,-21600,MacBook
com.apple.Notes,3,1734039352,1734039355,1734039355,-21600,MacBook
com.microsoft.Outlook,3,1734039349,1734039352,1734039353,-21600,MacBook
com.apple.Notes,3,1734039346,1734039349,1734039350,-21600,MacBook
com.microsoft.Outlook,8,1734039338,1734039346,1734039346,-21600,MacBook
com.google.Chrome,8,1734039330,1734039338,1734039339,-21600,MacBook
com.microsoft.Outlook,4,1734039326,1734039330,1734039331,-21600,MacBook
com.google.Chrome,3,1734039323,1734039326,1734039327,-21600,MacBook
com.microsoft.Outlook,4,1734039319,1734039323,1734039324,-21600,MacBook
com.google.Chrome,3,1734039316,1734039319,1734039319,-21600,MacBook
com.microsoft.Outlook,5,1734039311,1734039316,1734039317,-21600,MacBook
com.google.Chrome,5,1734039306,1734039311,1734039311,-21600,MacBook
com.microsoft.Outlook,10,1734039296,1734039306,1734039307,-21600,MacBook
com.google.Chrome,5,1734039291,1734039296,1734039296,-21600,MacBook
com.microsoft.Outlook,0,1734039291,1734039291,1734039292,-21600,MacBook
com.google.Chrome,9,1734039282,1734039291,1734039291,-21600,MacBook
com.microsoft.Outlook,5,1734039277,1734039282,1734039283,-21600,MacBook
com.google.Chrome,1,1734039276,1734039277,1734039278,-21600,MacBook
com.microsoft.Outlook,43,1734039233,1734039276,1734039276,-21600,MacBook
com.google.Chrome,8,1734039225,1734039233,1734039233,-21600,MacBook
com.microsoft.Outlook,26,1734039199,1734039225,1734039226,-21600,MacBook
com.google.Chrome,155,1734039044,1734039199,1734039200,-21600,MacBook
com.microsoft.Outlook,20,1734039024,1734039044,1734039045,-21600,MacBook
com.tinyspeck.slackmacgap,0,1734039024,1734039024,1734039025,-21600,MacBook
com.google.Chrome,188,1734038836,1734039024,1734039025,-21600,MacBook
com.tinyspeck.slackmacgap,11,1734038825,1734038836,1734038837,-21600,MacBook
com.google.Chrome,2,1734038823,1734038825,1734038825,-21600,MacBook
com.tinyspeck.slackmacgap,18,1734038717,1734038735,1734038736,-21600,MacBook
com.google.Chrome,10,1734038707,1734038717,1734038718,-21600,MacBook
com.tinyspeck.slackmacgap,46,1734038661,1734038707,1734038708,-21600,MacBook
com.apple.Notes,0,1734038661,1734038661,1734038662,-21600,MacBook
com.google.Chrome,201,1734038460,1734038661,1734038662,-21600,MacBook
com.apple.Notes,18,1734038415,1734038433,1734038434,-21600,MacBook
com.google.Chrome,6,1734038409,1734038415,1734038416,-21600,MacBook
com.apple.Notes,21,1734038388,1734038409,1734038410,-21600,MacBook
com.microsoft.Outlook,0,1734038388,1734038388,1734038389,-21600,MacBook
com.google.Chrome,97,1734038291,1734038388,1734038388,-21600,MacBook
com.microsoft.Outlook,13,1734037917,1734037930,1734037930,-21600,MacBook
com.google.Chrome,93,1734037824,1734037917,1734037917,-21600,MacBook
com.microsoft.Outlook,7,1734037817,1734037824,1734037824,-21600,MacBook
com.google.Chrome,209,1734037608,1734037817,1734037818,-21600,MacBook
com.microsoft.Outlook,3,1734037162,1734037165,1734037165,-21600,MacBook
com.apple.finder,4,1734037158,1734037162,1734037163,-21600,MacBook
com.microsoft.Outlook,14,1734037144,1734037158,1734037159,-21600,MacBook
com.google.Chrome,6,1734037138,1734037144,1734037144,-21600,MacBook
com.microsoft.Outlook,4,1734037134,1734037138,1734037139,-21600,MacBook
com.google.Chrome,3,1734037131,1734037134,1734037135,-21600,MacBook
com.microsoft.Outlook,1,1734037130,1734037131,1734037132,-21600,MacBook
com.google.Chrome,7,1734037123,1734037130,1734037131,-21600,MacBook
com.microsoft.Outlook,149,1734036974,1734037123,1734037123,-21600,MacBook
com.google.Chrome,68,1734036906,1734036974,1734036974,-21600,MacBook
com.microsoft.Outlook,7,1734036899,1734036906,1734036907,-21600,MacBook
com.google.Chrome,15,1734036884,1734036899,1734036899,-21600,MacBook
com.microsoft.Outlook,36,1734036848,1734036884,1734036884,-21600,MacBook
com.google.Chrome,19,1734036829,1734036848,1734036848,-21600,MacBook
com.microsoft.Outlook,2,1734036827,1734036829,1734036829,-21600,MacBook
com.google.Chrome,45,1734036782,1734036827,1734036828,-21600,MacBook
com.microsoft.Outlook,4,1734036778,1734036782,1734036782,-21600,MacBook
com.google.Chrome,2,1734036776,1734036778,1734036778,-21600,MacBook
com.microsoft.Outlook,2,1734036774,1734036776,1734036776,-21600,MacBook
com.google.Chrome,36,1734036738,1734036774,1734036775,-21600,MacBook
com.microsoft.Outlook,12,1734036726,1734036738,1734036739,-21600,MacBook
com.apple.finder,1,1734036725,1734036726,1734036726,-21600,MacBook
com.microsoft.Outlook,7,1734036718,1734036725,1734036726,-21600,MacBook
com.apple.Preview,3,1734036715,1734036718,1734036719,-21600,MacBook
com.apple.finder,1,1734036714,1734036715,1734036715,-21600,MacBook
com.apple.Preview,1,1734036713,1734036714,1734036714,-21600,MacBook
com.apple.finder,0,1734036713,1734036713,1734036713,-21600,MacBook
com.microsoft.Outlook,13,1734036700,1734036713,1734036713,-21600,MacBook
com.apple.finder,1,1734036699,1734036700,1734036701,-21600,MacBook
com.apple.Preview,0,1734036699,1734036699,1734036700,-21600,MacBook
com.apple.finder,4,1734036682,1734036686,1734036686,-21600,MacBook
com.microsoft.Outlook,51,1734036631,1734036682,1734036682,-21600,MacBook
com.google.Chrome,53,1734036578,1734036631,1734036632,-21600,MacBook
com.microsoft.Outlook,22,1734036556,1734036578,1734036579,-21600,MacBook
com.apple.Preview,6,1734036550,1734036556,1734036556,-21600,MacBook
com.apple.finder,1,1734036549,1734036550,1734036551,-21600,MacBook
com.apple.Preview,5,1734036544,1734036549,1734036550,-21600,MacBook
com.apple.finder,0,1734036544,1734036544,1734036545,-21600,MacBook
com.microsoft.Outlook,10,1734036534,1734036544,1734036545,-21600,MacBook
com.apple.finder,0,1734036534,1734036534,1734036535,-21600,MacBook
com.apple.Preview,8,1734036526,1734036534,1734036534,-21600,MacBook
com.apple.Preview,15,1734036329,1734036344,1734036344,-21600,MacBook
com.apple.finder,1,1734036328,1734036329,1734036329,-21600,MacBook
com.apple.Preview,1,1734036327,1734036328,1734036329,-21600,MacBook
com.apple.finder,0,1734036327,1734036327,1734036327,-21600,MacBook
com.microsoft.Outlook,20,1734036307,1734036327,1734036327,-21600,MacBook
com.apple.Preview,7,1734036300,1734036307,1734036308,-21600,MacBook
com.apple.finder,1,1734036299,1734036300,1734036301,-21600,MacBook
com.apple.Preview,2,1734036297,1734036299,1734036300,-21600,MacBook
com.apple.finder,1,1734036296,1734036297,1734036297,-21600,MacBook
com.microsoft.Outlook,17,1734036279,1734036296,1734036296,-21600,MacBook
com.tinyspeck.slackmacgap,3,1734036276,1734036279,1734036280,-21600,MacBook
com.microsoft.Outlook,3,1734036273,1734036276,1734036276,-21600,MacBook
com.tinyspeck.slackmacgap,0,1734036273,1734036273,1734036274,-21600,MacBook
com.apple.finder,2,1734036271,1734036273,1734036274,-21600,MacBook
com.apple.finder,16,1734029258,1734029274,1734029275,-21600,MacBook
com.apple.finder,2,1734003614,1734003616,1734003616,-21600,MacBook
com.google.Chrome,1941,1734001673,1734003614,1734003615,-21600,MacBook
com.apple.Notes,13,1734001660,1734001673,1734001673,-21600,MacBook
com.google.Chrome,129,1734001531,1734001660,1734001661,-21600,MacBook
com.apple.Notes,39,1734001492,1734001531,1734001532,-21600,MacBook
com.google.Chrome,6,1734001486,1734001492,1734001492,-21600,MacBook
com.apple.Notes,18,1734001468,1734001486,1734001487,-21600,MacBook
com.google.Chrome,4,1734001464,1734001468,1734001468,-21600,MacBook
com.apple.Notes,7,1734001457,1734001464,1734001464,-21600,MacBook
com.google.Chrome,133,1734001324,1734001457,1734001458,-21600,MacBook
com.apple.Notes,6,1734001318,1734001324,1734001324,-21600,MacBook
com.google.Chrome,347,1734000971,1734001318,1734001319,-21600,MacBook
com.apple.Notes,34,1734000937,1734000971,1734000971,-21600,MacBook
com.google.Chrome,100,1734000837,1734000937,1734000938,-21600,MacBook
com.apple.Notes,19,1734000818,1734000837,1734000838,-21600,MacBook
com.google.Chrome,51,1734000767,1734000818,1734000818,-21600,MacBook
com.apple.Notes,3,1734000764,1734000767,1734000767,-21600,MacBook
com.google.Chrome,36,1734000728,1734000764,1734000765,-21600,MacBook
com.apple.Notes,5,1734000723,1734000728,1734000728,-21600,MacBook
com.google.Chrome,102,1734000621,1734000723,1734000723,-21600,MacBook
com.apple.Notes,3,1734000618,1734000621,1734000622,-21600,MacBook
com.google.Chrome,225,1734000393,1734000618,1734000619,-21600,MacBook
com.apple.Notes,25,1734000368,1734000393,1734000393,-21600,MacBook
com.google.Chrome,71,1734000297,1734000368,1734000368,-21600,MacBook
com.apple.Notes,2,1734000295,1734000297,1734000297,-21600,MacBook
com.google.Chrome,7,1734000288,1734000295,1734000296,-21600,MacBook
com.apple.Notes,4,1734000284,1734000288,1734000289,-21600,MacBook
com.google.Chrome,11,1734000273,1734000284,1734000285,-21600,MacBook
com.apple.Notes,2,1734000271,1734000273,1734000273,-21600,MacBook
com.google.Chrome,24,1734000247,1734000271,1734000271,-21600,MacBook
com.apple.Notes,36,1734000211,1734000247,1734000248,-21600,MacBook
com.google.Chrome,1,1734000210,1734000211,1734000212,-21600,MacBook
com.apple.Notes,152,1734000058,1734000210,1734000211,-21600,MacBook
com.google.Chrome,92,1733999966,1734000058,1734000059,-21600,MacBook
com.apple.Notes,28,1733999938,1733999966,1733999966,-21600,MacBook
com.google.Chrome,83,1733999855,1733999938,1733999938,-21600,MacBook
com.apple.Notes,80,1733999775,1733999855,1733999855,-21600,MacBook
com.google.Chrome,52,1733999723,1733999775,1733999775,-21600,MacBook
com.apple.Notes,3,1733999720,1733999723,1733999724,-21600,MacBook
com.google.Chrome,22,1733999698,1733999720,1733999720,-21600,MacBook
com.apple.Notes,80,1733999618,1733999698,1733999698,-21600,MacBook
com.google.Chrome,30,1733999588,1733999618,1733999619,-21600,MacBook
com.apple.Notes,25,1733999563,1733999588,1733999588,-21600,MacBook
com.google.Chrome,54,1733999509,1733999563,1733999563,-21600,MacBook
com.apple.Notes,3,1733999506,1733999509,1733999509,-21600,MacBook
notion.id,2,1733999504,1733999506,1733999506,-21600,MacBook
com.apple.Notes,20,1733999484,1733999504,1733999505,-21600,MacBook
com.google.Chrome,5,1733999479,1733999484,1733999485,-21600,MacBook
com.apple.Notes,42,1733999437,1733999479,1733999480,-21600,MacBook
com.google.Chrome,91,1733999346,1733999437,1733999438,-21600,MacBook
com.apple.Notes,52,1733999294,1733999346,1733999346,-21600,MacBook
com.google.Chrome,1,1733999293,1733999294,1733999295,-21600,MacBook
com.apple.Notes,42,1733999251,1733999293,1733999294,-21600,MacBook
com.google.Chrome,68,1733999183,1733999251,1733999252,-21600,MacBook
com.apple.Notes,157,1733999026,1733999183,1733999183,-21600,MacBook
com.google.Chrome,5,1733999021,1733999026,1733999026,-21600,MacBook
com.apple.Notes,62,1733998959,1733999021,1733999022,-21600,MacBook
com.google.Chrome,71,1733998888,1733998959,1733998960,-21600,MacBook
com.apple.Notes,12,1733998876,1733998888,1733998888,-21600,MacBook
com.google.Chrome,8,1733998868,1733998876,1733998877,-21600,MacBook
com.apple.Notes,40,1733998828,1733998868,1733998868,-21600,MacBook
com.google.Chrome,11,1733998817,1733998828,1733998828,-21600,MacBook
com.apple.Notes,4,1733998813,1733998817,1733998818,-21600,MacBook
com.google.Chrome,19,1733998794,1733998813,1733998813,-21600,MacBook
com.apple.Notes,4,1733998790,1733998794,1733998795,-21600,MacBook
com.google.Chrome,28,1733998762,1733998790,1733998791,-21600,MacBook
com.apple.Notes,5,1733998757,1733998762,1733998763,-21600,MacBook
com.google.Chrome,53,1733998704,1733998757,1733998757,-21600,MacBook
com.apple.Notes,490,1733998214,1733998704,1733998705,-21600,MacBook
com.google.Chrome,59,1733998155,1733998214,1733998214,-21600,MacBook
com.apple.Notes,146,1733998009,1733998155,1733998156,-21600,MacBook
com.google.Chrome,307,1733997702,1733998009,1733998010,-21600,MacBook
com.apple.Notes,9,1733997693,1733997702,1733997703,-21600,MacBook
com.google.Chrome,526,1733997167,1733997693,1733997694,-21600,MacBook
com.apple.Notes,36,1733997131,1733997167,1733997167,-21600,MacBook
notion.id,2,1733997129,1733997131,1733997132,-21600,MacBook
com.google.Chrome,51,1733997078,1733997129,1733997130,-21600,MacBook
notion.id,1,1733997077,1733997078,1733997079,-21600,MacBook
com.apple.Notes,2,1733997075,1733997077,1733997077,-21600,MacBook
com.google.Chrome,90,1733996985,1733997075,1733997076,-21600,MacBook
com.apple.Notes,0,1733996985,1733996985,1733996986,-21600,MacBook
com.google.Chrome,64,1733996921,1733996985,1733996985,-21600,MacBook
com.apple.Notes,292,1733996629,1733996921,1733996922,-21600,MacBook
notion.id,29,1733996600,1733996629,1733996630,-21600,MacBook
com.google.Chrome,21,1733996579,1733996600,1733996601,-21600,MacBook
notion.id,85,1733996494,1733996579,1733996579,-21600,MacBook
com.google.Chrome,20,1733996474,1733996494,1733996494,-21600,MacBook
notion.id,9,1733996465,1733996474,1733996475,-21600,MacBook
com.google.Chrome,171,1733996294,1733996465,1733996466,-21600,MacBook
notion.id,18,1733996276,1733996294,1733996294,-21600,MacBook
com.google.Chrome,298,1733995978,1733996276,1733996277,-21600,MacBook
notion.id,12,1733995966,1733995978,1733995978,-21600,MacBook
com.google.Chrome,24,1733995942,1733995966,1733995967,-21600,MacBook
notion.id,34,1733995908,1733995942,1733995943,-21600,MacBook
com.apple.Notes,161,1733995747,1733995908,1733995909,-21600,MacBook
com.apple.finder,69,1733995678,1733995747,1733995747,-21600,MacBook
com.google.Chrome,4,1733995674,1733995678,1733995678,-21600,MacBook
com.apple.finder,1,1733995673,1733995674,1733995675,-21600,MacBook
com.microsoft.Outlook,1,1733995672,1733995673,1733995674,-21600,MacBook
com.google.Chrome,16,1733995656,1733995672,1733995672,-21600,MacBook
com.google.Chrome,16,1733995479,1733995495,1733995496,-21600,MacBook
com.google.Chrome,21,1733978444,1733978465,1733978466,-21600,MacBook
com.google.Chrome,320,1733977908,1733978228,1733978229,-21600,MacBook
com.google.Chrome,301,1733977548,1733977849,1733977849,-21600,MacBook
com.google.Chrome,1779,1733974848,1733976627,1733976627,-21600,MacBook
com.google.Chrome,760,1733973781,1733974541,1733974542,-21600,MacBook
com.google.Chrome,416,1733973338,1733973754,1733973755,-21600,MacBook
com.google.Chrome,1052,1733971692,1733972744,1733972744,-21600,MacBook
com.google.Chrome,300,1733969321,1733969621,1733969622,-21600,MacBook
com.google.Chrome,898,1733968360,1733969258,1733969258,-21600,MacBook
com.google.Chrome,515,1733967448,1733967963,1733967963,-21600,MacBook
com.google.Chrome,288,1733966698,1733966986,1733966986,-21600,MacBook
com.google.Chrome,614,1733965811,1733966425,1733966426,-21600,MacBook
com.google.Chrome,347,1733964727,1733965074,1733965074,-21600,MacBook
com.microsoft.Outlook,33,1733964694,1733964727,1733964727,-21600,MacBook
com.apple.finder,1,1733964693,1733964694,1733964695,-21600,MacBook
com.google.Chrome,219,1733964474,1733964693,1733964694,-21600,MacBook
com.google.Chrome,465,1733963199,1733963664,1733963664,-21600,MacBook
com.google.Chrome,546,1733962166,1733962712,1733962712,-21600,MacBook
com.google.Chrome,318,1733961595,1733961913,1733961913,-21600,MacBook
com.google.Chrome,1348,1733960064,1733961412,1733961412,-21600,MacBook
com.apple.finder,4,1733960060,1733960064,1733960064,-21600,MacBook
com.apple.Notes,14,1733960046,1733960060,1733960060,-21600,MacBook
com.apple.finder,3,1733960043,1733960046,1733960046,-21600,MacBook
com.google.Chrome,4,1733960039,1733960043,1733960044,-21600,MacBook
com.apple.finder,2,1733960037,1733960039,1733960040,-21600,MacBook
com.google.Chrome,19,1733960018,1733960037,1733960038,-21600,MacBook
com.google.Chrome,16,1733959983,1733959999,1733960000,-21600,MacBook
com.google.Chrome,14,1733957937,1733957951,1733957951,-21600,MacBook
com.apple.finder,1,1733957936,1733957937,1733957938,-21600,MacBook
com.google.Chrome,0,1733957936,1733957936,1733957937,-21600,MacBook
com.apple.finder,1,1733957935,1733957936,1733957936,-21600,MacBook
com.google.Chrome,0,1733957935,1733957935,1733957936,-21600,MacBook
com.apple.finder,1,1733957934,1733957935,1733957935,-21600,MacBook
com.google.Chrome,0,1733957934,1733957934,1733957935,-21600,MacBook
com.apple.finder,1,1733957933,1733957934,1733957934,-21600,MacBook
com.google.Chrome,1,1733957932,1733957933,1733957933,-21600,MacBook
com.apple.finder,0,1733957932,1733957932,1733957933,-21600,MacBook
com.google.Chrome,1,1733957931,1733957932,1733957932,-21600,MacBook
com.apple.finder,0,1733957931,1733957931,1733957932,-21600,MacBook
com.google.Chrome,1,1733957930,1733957931,1733957931,-21600,MacBook
com.apple.finder,0,1733957930,1733957930,1733957931,-21600,MacBook
com.google.Chrome,2,1733957928,1733957930,1733957930,-21600,MacBook
com.apple.finder,1,1733957927,1733957928,1733957928,-21600,MacBook
com.google.Chrome,78,1733957849,1733957927,1733957928,-21600,MacBook
com.apple.finder,0,1733957849,1733957849,1733957850,-21600,MacBook
com.apple.Notes,31,1733957818,1733957849,1733957849,-21600,MacBook
com.google.Chrome,125,1733957693,1733957818,1733957819,-21600,MacBook
com.google.Chrome,302,1733957262,1733957564,1733957565,-21600,MacBook
com.google.Chrome,302,1733956592,1733956894,1733956895,-21600,MacBook
com.google.Chrome,302,1733955043,1733955345,1733955345,-21600,MacBook
com.google.Chrome,403,1733954341,1733954744,1733954744,-21600,MacBook
com.google.Chrome,280,1733952015,1733952295,1733952295,-21600,MacBook
com.microsoft.Outlook,1,1733952014,1733952015,1733952016,-21600,MacBook
com.google.Chrome,1,1733952013,1733952014,1733952015,-21600,MacBook
com.microsoft.Outlook,1,1733952012,1733952013,1733952013,-21600,MacBook
com.google.Chrome,62,1733951950,1733952012,1733952012,-21600,MacBook
com.microsoft.Outlook,6,1733951818,1733951824,1733951825,-21600,MacBook
com.google.Chrome,1,1733951817,1733951818,1733951819,-21600,MacBook
com.microsoft.Outlook,7,1733951810,1733951817,1733951817,-21600,MacBook
com.apple.finder,0,1733951810,1733951810,1733951811,-21600,MacBook
com.google.Chrome,8,1733951802,1733951810,1733951810,-21600,MacBook
com.apple.finder,1,1733951801,1733951802,1733951803,-21600,MacBook
com.microsoft.Outlook,6,1733951795,1733951801,1733951802,-21600,MacBook
com.google.Chrome,8,1733951787,1733951795,1733951796,-21600,MacBook
com.microsoft.Outlook,9,1733951778,1733951787,1733951788,-21600,MacBook
com.apple.finder,2,1733951776,1733951778,1733951779,-21600,MacBook
com.microsoft.Outlook,17,1733951759,1733951776,1733951777,-21600,MacBook
com.google.Chrome,48,1733951711,1733951759,1733951760,-21600,MacBook
com.microsoft.Outlook,110,1733951601,1733951711,1733951712,-21600,MacBook
com.apple.finder,8,1733951593,1733951601,1733951601,-21600,MacBook
com.microsoft.Outlook,21,1733951572,1733951593,1733951593,-21600,MacBook
com.google.Chrome,1,1733951571,1733951572,1733951573,-21600,MacBook
com.microsoft.Outlook,2,1733951569,1733951571,1733951571,-21600,MacBook
com.google.Chrome,59,1733951510,1733951569,1733951570,-21600,MacBook
com.adobe.acc.AdobeCreativeCloud,2,1733951508,1733951510,1733951511,-21600,MacBook
com.google.Chrome,2136,1733949372,1733951508,1733951509,-21600,MacBook
com.microsoft.Outlook,4,1733949368,1733949372,1733949373,-21600,MacBook
com.apple.finder,0,1733949368,1733949368,1733949369,-21600,MacBook
com.google.Chrome,1488,1733947880,1733949368,1733949369,-21600,MacBook
com.apple.finder,1,1733947879,1733947880,1733947881,-21600,MacBook
com.google.Chrome,15,1733947864,1733947879,1733947879,-21600,MacBook
com.apple.finder,1,1733947863,1733947864,1733947864,-21600,MacBook
com.apple.Dictionary,2,1733947861,1733947863,1733947863,-21600,MacBook
com.google.Chrome,391,1733947470,1733947861,1733947862,-21600,MacBook
com.apple.finder,6,1733947464,1733947470,1733947470,-21600,MacBook
com.microsoft.Outlook,42,1733947422,1733947464,1733947465,-21600,MacBook
com.apple.finder,0,1733947422,1733947422,1733947423,-21600,MacBook
com.microsoft.Outlook,2,1733947420,1733947422,1733947422,-21600,MacBook
com.apple.finder,0,1733947420,1733947420,1733947421,-21600,MacBook
com.microsoft.Outlook,1,1733947419,1733947420,1733947420,-21600,MacBook
com.apple.finder,0,1733947419,1733947419,1733947420,-21600,MacBook
com.microsoft.Outlook,6,1733947413,1733947419,1733947419,-21600,MacBook
com.apple.finder,1,1733947412,1733947413,1733947414,-21600,MacBook
com.microsoft.Outlook,2,1733947410,1733947412,1733947413,-21600,MacBook
com.apple.finder,1,1733947409,1733947410,1733947410,-21600,MacBook
com.microsoft.Outlook,20,1733947389,1733947409,1733947410,-21600,MacBook
com.google.Chrome,2,1733947387,1733947389,1733947389,-21600,MacBook
com.microsoft.Outlook,9,1733947378,1733947387,1733947387,-21600,MacBook
com.google.Chrome,25,1733947353,1733947378,1733947378,-21600,MacBook
com.microsoft.Outlook,18,1733947335,1733947353,1733947354,-21600,MacBook
com.google.Chrome,48,1733947287,1733947335,1733947335,-21600,MacBook
com.microsoft.Outlook,11,1733947276,1733947287,1733947288,-21600,MacBook
com.google.Chrome,1,1733947275,1733947276,1733947277,-21600,MacBook
com.microsoft.Outlook,26,1733947249,1733947275,1733947276,-21600,MacBook
com.google.Chrome,10,1733947239,1733947249,1733947250,-21600,MacBook
com.microsoft.Outlook,1,1733947238,1733947239,1733947239,-21600,MacBook
com.apple.Dictionary,2,1733947236,1733947238,1733947239,-21600,MacBook
com.google.Chrome,13,1733947223,1733947236,1733947236,-21600,MacBook
com.microsoft.Outlook,12,1733947211,1733947223,1733947224,-21600,MacBook
com.google.Chrome,14,1733947197,1733947211,1733947212,-21600,MacBook
com.microsoft.Outlook,2,1733947195,1733947197,1733947198,-21600,MacBook
com.google.Chrome,3,1733947192,1733947195,1733947196,-21600,MacBook
com.microsoft.Outlook,2,1733947190,1733947192,1733947193,-21600,MacBook
com.google.Chrome,2,1733947188,1733947190,1733947190,-21600,MacBook
com.microsoft.Outlook,88,1733947100,1733947188,1733947188,-21600,MacBook
com.google.Chrome,107,1733946993,1733947100,1733947101,-21600,MacBook
com.microsoft.Outlook,2,1733946991,1733946993,1733946993,-21600,MacBook
com.google.Chrome,15,1733946976,1733946991,1733946992,-21600,MacBook
com.microsoft.Outlook,0,1733946976,1733946976,1733946977,-21600,MacBook
com.google.Chrome,1,1733946975,1733946976,1733946976,-21600,MacBook
com.microsoft.Outlook,2,1733946973,1733946975,1733946975,-21600,MacBook
com.google.Chrome,109,1733946864,1733946973,1733946973,-21600,MacBook
com.microsoft.Outlook,32,1733946832,1733946864,1733946864,-21600,MacBook
com.google.Chrome,1,1733946831,1733946832,1733946833,-21600,MacBook
com.microsoft.Outlook,13,1733946818,1733946831,1733946831,-21600,MacBook
com.google.Chrome,1,1733946817,1733946818,1733946819,-21600,MacBook
com.microsoft.Outlook,37,1733946780,1733946817,1733946818,-21600,MacBook
com.google.Chrome,3,1733946777,1733946780,1733946780,-21600,MacBook
com.microsoft.Outlook,6,1733946771,1733946777,1733946777,-21600,MacBook
com.google.Chrome,2,1733946769,1733946771,1733946771,-21600,MacBook
com.microsoft.Outlook,6,1733946763,1733946769,1733946770,-21600,MacBook
com.google.Chrome,23,1733946740,1733946763,1733946764,-21600,MacBook
com.microsoft.Outlook,35,1733946705,1733946740,1733946741,-21600,MacBook
com.google.Chrome,4,1733946701,1733946705,1733946706,-21600,MacBook
com.microsoft.Outlook,43,1733946658,1733946701,1733946702,-21600,MacBook
com.apple.finder,1,1733946657,1733946658,1733946658,-21600,MacBook
com.microsoft.Outlook,27,1733946630,1733946657,1733946658,-21600,MacBook
com.apple.finder,0,1733946630,1733946630,1733946631,-21600,MacBook
com.microsoft.Outlook,12,1733946618,1733946630,1733946630,-21600,MacBook
com.apple.finder,1,1733946617,1733946618,1733946619,-21600,MacBook
com.apple.Preview,9,1733946608,1733946617,1733946617,-21600,MacBook
com.apple.finder,1,1733946607,1733946608,1733946608,-21600,MacBook
com.apple.Preview,26,1733946581,1733946607,1733946607,-21600,MacBook
com.google.Chrome,4,1733946577,1733946581,1733946581,-21600,MacBook
com.apple.Preview,4,1733946573,1733946577,1733946577,-21600,MacBook
com.google.Chrome,13,1733946560,1733946573,1733946573,-21600,MacBook
com.apple.Preview,13,1733946547,1733946560,1733946561,-21600,MacBook
com.google.Chrome,6,1733946541,1733946547,1733946547,-21600,MacBook
com.apple.Preview,4,1733946537,1733946541,1733946542,-21600,MacBook
com.google.Chrome,7,1733946530,1733946537,1733946537,-21600,MacBook
com.apple.Preview,6,1733946524,1733946530,1733946531,-21600,MacBook
com.google.Chrome,44,1733946480,1733946524,1733946525,-21600,MacBook
com.apple.Preview,22,1733946458,1733946480,1733946480,-21600,MacBook
com.apple.finder,1,1733946423,1733946424,1733946425,-21600,MacBook
com.apple.Preview,4,1733946419,1733946423,1733946423,-21600,MacBook
com.apple.finder,1,1733946418,1733946419,1733946419,-21600,MacBook
com.apple.Preview,6,1733946412,1733946418,1733946419,-21600,MacBook
com.apple.finder,0,1733946412,1733946412,1733946413,-21600,MacBook
com.apple.Preview,19,1733946393,1733946412,1733946412,-21600,MacBook
com.google.Chrome,2,1733946391,1733946393,1733946393,-21600,MacBook
com.apple.Preview,1,1733946390,1733946391,1733946392,-21600,MacBook
com.google.Chrome,4,1733946386,1733946390,1733946391,-21600,MacBook
com.apple.Preview,15,1733946371,1733946386,1733946387,-21600,MacBook
com.apple.finder,8,1733946363,1733946371,1733946371,-21600,MacBook
com.microsoft.Outlook,4,1733946359,1733946363,1733946363,-21600,MacBook
com.google.Chrome,81,1733946278,1733946359,1733946360,-21600,MacBook
com.microsoft.Outlook,4,1733946274,1733946278,1733946278,-21600,MacBook
com.google.Chrome,8,1733946266,1733946274,1733946275,-21600,MacBook
com.google.Chrome,35,1733945729,1733945764,1733945765,-21600,MacBook
com.google.Chrome,44,1733939767,1733939811,1733939811,-21600,MacBook
com.microsoft.Outlook,1,1733939766,1733939767,1733939767,-21600,MacBook
com.google.Chrome,297,1733939469,1733939766,1733939766,-21600,MacBook
com.google.Chrome,1003,1733938409,1733939412,1733939412,-21600,MacBook
com.google.Chrome,499,1733937721,1733938220,1733938220,-21600,MacBook
com.google.Chrome,893,1733936014,1733936907,1733936908,-21600,MacBook
com.microsoft.Outlook,7,1733936007,1733936014,1733936014,-21600,MacBook
com.google.Chrome,1,1733936006,1733936007,1733936008,-21600,MacBook
com.microsoft.Outlook,6,1733936000,1733936006,1733936007,-21600,MacBook
com.google.Chrome,1,1733935999,1733936000,1733936001,-21600,MacBook
com.microsoft.Outlook,30,1733935969,1733935999,1733936000,-21600,MacBook
com.google.Chrome,29,1733935940,1733935969,1733935969,-21600,MacBook
com.apple.finder,0,1733935940,1733935940,1733935942,-21600,MacBook
com.google.Chrome,2,1733935938,1733935940,1733935941,-21600,MacBook
com.apple.finder,7,1733935931,1733935938,1733935938,-21600,MacBook
com.apple.finder,1,1733903271,1733903272,1733903273,-21600,MacBook
com.tinyspeck.slackmacgap,3,1733903268,1733903271,1733903271,-21600,MacBook
com.google.Chrome,14,1733903254,1733903268,1733903269,-21600,MacBook
com.apple.finder,7,1733903247,1733903254,1733903255,-21600,MacBook
com.tinyspeck.slackmacgap,0,1733903247,1733903247,1733903248,-21600,MacBook
com.google.Chrome,0,1733903247,1733903247,1733903248,-21600,MacBook
com.apple.finder,1,1733903246,1733903247,1733903247,-21600,MacBook
com.tinyspeck.slackmacgap,3,1733903243,1733903246,1733903246,-21600,MacBook
com.apple.finder,0,1733903243,1733903243,1733903244,-21600,MacBook
com.google.Chrome,4,1733903239,1733903243,1733903243,-21600,MacBook
com.tinyspeck.slackmacgap,2,1733903237,1733903239,1733903240,-21600,MacBook
com.apple.finder,1,1733903236,1733903237,1733903238,-21600,MacBook
com.apple.Preview,1,1733903235,1733903236,1733903237,-21600,MacBook
com.tinyspeck.slackmacgap,34,1733903201,1733903235,1733903235,-21600,MacBook
com.google.Chrome,121,1733903080,1733903201,1733903202,-21600,MacBook
com.tinyspeck.slackmacgap,5,1733903075,1733903080,1733903081,-21600,MacBook
com.apple.finder,2,1733903073,1733903075,1733903076,-21600,MacBook
com.tinyspeck.slackmacgap,3,1733903070,1733903073,1733903074,-21600,MacBook
com.apple.finder,0,1733903070,1733903070,1733903071,-21600,MacBook
com.google.Chrome,347,1733902723,1733903070,1733903070,-21600,MacBook
com.apple.finder,2,1733902721,1733902723,1733902723,-21600,MacBook
com.google.Chrome,15,1733902706,1733902721,1733902721,-21600,MacBook
com.apple.finder,2,1733902704,1733902706,1733902707,-21600,MacBook
com.google.Chrome,603,1733902101,1733902704,1733902704,-21600,MacBook
com.apple.finder,2,1733902099,1733902101,1733902101,-21600,MacBook
com.google.Chrome,794,1733901305,1733902099,1733902100,-21600,MacBook
com.apple.finder,2,1733901303,1733901305,1733901305,-21600,MacBook
com.google.Chrome,2,1733901301,1733901303,1733901304,-21600,MacBook
com.apple.finder,7,1733901294,1733901301,1733901302,-21600,MacBook
com.google.Chrome,4,1733901290,1733901294,1733901294,-21600,MacBook
com.apple.Preview,5,1733901285,1733901290,1733901290,-21600,MacBook
com.google.Chrome,3,1733901282,1733901285,1733901285,-21600,MacBook
com.apple.Preview,2,1733901280,1733901282,1733901282,-21600,MacBook
com.google.Chrome,72,1733901208,1733901280,1733901281,-21600,MacBook
com.apple.Preview,15,1733901193,1733901208,1733901209,-21600,MacBook
com.apple.finder,3,1733901190,1733901193,1733901194,-21600,MacBook
com.google.Chrome,9,1733901181,1733901190,1733901191,-21600,MacBook
com.apple.Preview,1,1733901180,1733901181,1733901182,-21600,MacBook
com.google.Chrome,29,1733901151,1733901180,1733901180,-21600,MacBook
com.apple.Preview,11,1733901140,1733901151,1733901151,-21600,MacBook
com.google.Chrome,11,1733901129,1733901140,1733901140,-21600,MacBook
com.apple.Preview,6,1733901123,1733901129,1733901130,-21600,MacBook
com.google.Chrome,11,1733901112,1733901123,1733901124,-21600,MacBook
com.apple.Preview,3,1733901109,1733901112,1733901112,-21600,MacBook
com.apple.finder,1,1733901108,1733901109,1733901110,-21600,MacBook
com.apple.Preview,9,1733901099,1733901108,1733901109,-21600,MacBook
com.google.Chrome,9,1733901090,1733901099,1733901100,-21600,MacBook
com.apple.Preview,3,1733901087,1733901090,1733901091,-21600,MacBook
com.google.Chrome,207,1733900880,1733901087,1733901088,-21600,MacBook
com.tinyspeck.slackmacgap,4,1733900876,1733900880,1733900881,-21600,MacBook
com.google.Chrome,104,1733900772,1733900876,1733900877,-21600,MacBook
com.apple.Preview,4,1733900768,1733900772,1733900773,-21600,MacBook
com.google.Chrome,4,1733900764,1733900768,1733900768,-21600,MacBook
com.apple.Preview,0,1733900764,1733900764,1733900765,-21600,MacBook
com.tinyspeck.slackmacgap,13,1733900751,1733900764,1733900764,-21600,MacBook
com.google.Chrome,15,1733900736,1733900751,1733900752,-21600,MacBook
com.tinyspeck.slackmacgap,8,1733900728,1733900736,1733900737,-21600,MacBook
com.google.Chrome,8,1733900720,1733900728,1733900729,-21600,MacBook
com.tinyspeck.slackmacgap,3,1733900717,1733900720,1733900721,-21600,MacBook
com.google.Chrome,8,1733900709,1733900717,1733900717,-21600,MacBook
com.apple.Preview,8,1733900701,1733900709,1733900710,-21600,MacBook
com.google.Chrome,5,1733900696,1733900701,1733900702,-21600,MacBook
com.apple.Preview,2,1733900694,1733900696,1733900697,-21600,MacBook
com.google.Chrome,3,1733900691,1733900694,1733900694,-21600,MacBook
com.apple.Preview,2,1733900689,1733900691,1733900691,-21600,MacBook
com.google.Chrome,23,1733900666,1733900689,1733900690,-21600,MacBook
com.apple.Preview,2,1733900664,1733900666,1733900667,-21600,MacBook
com.google.Chrome,4,1733900660,1733900664,1733900665,-21600,MacBook
com.apple.Preview,1,1733900659,1733900660,1733900661,-21600,MacBook
com.google.Chrome,7,1733900652,1733900659,1733900660,-21600,MacBook
com.apple.Preview,1,1733900651,1733900652,1733900653,-21600,MacBook
com.google.Chrome,5,1733900646,1733900651,1733900651,-21600,MacBook
com.apple.Preview,1,1733900645,1733900646,1733900647,-21600,MacBook
com.google.Chrome,9,1733900636,1733900645,1733900646,-21600,MacBook
com.apple.Preview,1,1733900635,1733900636,1733900637,-21600,MacBook
com.google.Chrome,9,1733900626,1733900635,1733900636,-21600,MacBook
com.apple.Preview,7,1733900619,1733900626,1733900626,-21600,MacBook
com.google.Chrome,25,1733900594,1733900619,1733900620,-21600,MacBook
com.apple.Preview,2,1733900592,1733900594,1733900595,-21600,MacBook
com.google.Chrome,3,1733900589,1733900592,1733900593,-21600,MacBook
com.apple.Preview,1,1733900588,1733900589,1733900590,-21600,MacBook
com.google.Chrome,5,1733900583,1733900588,1733900588,-21600,MacBook
com.apple.Preview,2,1733900581,1733900583,1733900584,-21600,MacBook
com.google.Chrome,10,1733900571,1733900581,1733900581,-21600,MacBook
com.apple.Preview,3,1733900568,1733900571,1733900572,-21600,MacBook
com.google.Chrome,3,1733900565,1733900568,1733900569,-21600,MacBook
com.apple.Preview,2,1733900563,1733900565,1733900565,-21600,MacBook
com.google.Chrome,4,1733900559,1733900563,1733900564,-21600,MacBook
com.apple.Preview,1,1733900558,1733900559,1733900560,-21600,MacBook
com.google.Chrome,2,1733900556,1733900558,1733900558,-21600,MacBook
com.apple.Preview,4,1733900552,1733900556,1733900557,-21600,MacBook
com.google.Chrome,4,1733900548,1733900552,1733900552,-21600,MacBook
com.apple.Preview,2,1733900546,1733900548,1733900549,-21600,MacBook
com.google.Chrome,5,1733900541,1733900546,1733900547,-21600,MacBook
com.apple.Preview,3,1733900538,1733900541,1733900542,-21600,MacBook
com.google.Chrome,9,1733900529,1733900538,1733900539,-21600,MacBook
com.apple.Preview,1,1733900528,1733900529,1733900530,-21600,MacBook
com.google.Chrome,3,1733900525,1733900528,1733900529,-21600,MacBook
com.apple.Preview,2,1733900523,1733900525,1733900526,-21600,MacBook
com.google.Chrome,3,1733900520,1733900523,1733900524,-21600,MacBook
com.apple.Preview,2,1733900518,1733900520,1733900521,-21600,MacBook
com.google.Chrome,3,1733900515,1733900518,1733900519,-21600,MacBook
com.apple.Preview,1,1733900514,1733900515,1733900516,-21600,MacBook
com.google.Chrome,4,1733900510,1733900514,1733900514,-21600,MacBook
com.apple.Preview,2,1733900508,1733900510,1733900511,-21600,MacBook
com.google.Chrome,20,1733900488,1733900508,1733900509,-21600,MacBook
com.apple.Preview,19,1733900469,1733900488,1733900489,-21600,MacBook
com.google.Chrome,11,1733900458,1733900469,1733900469,-21600,MacBook
com.apple.Preview,3,1733900455,1733900458,1733900459,-21600,MacBook
com.google.Chrome,39,1733900416,1733900455,1733900456,-21600,MacBook
com.apple.Preview,4,1733900412,1733900416,1733900417,-21600,MacBook
com.google.Chrome,151,1733900261,1733900412,1733900413,-21600,MacBook
com.apple.Preview,3,1733900258,1733900261,1733900261,-21600,MacBook
com.google.Chrome,6,1733900252,1733900258,1733900258,-21600,MacBook
com.apple.Preview,1,1733900251,1733900252,1733900252,-21600,MacBook
com.google.Chrome,3,1733900248,1733900251,1733900251,-21600,MacBook
com.apple.Preview,2,1733900246,1733900248,1733900248,-21600,MacBook
com.google.Chrome,2,1733900244,1733900246,1733900247,-21600,MacBook
com.apple.Preview,1,1733900243,1733900244,1733900245,-21600,MacBook
com.google.Chrome,6,1733900237,1733900243,1733900244,-21600,MacBook
com.apple.Preview,1,1733900236,1733900237,1733900238,-21600,MacBook
com.google.Chrome,5,1733900231,1733900236,1733900236,-21600,MacBook
com.apple.Preview,3,1733900228,1733900231,1733900232,-21600,MacBook
com.google.Chrome,25,1733900203,1733900228,1733900229,-21600,MacBook
com.apple.Preview,1,1733900202,1733900203,1733900203,-21600,MacBook
com.google.Chrome,4,1733900198,1733900202,1733900202,-21600,MacBook
com.apple.Preview,3,1733900195,1733900198,1733900199,-21600,MacBook
com.google.Chrome,20,1733900175,1733900195,1733900195,-21600,MacBook
com.apple.Preview,1,1733900174,1733900175,1733900175,-21600,MacBook
com.google.Chrome,4,1733900170,1733900174,1733900174,-21600,MacBook
com.apple.Preview,2,1733900168,1733900170,1733900170,-21600,MacBook
com.google.Chrome,6,1733900162,1733900168,1733900168,-21600,MacBook
com.apple.Preview,5,1733900157,1733900162,1733900162,-21600,MacBook
com.google.Chrome,21,1733900136,1733900157,1733900158,-21600,MacBook
com.apple.Preview,3,1733900133,1733900136,1733900136,-21600,MacBook
com.google.Chrome,9,1733900124,1733900133,1733900134,-21600,MacBook
com.apple.Preview,26,1733900098,1733900124,1733900124,-21600,MacBook
com.google.Chrome,8,1733900090,1733900098,1733900098,-21600,MacBook
com.apple.finder,2,1733900088,1733900090,1733900090,-21600,MacBook
com.google.Chrome,1,1733900087,1733900088,1733900088,-21600,MacBook
com.apple.Preview,6,1733900081,1733900087,1733900087,-21600,MacBook
com.apple.finder,1,1733900080,1733900081,1733900082,-21600,MacBook
com.apple.Preview,1,1733900079,1733900080,1733900081,-21600,MacBook
com.google.Chrome,5,1733900074,1733900079,1733900080,-21600,MacBook
com.apple.Preview,1,1733900073,1733900074,1733900075,-21600,MacBook
com.apple.finder,2,1733900071,1733900073,1733900074,-21600,MacBook
com.google.Chrome,1,1733900070,1733900071,1733900072,-21600,MacBook
com.apple.Preview,40,1733900030,1733900070,1733900071,-21600,MacBook
com.google.Chrome,15,1733900015,1733900030,1733900031,-21600,MacBook
com.apple.Preview,3,1733900012,1733900015,1733900016,-21600,MacBook
com.google.Chrome,11,1733900001,1733900012,1733900013,-21600,MacBook
com.apple.Preview,5,1733899996,1733900001,1733900001,-21600,MacBook
com.google.Chrome,5,1733899991,1733899996,1733899996,-21600,MacBook
com.apple.Preview,4,1733899987,1733899991,1733899991,-21600,MacBook
com.google.Chrome,6,1733899981,1733899987,1733899987,-21600,MacBook
com.apple.Preview,3,1733899978,1733899981,1733899981,-21600,MacBook
com.google.Chrome,42,1733899936,1733899978,1733899979,-21600,MacBook
com.apple.Preview,14,1733899922,1733899936,1733899936,-21600,MacBook
com.google.Chrome,12,1733899910,1733899922,1733899923,-21600,MacBook
com.apple.Preview,6,1733899904,1733899910,1733899910,-21600,MacBook
com.google.Chrome,29,1733899875,1733899904,1733899904,-21600,MacBook
com.apple.Preview,1,1733899874,1733899875,1733899876,-21600,MacBook
com.google.Chrome,11,1733899863,1733899874,1733899874,-21600,MacBook
com.apple.Preview,1,1733899862,1733899863,1733899863,-21600,MacBook
com.apple.finder,3,1733899859,1733899862,1733899862,-21600,MacBook
com.apple.Preview,5,1733899854,1733899859,1733899859,-21600,MacBook
com.google.Chrome,5,1733899849,1733899854,1733899855,-21600,MacBook
com.apple.Preview,4,1733899845,1733899849,1733899850,-21600,MacBook
com.google.Chrome,256,1733899589,1733899845,1733899846,-21600,MacBook
com.apple.Preview,1,1733899588,1733899589,1733899590,-21600,MacBook
com.apple.finder,2,1733899586,1733899588,1733899589,-21600,MacBook
com.apple.Preview,5,1733899581,1733899586,1733899587,-21600,MacBook
com.google.Chrome,9,1733899572,1733899581,1733899581,-21600,MacBook
com.apple.Preview,11,1733899561,1733899572,1733899573,-21600,MacBook
com.google.Chrome,82,1733899479,1733899561,1733899561,-21600,MacBook
com.apple.Preview,2,1733899477,1733899479,1733899479,-21600,MacBook
com.tinyspeck.slackmacgap,9,1733899468,1733899477,1733899477,-21600,MacBook
com.google.Chrome,3,1733899465,1733899468,1733899468,-21600,MacBook
com.google.Chrome,327,1733898723,1733899050,1733899051,-21600,MacBook
com.apple.Preview,4,1733898719,1733898723,1733898724,-21600,MacBook
com.google.Chrome,1,1733898718,1733898719,1733898720,-21600,MacBook
com.apple.Preview,2,1733898716,1733898718,1733898718,-21600,MacBook
com.google.Chrome,9,1733898707,1733898716,1733898717,-21600,MacBook
com.apple.Preview,1,1733898706,1733898707,1733898708,-21600,MacBook
com.google.Chrome,14,1733898692,1733898706,1733898706,-21600,MacBook
com.apple.Preview,36,1733898656,1733898692,1733898693,-21600,MacBook
com.google.Chrome,19,1733898637,1733898656,1733898657,-21600,MacBook
com.apple.Preview,8,1733898629,1733898637,1733898638,-21600,MacBook
com.google.Chrome,34,1733898595,1733898629,1733898630,-21600,MacBook
com.apple.Preview,2,1733898593,1733898595,1733898595,-21600,MacBook
com.google.Chrome,18,1733898575,1733898593,1733898594,-21600,MacBook
com.apple.Preview,1,1733898574,1733898575,1733898575,-21600,MacBook
com.google.Chrome,4,1733898570,1733898574,1733898574,-21600,MacBook
com.apple.Preview,15,1733898555,1733898570,1733898571,-21600,MacBook
com.google.Chrome,2,1733898553,1733898555,1733898555,-21600,MacBook
com.apple.Preview,69,1733898484,1733898553,1733898553,-21600,MacBook
com.google.Chrome,24,1733898460,1733898484,1733898485,-21600,MacBook
com.apple.Preview,40,1733898420,1733898460,1733898461,-21600,MacBook
com.google.Chrome,25,1733898395,1733898420,1733898421,-21600,MacBook
com.apple.Preview,15,1733898380,1733898395,1733898396,-21600,MacBook
com.google.Chrome,1,1733898379,1733898380,1733898381,-21600,MacBook
com.apple.Preview,2,1733898377,1733898379,1733898380,-21600,MacBook
com.google.Chrome,14,1733898363,1733898377,1733898378,-21600,MacBook
com.apple.Preview,1,1733898362,1733898363,1733898364,-21600,MacBook
com.google.Chrome,20,1733898342,1733898362,1733898363,-21600,MacBook
com.apple.Preview,6,1733898336,1733898342,1733898343,-21600,MacBook
com.google.Chrome,25,1733898311,1733898336,1733898337,-21600,MacBook
com.apple.Preview,17,1733898294,1733898311,1733898311,-21600,MacBook
com.google.Chrome,5,1733898289,1733898294,1733898294,-21600,MacBook
com.apple.Preview,3,1733898286,1733898289,1733898290,-21600,MacBook
com.google.Chrome,30,1733898256,1733898286,1733898286,-21600,MacBook
com.apple.Preview,4,1733898252,1733898256,1733898256,-21600,MacBook
com.google.Chrome,7,1733898245,1733898252,1733898252,-21600,MacBook
com.apple.Preview,5,1733898240,1733898245,1733898246,-21600,MacBook
com.google.Chrome,8,1733898232,1733898240,1733898240,-21600,MacBook
com.apple.Preview,2,1733898230,1733898232,1733898232,-21600,MacBook
com.google.Chrome,2,1733898228,1733898230,1733898230,-21600,MacBook
com.apple.Preview,2,1733898226,1733898228,1733898229,-21600,MacBook
com.google.Chrome,2,1733898224,1733898226,1733898226,-21600,MacBook
com.apple.Preview,1,1733898223,1733898224,1733898224,-21600,MacBook
com.google.Chrome,2,1733898221,1733898223,1733898223,-21600,MacBook
com.apple.Preview,3,1733898218,1733898221,1733898222,-21600,MacBook
com.google.Chrome,20,1733898198,1733898218,1733898219,-21600,MacBook
com.apple.Preview,5,1733898193,1733898198,1733898199,-21600,MacBook
com.google.Chrome,47,1733898146,1733898193,1733898194,-21600,MacBook
com.apple.Preview,1,1733898145,1733898146,1733898147,-21600,MacBook
com.tinyspeck.slackmacgap,110,1733898035,1733898145,1733898146,-21600,MacBook
com.apple.finder,0,1733898035,1733898035,1733898036,-21600,MacBook
com.google.Chrome,7,1733898028,1733898035,1733898035,-21600,MacBook
com.apple.Preview,1,1733898027,1733898028,1733898029,-21600,MacBook
com.apple.finder,6,1733898021,1733898027,1733898028,-21600,MacBook
com.google.Chrome,254,1733897767,1733898021,1733898021,-21600,MacBook
com.apple.finder,2,1733897765,1733897767,1733897768,-21600,MacBook
com.apple.Preview,3,1733897762,1733897765,1733897765,-21600,MacBook
com.google.Chrome,31,1733897731,1733897762,1733897762,-21600,MacBook
com.apple.finder,1,1733897730,1733897731,1733897732,-21600,MacBook
com.apple.Preview,1,1733897729,1733897730,1733897730,-21600,MacBook
com.google.Chrome,4,1733897725,1733897729,1733897730,-21600,MacBook
com.apple.finder,1,1733897724,1733897725,1733897726,-21600,MacBook
com.apple.Preview,1,1733897723,1733897724,1733897725,-21600,MacBook
com.google.Chrome,16,1733897707,1733897723,1733897724,-21600,MacBook
com.apple.Preview,1,1733897706,1733897707,1733897707,-21600,MacBook
com.apple.finder,4,1733897702,1733897706,1733897706,-21600,MacBook
com.google.Chrome,53,1733897649,1733897702,1733897703,-21600,MacBook
com.apple.Preview,1,1733897648,1733897649,1733897649,-21600,MacBook
com.apple.finder,2,1733897646,1733897648,1733897649,-21600,MacBook
com.google.Chrome,111,1733897535,1733897646,1733897646,-21600,MacBook
com.apple.Preview,1,1733897534,1733897535,1733897535,-21600,MacBook
com.apple.finder,3,1733897531,1733897534,1733897535,-21600,MacBook
com.apple.Preview,1,1733897530,1733897531,1733897532,-21600,MacBook
com.apple.finder,6,1733897524,1733897530,1733897530,-21600,MacBook
com.tinyspeck.slackmacgap,3,1733897521,1733897524,1733897524,-21600,MacBook
com.google.Chrome,39,1733897482,1733897521,1733897522,-21600,MacBook
com.apple.Preview,1,1733897481,1733897482,1733897482,-21600,MacBook
com.tinyspeck.slackmacgap,17,1733897464,1733897481,1733897482,-21600,MacBook
com.apple.Preview,1,1733897463,1733897464,1733897464,-21600,MacBook
com.google.Chrome,7,1733897456,1733897463,1733897464,-21600,MacBook
com.apple.Preview,1,1733897455,1733897456,1733897456,-21600,MacBook
com.tinyspeck.slackmacgap,10,1733897445,1733897455,1733897455,-21600,MacBook
com.adobe.Photoshop,1,1733897444,1733897445,1733897446,-21600,MacBook
com.tinyspeck.slackmacgap,2,1733897442,1733897444,1733897445,-21600,MacBook
com.apple.finder,0,1733897442,1733897442,1733897442,-21600,MacBook
com.google.Chrome,135,1733897307,1733897442,1733897442,-21600,MacBook
com.apple.Preview,8,1733897299,1733897307,1733897307,-21600,MacBook
com.google.Chrome,5,1733897294,1733897299,1733897300,-21600,MacBook
com.apple.Preview,1,1733897293,1733897294,1733897295,-21600,MacBook
com.google.Chrome,7,1733897286,1733897293,1733897293,-21600,MacBook
com.apple.Preview,2,1733897284,1733897286,1733897286,-21600,MacBook
com.google.Chrome,21,1733897263,1733897284,1733897284,-21600,MacBook
com.apple.Preview,1,1733897262,1733897263,1733897264,-21600,MacBook
com.google.Chrome,21,1733897241,1733897262,1733897263,-21600,MacBook
com.apple.Preview,3,1733897238,1733897241,1733897241,-21600,MacBook
com.google.Chrome,3,1733897235,1733897238,1733897238,-21600,MacBook
com.apple.Preview,4,1733897231,1733897235,1733897235,-21600,MacBook
com.google.Chrome,51,1733897180,1733897231,1733897231,-21600,MacBook
com.apple.Preview,5,1733897175,1733897180,1733897181,-21600,MacBook
com.google.Chrome,6,1733897169,1733897175,1733897176,-21600,MacBook
com.apple.Preview,3,1733897166,1733897169,1733897169,-21600,MacBook
com.google.Chrome,10,1733897156,1733897166,1733897167,-21600,MacBook
com.apple.Preview,3,1733897153,1733897156,1733897157,-21600,MacBook
com.google.Chrome,4,1733897149,1733897153,1733897154,-21600,MacBook
com.apple.Preview,2,1733897147,1733897149,1733897149,-21600,MacBook
com.google.Chrome,4,1733897143,1733897147,1733897148,-21600,MacBook
com.apple.Preview,4,1733897139,1733897143,1733897143,-21600,MacBook
com.google.Chrome,7,1733897132,1733897139,1733897140,-21600,MacBook
com.apple.Preview,2,1733897130,1733897132,1733897132,-21600,MacBook
com.google.Chrome,5,1733897125,1733897130,1733897130,-21600,MacBook
com.apple.Preview,8,1733897117,1733897125,1733897125,-21600,MacBook
com.google.Chrome,2,1733897115,1733897117,1733897117,-21600,MacBook
com.apple.Preview,1,1733897114,1733897115,1733897115,-21600,MacBook
com.google.Chrome,3,1733897111,1733897114,1733897114,-21600,MacBook
com.apple.Preview,3,1733897108,1733897111,1733897111,-21600,MacBook
com.google.Chrome,6,1733897102,1733897108,1733897109,-21600,MacBook
com.apple.Preview,2,1733897100,1733897102,1733897102,-21600,MacBook
com.google.Chrome,5,1733897095,1733897100,1733897101,-21600,MacBook
com.apple.Preview,22,1733897073,1733897095,1733897095,-21600,MacBook
com.google.Chrome,5,1733897068,1733897073,1733897073,-21600,MacBook
com.apple.Preview,1,1733897067,1733897068,1733897068,-21600,MacBook
com.google.Chrome,6,1733897061,1733897067,1733897067,-21600,MacBook
com.apple.Preview,8,1733897053,1733897061,1733897062,-21600,MacBook
com.google.Chrome,9,1733897044,1733897053,1733897053,-21600,MacBook
com.apple.Preview,16,1733897028,1733897044,1733897045,-21600,MacBook
com.google.Chrome,533,1733896495,1733897028,1733897029,-21600,MacBook
com.apple.Preview,2,1733896493,1733896495,1733896495,-21600,MacBook
com.google.Chrome,64,1733896429,1733896493,1733896493,-21600,MacBook
com.apple.Preview,1,1733896428,1733896429,1733896429,-21600,MacBook
com.apple.finder,5,1733896423,1733896428,1733896429,-21600,MacBook
com.google.Chrome,2,1733896421,1733896423,1733896424,-21600,MacBook
com.apple.Preview,10,1733896411,1733896421,1733896422,-21600,MacBook
com.google.Chrome,36,1733896375,1733896411,1733896412,-21600,MacBook
com.apple.Preview,8,1733896350,1733896358,1733896359,-21600,MacBook
com.google.Chrome,9,1733896341,1733896350,1733896351,-21600,MacBook
com.apple.Preview,2,1733896339,1733896341,1733896341,-21600,MacBook
com.google.Chrome,22,1733896317,1733896339,1733896340,-21600,MacBook
com.apple.Preview,3,1733896314,1733896317,1733896318,-21600,MacBook
com.google.Chrome,16,1733896298,1733896314,1733896315,-21600,MacBook
com.apple.Preview,2,1733896296,1733896298,1733896299,-21600,MacBook
com.google.Chrome,5,1733896291,1733896296,1733896296,-21600,MacBook
com.apple.Preview,1,1733896290,1733896291,1733896291,-21600,MacBook
com.google.Chrome,12,1733896278,1733896290,1733896290,-21600,MacBook